时间,官网数据,实际官网预约人数,BiliBili数据,TapTap数据,合计
2023-04-12 18:08,797229,147109,468360,181760,797229
2023-04-12 18:09,797258,147128,468366,181764,797258
2023-04-12 18:10,797284,147149,468366,181769,797284
2023-04-12 18:11,797311,147167,468370,181774,797311
2023-04-12 18:12,797340,147195,468370,181775,797340
2023-04-12 18:13,797368,147212,468377,181779,797368
2023-04-12 18:14,797395,147232,468377,181786,797395
2023-04-12 18:15,797423,147251,468384,181788,797423
2023-04-12 18:16,797451,147275,468384,181792,797451
2023-04-12 18:17,797479,147296,468387,181796,797479
2023-04-12 18:18,797506,147318,468387,181801,797506
2023-04-12 18:19,797532,147332,468393,181807,797532
2023-04-12 18:20,797560,147354,468393,181813,797560
2023-04-12 18:21,797585,147372,468398,181815,797585
2023-04-12 18:22,797614,147400,468398,181816,797614
2023-04-12 18:23,797640,147417,468405,181818,797640
2023-04-12 18:24,797666,147439,468405,181822,797666
2023-04-12 18:25,797693,147454,468414,181825,797693
2023-04-12 18:26,797720,147479,468414,181827,797720
2023-04-12 18:27,797748,147503,468417,181828,797748
2023-04-12 18:28,797777,147532,468417,181828,797777
2023-04-12 18:29,797804,147537,468428,181839,797804
2023-04-12 18:30,797832,147561,468430,181841,797832
2023-04-12 18:31,797859,147585,468430,181844,797859
2023-04-12 18:32,797888,147603,468437,181848,797888
2023-04-12 18:33,797917,147626,468437,181854,797917
2023-04-12 18:34,797943,147641,468444,181858,797943
2023-04-12 18:35,797971,147661,468444,181866,797971
2023-04-12 18:36,797997,147676,468453,181868,797997
2023-04-12 18:37,798024,147696,468457,181871,798024
2023-04-12 18:38,798052,147703,468475,181874,798052
2023-04-12 18:39,798079,147724,468475,181880,798079
2023-04-12 18:40,798108,147733,468494,181881,798108
2023-04-12 18:41,798138,147749,468506,181883,798138
2023-04-12 18:43,798166,147766,468517,181883,798166
2023-04-12 18:44,798194,147786,468523,181885,798194
2023-04-12 18:45,798222,147804,468530,181888,798222
2023-04-12 18:46,798253,147803,468559,181891,798253
2023-04-12 18:47,798282,147820,468566,181896,798282
2023-04-12 18:48,798311,147813,468597,181901,798311
2023-04-12 18:49,798341,147820,468614,181907,798341
2023-04-12 18:50,798367,147830,468626,181911,798367
2023-04-12 18:51,798395,147850,468626,181919,798395
2023-04-12 18:52,798422,147837,468661,181924,798422
2023-04-12 18:53,798450,147833,468685,181932,798450
2023-04-12 18:54,798477,147829,468712,181936,798477
2023-04-12 18:55,798503,147852,468712,181939,798503
2023-04-12 18:56,798532,147841,468747,181944,798532
2023-04-12 18:57,798560,147862,468747,181951,798560
2023-04-12 18:58,798589,147862,468772,181955,798589
2023-04-12 18:59,798617,147868,468790,181959,798617
2023-04-12 19:00,798639,147880,468796,181963,798639
2023-04-12 19:01,798648,147881,468796,181971,798648
2023-04-12 19:02,798657,147851,468833,181973,798657
2023-04-12 19:03,798667,147842,468849,181976,798667
2023-04-12 19:04,798675,147837,468858,181980,798675
2023-04-12 19:05,798682,147843,468858,181981,798682
2023-04-12 19:06,798693,147829,468881,181983,798693
2023-04-12 19:07,798701,147817,468897,181987,798701
2023-04-12 19:08,798710,147810,468910,181990,798710
2023-04-12 19:09,798717,147799,468922,181996,798717
2023-04-12 19:10,798725,147801,468922,182002,798725
2023-04-12 19:11,798735,147788,468941,182006,798735
2023-04-12 19:12,798746,147796,468941,182009,798746
2023-04-12 19:13,798754,147774,468964,182016,798754
2023-04-12 19:14,798761,147775,468966,182020,798761
2023-04-12 19:15,798769,147779,468966,182024,798769
2023-04-12 19:16,798777,147764,468987,182026,798777
2023-04-12 19:17,798788,147758,469000,182030,798788
2023-04-12 19:18,798797,147759,469006,182032,798797
2023-04-12 19:19,798805,147760,469012,182033,798805
2023-04-12 19:20,798812,147763,469012,182037,798812
2023-04-12 19:21,798822,147755,469028,182039,798822
2023-04-12 19:22,798828,147758,469031,182039,798828
2023-04-12 19:23,798837,147745,469049,182043,798837
2023-04-12 19:24,798845,147731,469069,182045,798845
2023-04-12 19:25,798854,147736,469069,182049,798854
2023-04-12 19:26,798862,147734,469077,182051,798862
2023-04-12 19:27,798870,147740,469077,182053,798870
2023-04-12 19:28,798880,147728,469097,182055,798880
2023-04-12 19:29,798890,147734,469097,182059,798890
2023-04-12 19:31,798901,147719,469118,182064,798901
2023-04-12 19:32,798910,147719,469118,182073,798910
2023-04-12 19:33,798918,147704,469140,182074,798918
2023-04-12 19:34,798925,147694,469154,182077,798925
2023-04-12 19:35,798934,147696,469158,182080,798934
2023-04-12 19:36,798944,147689,469170,182085,798944
2023-04-12 19:37,798955,147694,469170,182091,798955
2023-04-12 19:38,798965,147684,469185,182096,798965
2023-04-12 19:39,798974,147680,469196,182098,798974
2023-04-12 19:40,798984,147688,469196,182100,798984
2023-04-12 19:41,798992,147679,469209,182104,798992
2023-04-12 19:42,798999,147678,469210,182111,798999
2023-04-12 19:43,799009,147669,469224,182116,799009
2023-04-12 19:44,799018,147673,469228,182117,799018
2023-04-12 19:45,799026,147679,469228,182119,799026
2023-04-12 19:46,799033,147671,469241,182121,799033
2023-04-12 19:47,799041,147667,469249,182125,799041
2023-04-12 19:48,799049,147671,469249,182129,799049
2023-04-12 19:49,799057,147661,469264,182132,799057
2023-04-12 19:50,799065,147668,469264,182133,799065
2023-04-12 19:51,799072,147656,469281,182135,799072
2023-04-12 19:52,799080,147661,469281,182138,799080
2023-04-12 19:53,799087,147653,469291,182143,799087
2023-04-12 19:54,799094,147652,469296,182146,799094
2023-04-12 19:55,799101,147642,469309,182150,799101
2023-04-12 19:56,799109,147638,469319,182152,799109
2023-04-12 19:57,799116,147638,469319,182159,799116
2023-04-12 19:58,799123,147628,469334,182161,799123
2023-04-12 19:59,799131,147631,469334,182166,799131
2023-04-12 20:00,799152,147643,469341,182168,799152
2023-04-12 20:01,799181,147661,469341,182179,799181
2023-04-12 20:02,799209,147673,469354,182182,799209
2023-04-12 20:03,799238,147698,469354,182186,799238
2023-04-12 20:04,799268,147717,469362,182189,799268
2023-04-12 20:05,799295,147727,469374,182194,799295
2023-04-12 20:06,799322,147751,469374,182197,799322
2023-04-12 20:07,799349,147763,469387,182199,799349
2023-04-12 20:08,799377,147789,469387,182201,799377
2023-04-12 20:09,799405,147805,469397,182203,799405
2023-04-12 20:10,799433,147821,469405,182207,799433
2023-04-12 20:11,799460,147837,469412,182211,799460
2023-04-12 20:12,799488,147863,469412,182213,799488
2023-04-12 20:13,799515,147873,469425,182217,799515
2023-04-12 20:14,799543,147885,469438,182220,799543
2023-04-12 20:15,799571,147907,469438,182226,799571
2023-04-12 20:16,799599,147928,469442,182229,799599
2023-04-12 20:17,799628,147955,469442,182231,799628
2023-04-12 20:19,799656,147972,469450,182234,799656
2023-04-12 20:20,799686,148000,469450,182236,799686
2023-04-12 20:21,799714,148014,469462,182238,799714
2023-04-12 20:22,799743,148038,469462,182243,799743
2023-04-12 20:23,799770,148051,469472,182247,799770
2023-04-12 20:24,799797,148076,469472,182249,799797
2023-04-12 20:25,799824,148093,469480,182251,799824
2023-04-12 20:26,799854,148116,469480,182258,799854
2023-04-12 20:27,799881,148127,469492,182262,799881
2023-04-12 20:28,799908,148144,469498,182266,799908
2023-04-12 20:29,799938,148172,469498,182268,799938
2023-04-12 20:30,799968,148189,469510,182269,799968
2023-04-12 20:31,799994,148209,469515,182270,799994
2023-04-12 20:32,800022,148230,469520,182272,800022
2023-04-12 20:33,800051,148248,469524,182279,800051
2023-04-12 20:34,800079,148265,469530,182284,800079
2023-04-12 20:35,800107,148289,469530,182288,800107
2023-04-12 20:36,800137,148298,469545,182294,800137
2023-04-12 20:37,800165,148314,469551,182300,800165
2023-04-12 20:38,800192,148336,469551,182305,800192
2023-04-12 20:39,800219,148342,469563,182314,800219
2023-04-12 20:40,800248,148369,469563,182316,800248
2023-04-12 20:41,800278,148392,469570,182316,800278
2023-04-12 20:42,800306,148414,469570,182322,800306
2023-04-12 20:43,800335,148431,469575,182329,800335
2023-04-12 20:44,800363,148454,469575,182334,800363
2023-04-12 20:45,800395,148474,469584,182337,800395
2023-04-12 20:46,800423,148498,469584,182341,800423
2023-04-12 20:47,800450,148514,469591,182345,800450
2023-04-12 20:48,800479,148538,469594,182347,800479
2023-04-12 20:49,800506,148561,469594,182351,800506
2023-04-12 20:50,800532,148576,469602,182354,800532
2023-04-12 20:51,800562,148602,469602,182358,800562
2023-04-12 20:52,800589,148615,469612,182362,800589
2023-04-12 20:53,800619,148644,469612,182363,800619
2023-04-12 20:54,800647,148662,469620,182365,800647
2023-04-12 20:55,800677,148686,469620,182371,800677
2023-04-12 20:56,800706,148712,469622,182372,800706
2023-04-12 20:57,800737,148728,469635,182374,800737
2023-04-12 20:58,800764,148747,469635,182382,800764
2023-04-12 20:59,800794,148765,469642,182387,800794
2023-04-12 21:00,800815,148787,469642,182386,800815
2023-04-12 21:01,800834,148792,469651,182391,800834
2023-04-12 21:02,800852,148806,469651,182395,800852
2023-04-12 21:03,800871,148816,469660,182395,800871
2023-04-12 21:04,800889,148830,469660,182399,800889
2023-04-12 21:05,800909,148839,469667,182403,800909
2023-04-12 21:07,800930,148859,469667,182404,800930
2023-04-12 21:08,800947,148862,469675,182410,800947
2023-04-12 21:09,800969,148879,469678,182412,800969
2023-04-12 21:10,800989,148896,469678,182415,800989
2023-04-12 21:11,801006,148906,469682,182418,801006
2023-04-12 21:12,801027,148924,469682,182421,801027
2023-04-12 21:13,801046,148931,469689,182426,801046
2023-04-12 21:14,801066,148940,469699,182427,801066
2023-04-12 21:15,801084,148950,469703,182431,801084
2023-04-12 21:16,801105,148964,469703,182438,801105
2023-04-12 21:17,801126,148970,469715,182441,801126
2023-04-12 21:18,801145,148982,469720,182443,801145
2023-04-12 21:19,801165,148997,469720,182448,801165
2023-04-12 21:20,801182,149002,469730,182450,801182
2023-04-12 21:21,801202,149021,469730,182451,801202
2023-04-12 21:22,801222,149028,469737,182457,801222
2023-04-12 21:23,801240,149038,469743,182459,801240
2023-04-12 21:24,801260,149053,469743,182464,801260
2023-04-12 21:25,801278,149059,469749,182470,801278
2023-04-12 21:26,801296,149074,469749,182473,801296
2023-04-12 21:27,801315,149076,469761,182478,801315
2023-04-12 21:28,801335,149091,469761,182483,801335
2023-04-12 21:29,801355,149101,469769,182485,801355
2023-04-12 21:30,801374,149113,469769,182492,801374
2023-04-12 21:31,801393,149116,469781,182496,801393
2023-04-12 21:32,801410,149129,469781,182500,801410
2023-04-12 21:33,801429,149131,469794,182504,801429
2023-04-12 21:34,801448,149145,469794,182509,801448
2023-04-12 21:35,801466,149150,469803,182513,801466
2023-04-12 21:36,801486,149161,469807,182518,801486
2023-04-12 21:37,801505,149175,469810,182520,801505
2023-04-12 21:38,801524,149175,469820,182529,801524
2023-04-12 21:39,801544,149187,469825,182532,801544
2023-04-12 21:40,801562,149193,469831,182538,801562
2023-04-12 21:41,801579,149197,469840,182542,801579
2023-04-12 21:42,801599,149215,469840,182544,801599
2023-04-12 21:43,801619,149225,469848,182546,801619
2023-04-12 21:44,801641,149232,469854,182555,801641
2023-04-12 21:45,801661,149244,469859,182558,801661
2023-04-12 21:46,801680,149258,469859,182563,801680
2023-04-12 21:47,801700,149267,469866,182567,801700
2023-04-12 21:48,801720,149286,469866,182568,801720
2023-04-12 21:49,801739,149291,469877,182571,801739
2023-04-12 21:50,801758,149302,469877,182579,801758
2023-04-12 21:51,801780,149314,469885,182581,801780
2023-04-12 21:52,801799,149325,469890,182584,801799
2023-04-12 21:54,801816,149337,469890,182589,801816
2023-04-12 21:55,801837,149348,469896,182593,801837
2023-04-12 21:56,801857,149360,469899,182598,801857
2023-04-12 21:57,801877,149379,469899,182599,801877
2023-04-12 21:58,801895,149388,469908,182599,801895
2023-04-12 21:59,801916,149405,469908,182603,801916
2023-04-12 22:00,801934,149409,469919,182606,801934
2023-04-12 22:01,801963,149434,469919,182610,801963
2023-04-12 22:02,801990,149443,469931,182616,801990
2023-04-12 22:03,802017,149455,469938,182624,802017
2023-04-12 22:04,802048,149483,469938,182627,802048
2023-04-12 22:05,802076,149500,469944,182632,802076
2023-04-12 22:06,802102,149522,469944,182636,802102
2023-04-12 22:07,802129,149535,469954,182640,802129
2023-04-12 22:08,802158,149562,469955,182641,802158
2023-04-12 22:09,802185,149586,469955,182644,802185
2023-04-12 22:10,802213,149599,469966,182648,802213
2023-04-12 22:11,802240,149625,469966,182649,802240
2023-04-12 22:12,802268,149634,469984,182650,802268
2023-04-12 22:13,802297,149646,469993,182658,802297
2023-04-12 22:14,802326,149653,470010,182663,802326
2023-04-12 22:15,802354,149674,470010,182670,802354
2023-04-12 22:16,802384,149689,470020,182675,802384
2023-04-12 22:17,802411,149707,470023,182681,802411
2023-04-12 22:18,802440,149731,470023,182686,802440
2023-04-12 22:19,802468,149743,470036,182689,802468
2023-04-12 22:20,802496,149768,470036,182692,802496
2023-04-12 22:21,802524,149785,470044,182695,802524
2023-04-12 22:22,802554,149813,470044,182697,802554
2023-04-12 22:23,802583,149834,470052,182697,802583
2023-04-12 22:24,802612,149855,470052,182705,802612
2023-04-12 22:25,802639,149863,470065,182711,802639
2023-04-12 22:26,802668,149882,470068,182718,802668
2023-04-12 22:27,802697,149904,470068,182725,802697
2023-04-12 22:28,802725,149920,470078,182727,802725
2023-04-12 22:29,802752,149945,470078,182729,802752
2023-04-12 22:30,802781,149949,470098,182734,802781
2023-04-12 22:31,802807,149973,470098,182736,802807
2023-04-12 22:32,802834,149989,470105,182740,802834
2023-04-12 22:33,802862,150007,470110,182745,802862
2023-04-12 22:34,802889,150027,470110,182752,802889
2023-04-12 22:35,802917,150048,470115,182754,802917
2023-04-12 22:36,802943,150070,470115,182758,802943
2023-04-12 22:37,802973,150083,470128,182762,802973
2023-04-12 22:38,802999,150104,470128,182767,802999
2023-04-12 22:39,803027,150118,470136,182773,803027
2023-04-12 22:41,803053,150141,470136,182776,803053
2023-04-12 22:42,803081,150159,470142,182780,803081
2023-04-12 22:43,803109,150185,470142,182782,803109
2023-04-12 22:44,803137,150199,470155,182783,803137
2023-04-12 22:45,803164,150217,470159,182788,803164
2023-04-12 22:46,803192,150238,470159,182795,803192
2023-04-12 22:47,803219,150255,470168,182796,803219
2023-04-12 22:48,803249,150284,470168,182797,803249
2023-04-12 22:49,803277,150299,470176,182802,803277
2023-04-12 22:50,803304,150322,470176,182806,803304
2023-04-12 22:51,803333,150333,470188,182812,803333
2023-04-12 22:52,803360,150354,470188,182818,803360
2023-04-12 22:53,803389,150373,470196,182820,803389
2023-04-12 22:54,803417,150392,470202,182823,803417
2023-04-12 22:55,803443,150408,470209,182826,803443
2023-04-12 22:56,803471,150431,470209,182831,803471
2023-04-12 22:57,803498,150444,470215,182839,803498
2023-04-12 22:58,803525,150455,470224,182846,803525
2023-04-12 22:59,803557,150480,470224,182853,803557
2023-04-12 23:00,803584,150497,470233,182854,803584
2023-04-12 23:01,803601,150508,470233,182860,803601
2023-04-12 23:02,803620,150517,470239,182864,803620
2023-04-12 23:03,803638,150530,470241,182867,803638
2023-04-12 23:04,803655,150536,470246,182873,803655
2023-04-12 23:05,803673,150550,470246,182877,803673
2023-04-12 23:06,803690,150554,470253,182883,803690
2023-04-12 23:07,803708,150569,470253,182886,803708
2023-04-12 23:08,803724,150572,470262,182890,803724
2023-04-12 23:09,803741,150585,470262,182894,803741
2023-04-12 23:10,803759,150591,470267,182901,803759
2023-04-12 23:11,803775,150602,470267,182906,803775
2023-04-12 23:12,803795,150610,470275,182910,803795
2023-04-12 23:13,803813,150624,470275,182914,803813
2023-04-12 23:15,803832,150623,470285,182924,803832
2023-04-12 23:16,803869,150657,470285,182927,803869
2023-04-12 23:17,803888,150664,470296,182928,803888
2023-04-12 23:18,803906,150673,470296,182937,803906
2023-04-12 23:19,803923,150673,470304,182946,803923
2023-04-12 23:20,803938,150684,470304,182950,803938
2023-04-12 23:21,803956,150688,470314,182954,803956
2023-04-12 23:22,803973,150701,470314,182958,803973
2023-04-12 23:23,803990,150702,470324,182964,803990
2023-04-12 23:24,804006,150715,470324,182967,804006
2023-04-12 23:25,804026,150724,470331,182971,804026
2023-04-12 23:27,804046,150734,470331,182981,804046
2023-04-12 23:28,804063,150736,470342,182985,804063
2023-04-12 23:29,804080,150750,470342,182988,804080
2023-04-12 23:30,804098,150748,470357,182993,804098
2023-04-12 23:31,804114,150758,470357,182999,804114
2023-04-12 23:32,804132,150761,470368,183003,804132
2023-04-12 23:33,804150,150775,470368,183007,804150
2023-04-12 23:34,804166,150782,470372,183012,804166
2023-04-12 23:35,804186,150793,470377,183016,804186
2023-04-12 23:36,804203,150804,470377,183022,804203
2023-04-12 23:37,804222,150810,470387,183025,804222
2023-04-12 23:38,804240,150820,470387,183033,804240
2023-04-12 23:39,804257,150823,470397,183037,804257
2023-04-12 23:40,804276,150832,470401,183043,804276
2023-04-12 23:41,804293,150836,470409,183048,804293
2023-04-12 23:42,804309,150849,470409,183051,804309
2023-04-12 23:43,804325,150851,470420,183054,804325
2023-04-12 23:44,804344,150864,470420,183060,804344
2023-04-12 23:45,804359,150866,470428,183065,804359
2023-04-12 23:46,804378,150883,470428,183067,804378
2023-04-12 23:47,804395,150887,470439,183069,804395
2023-04-12 23:48,804411,150896,470439,183076,804411
2023-04-12 23:49,804428,150897,470449,183082,804428
2023-04-12 23:50,804449,150913,470449,183087,804449
2023-04-12 23:51,804467,150916,470460,183091,804467
2023-04-12 23:52,804485,150930,470460,183095,804485
2023-04-12 23:53,804501,150938,470466,183097,804501
2023-04-12 23:54,804519,150948,470471,183100,804519
2023-04-12 23:55,804535,150954,470471,183110,804535
2023-04-12 23:56,804551,150958,470478,183115,804551
2023-04-12 23:57,804569,150972,470478,183119,804569
2023-04-12 23:58,804587,150973,470493,183121,804587
2023-04-12 23:59,804604,150987,470493,183124,804604
2023-04-13 00:00,804621,150991,470500,183130,804621
2023-04-13 00:01,804637,151004,470500,183133,804637
2023-04-13 00:02,804652,151006,470505,183141,804652
2023-04-13 00:03,804666,151014,470505,183147,804666
2023-04-13 00:04,804683,151016,470513,183154,804683
2023-04-13 00:05,804698,151029,470513,183156,804698
2023-04-13 00:06,804713,151029,470519,183165,804713
2023-04-13 00:07,804727,151038,470522,183167,804727
2023-04-13 00:08,804743,151047,470526,183170,804743
2023-04-13 00:09,804758,151062,470526,183170,804758
2023-04-13 00:10,804775,151065,470535,183175,804775
2023-04-13 00:11,804790,151079,470535,183176,804790
2023-04-13 00:12,804806,151083,470542,183181,804806
2023-04-13 00:13,804821,151096,470542,183183,804821
2023-04-13 00:15,804838,151095,470553,183190,804838
2023-04-13 00:16,804853,151107,470553,183193,804853
2023-04-13 00:17,804868,151104,470563,183201,804868
2023-04-13 00:18,804883,151115,470563,183205,804883
2023-04-13 00:19,804898,151117,470573,183208,804898
2023-04-13 00:20,804916,151132,470573,183211,804916
2023-04-13 00:21,804930,151137,470579,183214,804930
2023-04-13 00:22,804945,151147,470579,183219,804945
2023-04-13 00:23,804962,151150,470589,183223,804962
2023-04-13 00:24,804976,151159,470591,183226,804976
2023-04-13 00:25,804991,151171,470591,183229,804991
2023-04-13 00:26,805007,151183,470592,183232,805007
2023-04-13 00:27,805023,151194,470592,183237,805023
2023-04-13 00:28,805037,151199,470597,183241,805037
2023-04-13 00:29,805052,151209,470597,183246,805052
2023-04-13 00:30,805066,151208,470607,183251,805066
2023-04-13 00:31,805081,151221,470607,183253,805081
2023-04-13 00:32,805096,151226,470612,183258,805096
2023-04-13 00:33,805111,151239,470612,183260,805111
2023-04-13 00:34,805125,151249,470616,183260,805125
2023-04-13 00:35,805139,151261,470616,183262,805139
2023-04-13 00:36,805155,151262,470629,183264,805155
2023-04-13 00:37,805169,151273,470629,183267,805169
2023-04-13 00:38,805185,151276,470637,183272,805185
2023-04-13 00:39,805199,151284,470637,183278,805199
2023-04-13 00:40,805215,151293,470639,183283,805215
2023-04-13 00:41,805229,151305,470639,183285,805229
2023-04-13 00:42,805244,151310,470645,183289,805244
2023-04-13 00:43,805259,151320,470645,183294,805259
2023-04-13 00:44,805275,151323,470655,183297,805275
2023-04-13 00:45,805292,151339,470655,183298,805292
2023-04-13 00:46,805307,151345,470661,183301,805307
2023-04-13 00:47,805321,151354,470661,183306,805321
2023-04-13 00:48,805335,151356,470666,183313,805335
2023-04-13 00:49,805352,151373,470666,183313,805352
2023-04-13 00:50,805366,151381,470669,183316,805366
2023-04-13 00:51,805380,151393,470669,183318,805380
2023-04-13 00:52,805396,151399,470678,183319,805396
2023-04-13 00:53,805411,151410,470679,183322,805411
2023-04-13 00:54,805425,151424,470679,183322,805425
2023-04-13 00:55,805441,151424,470691,183326,805441
2023-04-13 00:56,805456,151437,470691,183328,805456
2023-04-13 00:57,805469,151437,470700,183332,805469
2023-04-13 00:58,805486,151452,470700,183334,805486
2023-04-13 00:59,805500,151457,470707,183336,805500
2023-04-13 01:00,805507,151459,470707,183341,805507
2023-04-13 01:01,805514,151464,470707,183343,805514
2023-04-13 01:03,805519,151461,470714,183344,805519
2023-04-13 01:04,805525,151462,470714,183349,805525
2023-04-13 01:05,805530,151457,470721,183352,805530
2023-04-13 01:06,805535,151459,470721,183355,805535
2023-04-13 01:07,805541,151463,470721,183357,805541
2023-04-13 01:08,805548,151468,470721,183359,805548
2023-04-13 01:09,805554,151471,470721,183362,805554
2023-04-13 01:10,805559,151471,470721,183367,805559
2023-04-13 01:11,805564,151474,470721,183369,805564
2023-04-13 01:12,805569,151477,470721,183371,805569
2023-04-13 01:13,805576,151481,470721,183374,805576
2023-04-13 01:14,805583,151485,470721,183377,805583
2023-04-13 01:15,805589,151458,470750,183381,805589
2023-04-13 01:16,805595,151461,470750,183384,805595
2023-04-13 01:17,805600,151453,470759,183388,805600
2023-04-13 01:18,805605,151457,470759,183389,805605
2023-04-13 01:19,805611,151459,470761,183391,805611
2023-04-13 01:20,805616,151462,470761,183393,805616
2023-04-13 01:21,805623,151461,470767,183395,805623
2023-04-13 01:22,805630,151466,470767,183397,805630
2023-04-13 01:23,805635,151463,470774,183398,805635
2023-04-13 01:24,805642,151465,470774,183403,805642
2023-04-13 01:25,805648,151463,470779,183406,805648
2023-04-13 01:26,805654,151467,470779,183408,805654
2023-04-13 01:27,805661,151471,470780,183410,805661
2023-04-13 01:28,805667,151475,470780,183412,805667
2023-04-13 01:29,805673,151474,470785,183414,805673
2023-04-13 01:30,805678,151479,470785,183414,805678
2023-04-13 01:31,805684,151480,470789,183415,805684
2023-04-13 01:32,805689,151483,470789,183417,805689
2023-04-13 01:33,805696,151482,470794,183420,805696
2023-04-13 01:34,805701,151483,470796,183422,805701
2023-04-13 01:35,805707,151488,470796,183423,805707
2023-04-13 01:36,805712,151489,470799,183424,805712
2023-04-13 01:37,805717,151493,470799,183425,805717
2023-04-13 01:38,805723,151494,470800,183429,805723
2023-04-13 01:39,805728,151497,470800,183431,805728
2023-04-13 01:40,805733,151495,470805,183433,805733
2023-04-13 01:41,805739,151499,470805,183435,805739
2023-04-13 01:42,805744,151499,470808,183437,805744
2023-04-13 01:43,805749,151504,470808,183437,805749
2023-04-13 01:44,805755,151502,470814,183439,805755
2023-04-13 01:45,805760,151507,470814,183439,805760
2023-04-13 01:46,805765,151507,470818,183440,805765
2023-04-13 01:47,805770,151511,470818,183441,805770
2023-04-13 01:48,805776,151510,470824,183442,805776
2023-04-13 01:49,805781,151511,470824,183446,805781
2023-04-13 01:50,805787,151514,470825,183448,805787
2023-04-13 01:51,805793,151516,470825,183452,805793
2023-04-13 01:52,805799,151515,470830,183454,805799
2023-04-13 01:54,805806,151520,470830,183456,805806
2023-04-13 01:55,805812,151523,470831,183458,805812
2023-04-13 01:56,805818,151527,470831,183460,805818
2023-04-13 01:57,805823,151530,470833,183460,805823
2023-04-13 01:58,805829,151535,470833,183461,805829
2023-04-13 01:59,805835,151535,470838,183462,805835
2023-04-13 02:00,805841,151539,470838,183464,805841
2023-04-13 02:01,805851,151544,470841,183466,805851
2023-04-13 02:02,805862,151552,470841,183469,805862
2023-04-13 02:03,805873,151556,470848,183469,805873
2023-04-13 02:04,805885,151566,470848,183471,805885
2023-04-13 02:05,805896,151575,470849,183472,805896
2023-04-13 02:06,805907,151584,470849,183474,805907
2023-04-13 02:07,805918,151592,470852,183474,805918
2023-04-13 02:08,805928,151600,470852,183476,805928
2023-04-13 02:09,805939,151607,470854,183478,805939
2023-04-13 02:10,805951,151618,470854,183479,805951
2023-04-13 02:11,805962,151623,470858,183481,805962
2023-04-13 02:12,805972,151631,470858,183483,805972
2023-04-13 02:13,805983,151641,470858,183484,805983
2023-04-13 02:14,805994,151651,470858,183485,805994
2023-04-13 02:15,806005,151662,470858,183485,806005
2023-04-13 02:16,806016,151672,470858,183486,806016
2023-04-13 02:17,806027,151683,470858,183486,806027
2023-04-13 02:18,806038,151692,470858,183488,806038
2023-04-13 02:19,806049,151702,470858,183489,806049
2023-04-13 02:20,806060,151710,470858,183492,806060
2023-04-13 02:21,806072,151714,470865,183493,806072
2023-04-13 02:22,806083,151723,470865,183495,806083
2023-04-13 02:23,806094,151733,470865,183496,806094
2023-04-13 02:24,806106,151745,470865,183496,806106
2023-04-13 02:25,806117,151752,470866,183499,806117
2023-04-13 02:26,806128,151763,470866,183499,806128
2023-04-13 02:27,806139,151771,470868,183500,806139
2023-04-13 02:28,806150,151780,470868,183502,806150
2023-04-13 02:29,806161,151787,470871,183503,806161
2023-04-13 02:30,806171,151797,470871,183503,806171
2023-04-13 02:31,806184,151809,470872,183503,806184
2023-04-13 02:32,806195,151820,470872,183503,806195
2023-04-13 02:33,806205,151829,470873,183503,806205
2023-04-13 02:34,806217,151839,470873,183505,806217
2023-04-13 02:35,806230,151851,470873,183506,806230
2023-04-13 02:36,806242,151860,470873,183509,806242
2023-04-13 02:37,806252,151869,470874,183509,806252
2023-04-13 02:38,806263,151880,470874,183509,806263
2023-04-13 02:39,806274,151888,470877,183509,806274
2023-04-13 02:41,806285,151898,470877,183510,806285
2023-04-13 02:42,806296,151908,470878,183510,806296
2023-04-13 02:43,806308,151917,470880,183511,806308
2023-04-13 02:44,806319,151927,470880,183512,806319
2023-04-13 02:45,806330,151933,470881,183516,806330
2023-04-13 02:46,806342,151945,470881,183516,806342
2023-04-13 02:47,806352,151952,470881,183519,806352
2023-04-13 02:48,806365,151965,470881,183519,806365
2023-04-13 02:49,806376,151975,470882,183519,806376
2023-04-13 02:50,806387,151985,470882,183520,806387
2023-04-13 02:51,806398,151994,470884,183520,806398
2023-04-13 02:52,806409,152003,470884,183522,806409
2023-04-13 02:53,806420,152012,470884,183524,806420
2023-04-13 02:54,806431,152023,470884,183524,806431
2023-04-13 02:55,806442,152031,470886,183525,806442
2023-04-13 02:56,806453,152042,470886,183525,806453
2023-04-13 02:57,806463,152050,470887,183526,806463
2023-04-13 02:58,806475,152061,470887,183527,806475
2023-04-13 02:59,806486,152068,470891,183527,806486
2023-04-13 03:00,806496,152078,470891,183527,806496
2023-04-13 03:01,806506,152086,470892,183528,806506
2023-04-13 03:02,806516,152095,470892,183529,806516
2023-04-13 03:03,806526,152103,470894,183529,806526
2023-04-13 03:04,806535,152112,470894,183529,806535
2023-04-13 03:05,806545,152121,470894,183530,806545
2023-04-13 03:06,806555,152129,470894,183532,806555
2023-04-13 03:07,806564,152137,470894,183533,806564
2023-04-13 03:08,806574,152147,470894,183533,806574
2023-04-13 03:09,806583,152153,470896,183534,806583
2023-04-13 03:10,806592,152162,470896,183534,806592
2023-04-13 03:11,806603,152171,470897,183535,806603
2023-04-13 03:12,806612,152178,470897,183537,806612
2023-04-13 03:13,806621,152183,470899,183539,806621
2023-04-13 03:14,806631,152192,470899,183540,806631
2023-04-13 03:15,806641,152201,470899,183541,806641
2023-04-13 03:16,806650,152209,470899,183542,806650
2023-04-13 03:17,806659,152215,470901,183543,806659
2023-04-13 03:18,806669,152225,470901,183543,806669
2023-04-13 03:19,806679,152233,470903,183543,806679
2023-04-13 03:20,806688,152242,470903,183543,806688
2023-04-13 03:21,806699,152252,470903,183544,806699
2023-04-13 03:22,806708,152260,470903,183545,806708
2023-04-13 03:23,806719,152269,470904,183546,806719
2023-04-13 03:24,806729,152278,470904,183547,806729
2023-04-13 03:25,806739,152286,470906,183547,806739
2023-04-13 03:26,806749,152295,470906,183548,806749
2023-04-13 03:28,806758,152300,470908,183550,806758
2023-04-13 03:29,806768,152310,470908,183550,806768
2023-04-13 03:30,806778,152316,470912,183550,806778
2023-04-13 03:31,806787,152322,470915,183550,806787
2023-04-13 03:32,806797,152330,470915,183552,806797
2023-04-13 03:33,806806,152338,470916,183552,806806
2023-04-13 03:34,806816,152346,470916,183554,806816
2023-04-13 03:35,806826,152355,470917,183554,806826
2023-04-13 03:36,806835,152363,470917,183555,806835
2023-04-13 03:37,806844,152368,470921,183555,806844
2023-04-13 03:38,806854,152377,470921,183556,806854
2023-04-13 03:39,806864,152385,470922,183557,806864
2023-04-13 03:40,806873,152394,470922,183557,806873
2023-04-13 03:41,806883,152400,470924,183559,806883
2023-04-13 03:42,806894,152410,470925,183559,806894
2023-04-13 03:43,806903,152419,470925,183559,806903
2023-04-13 03:44,806912,152425,470927,183560,806912
2023-04-13 03:45,806922,152434,470927,183561,806922
2023-04-13 03:46,806932,152444,470927,183561,806932
2023-04-13 03:47,806941,152452,470927,183562,806941
2023-04-13 03:48,806951,152460,470929,183562,806951
2023-04-13 03:49,806961,152469,470929,183563,806961
2023-04-13 03:50,806970,152478,470929,183563,806970
2023-04-13 03:51,806980,152488,470929,183563,806980
2023-04-13 03:52,806989,152497,470929,183563,806989
2023-04-13 03:53,807000,152508,470929,183563,807000
2023-04-13 03:54,807010,152517,470929,183564,807010
2023-04-13 03:55,807019,152526,470929,183564,807019
2023-04-13 03:56,807028,152535,470929,183564,807028
2023-04-13 03:57,807040,152547,470929,183564,807040
2023-04-13 03:58,807050,152555,470931,183564,807050
2023-04-13 03:59,807060,152565,470931,183564,807060
2023-04-13 04:00,807074,152578,470932,183564,807074
2023-04-13 04:01,807091,152595,470932,183564,807091
2023-04-13 04:02,807108,152611,470932,183565,807108
2023-04-13 04:03,807125,152628,470932,183565,807125
2023-04-13 04:04,807141,152643,470933,183565,807141
2023-04-13 04:05,807157,152658,470933,183566,807157
2023-04-13 04:06,807174,152674,470934,183566,807174
2023-04-13 04:07,807192,152691,470934,183567,807192
2023-04-13 04:08,807209,152706,470935,183568,807209
2023-04-13 04:09,807225,152720,470935,183570,807225
2023-04-13 04:10,807241,152733,470938,183570,807241
2023-04-13 04:11,807258,152749,470938,183571,807258
2023-04-13 04:12,807274,152765,470938,183571,807274
2023-04-13 04:14,807292,152781,470938,183573,807292
2023-04-13 04:15,807308,152794,470939,183575,807308
2023-04-13 04:16,807324,152809,470939,183576,807324
2023-04-13 04:17,807342,152827,470939,183576,807342
2023-04-13 04:18,807358,152841,470939,183578,807358
2023-04-13 04:19,807375,152856,470940,183579,807375
2023-04-13 04:20,807391,152872,470940,183579,807391
2023-04-13 04:21,807410,152890,470940,183580,807410
2023-04-13 04:22,807427,152907,470940,183580,807427
2023-04-13 04:23,807444,152924,470940,183580,807444
2023-04-13 04:24,807460,152940,470940,183580,807460
2023-04-13 04:25,807476,152954,470940,183582,807476
2023-04-13 04:26,807494,152973,470940,183581,807494
2023-04-13 04:27,807510,152989,470940,183581,807510
2023-04-13 04:28,807527,153005,470940,183582,807527
2023-04-13 04:29,807544,153021,470941,183582,807544
2023-04-13 04:30,807561,153037,470941,183583,807561
2023-04-13 04:31,807578,153054,470941,183583,807578
2023-04-13 04:32,807594,153070,470941,183583,807594
2023-04-13 04:33,807611,153086,470942,183583,807611
2023-04-13 04:34,807627,153102,470942,183583,807627
2023-04-13 04:35,807644,153119,470942,183583,807644
2023-04-13 04:36,807660,153133,470943,183584,807660
2023-04-13 04:37,807678,153151,470943,183584,807678
2023-04-13 04:38,807695,153167,470943,183585,807695
2023-04-13 04:39,807711,153183,470943,183585,807711
2023-04-13 04:40,807728,153198,470944,183586,807728
2023-04-13 04:41,807744,153213,470944,183587,807744
2023-04-13 04:42,807761,153227,470947,183587,807761
2023-04-13 04:43,807777,153240,470949,183588,807777
2023-04-13 04:44,807794,153256,470949,183589,807794
2023-04-13 04:45,807811,153269,470951,183591,807811
2023-04-13 04:46,807827,153284,470951,183592,807827
2023-04-13 04:47,807845,153300,470952,183593,807845
2023-04-13 04:48,807861,153316,470952,183593,807861
2023-04-13 04:49,807878,153328,470957,183593,807878
2023-04-13 04:50,807894,153344,470957,183593,807894
2023-04-13 04:51,807910,153359,470957,183594,807910
2023-04-13 04:52,807928,153377,470957,183594,807928
2023-04-13 04:53,807944,153392,470957,183595,807944
2023-04-13 04:54,807961,153409,470957,183595,807961
2023-04-13 04:55,807977,153425,470957,183595,807977
2023-04-13 04:56,807996,153441,470957,183598,807996
2023-04-13 04:57,808013,153458,470957,183598,808013
2023-04-13 04:58,808029,153474,470957,183598,808029
2023-04-13 04:59,808046,153489,470958,183599,808046
2023-04-13 05:01,808069,153512,470958,183599,808069
2023-04-13 05:02,808091,153534,470958,183599,808091
2023-04-13 05:03,808111,153552,470958,183601,808111
2023-04-13 05:04,808132,153571,470959,183602,808132
2023-04-13 05:05,808154,153592,470959,183603,808154
2023-04-13 05:06,808175,153613,470959,183603,808175
2023-04-13 05:07,808196,153634,470959,183603,808196
2023-04-13 05:08,808217,153651,470961,183605,808217
2023-04-13 05:09,808239,153673,470961,183605,808239
2023-04-13 05:10,808260,153693,470962,183605,808260
2023-04-13 05:11,808281,153713,470962,183606,808281
2023-04-13 05:12,808303,153734,470962,183607,808303
2023-04-13 05:13,808324,153755,470962,183607,808324
2023-04-13 05:14,808344,153775,470962,183607,808344
2023-04-13 05:15,808367,153798,470962,183607,808367
2023-04-13 05:16,808387,153818,470962,183607,808387
2023-04-13 05:17,808408,153839,470962,183607,808408
2023-04-13 05:18,808429,153858,470963,183608,808429
2023-04-13 05:19,808450,153878,470963,183609,808450
2023-04-13 05:20,808473,153900,470964,183609,808473
2023-04-13 05:21,808493,153920,470964,183609,808493
2023-04-13 05:22,808515,153941,470965,183609,808515
2023-04-13 05:23,808535,153959,470965,183611,808535
2023-04-13 05:24,808557,153980,470966,183611,808557
2023-04-13 05:25,808578,154001,470966,183611,808578
2023-04-13 05:26,808600,154021,470968,183611,808600
2023-04-13 05:27,808621,154042,470968,183611,808621
2023-04-13 05:28,808643,154063,470968,183612,808643
2023-04-13 05:29,808664,154083,470968,183613,808664
2023-04-13 05:30,808686,154105,470968,183613,808686
2023-04-13 05:31,808707,154126,470968,183613,808707
2023-04-13 05:32,808728,154146,470969,183613,808728
2023-04-13 05:33,808749,154167,470969,183613,808749
2023-04-13 05:34,808770,154188,470969,183613,808770
2023-04-13 05:35,808790,154208,470969,183613,808790
2023-04-13 05:36,808813,154230,470969,183614,808813
2023-04-13 05:37,808833,154250,470969,183614,808833
2023-04-13 05:38,808856,154270,470972,183614,808856
2023-04-13 05:39,808877,154289,470972,183616,808877
2023-04-13 05:40,808897,154309,470972,183616,808897
2023-04-13 05:41,808918,154331,470972,183615,808918
2023-04-13 05:42,808940,154348,470975,183617,808940
2023-04-13 05:43,808961,154369,470975,183617,808961
2023-04-13 05:44,808982,154389,470975,183618,808982
2023-04-13 05:45,809004,154411,470975,183618,809004
2023-04-13 05:46,809025,154429,470978,183618,809025
2023-04-13 05:48,809047,154449,470980,183618,809047
2023-04-13 05:49,809068,154470,470980,183618,809068
2023-04-13 05:50,809088,154486,470983,183619,809088
2023-04-13 05:51,809109,154506,470983,183620,809109
2023-04-13 05:52,809132,154529,470983,183620,809132
2023-04-13 05:53,809153,154550,470983,183620,809153
2023-04-13 05:54,809173,154570,470983,183620,809173
2023-04-13 05:55,809194,154591,470983,183620,809194
2023-04-13 05:56,809217,154614,470983,183620,809217
2023-04-13 05:57,809237,154634,470983,183620,809237
2023-04-13 05:58,809258,154655,470983,183620,809258
2023-04-13 05:59,809280,154677,470983,183620,809280
2023-04-13 06:00,809298,154688,470989,183621,809298
2023-04-13 06:01,809303,154691,470989,183623,809303
2023-04-13 06:02,809309,154697,470989,183623,809309
2023-04-13 06:03,809315,154702,470989,183624,809315
2023-04-13 06:04,809321,154707,470989,183625,809321
2023-04-13 06:05,809327,154712,470989,183626,809327
2023-04-13 06:06,809333,154716,470989,183628,809333
2023-04-13 06:07,809338,154719,470989,183630,809338
2023-04-13 06:08,809345,154723,470992,183630,809345
2023-04-13 06:09,809351,154729,470992,183630,809351
2023-04-13 06:10,809356,154731,470994,183631,809356
2023-04-13 06:11,809362,154736,470994,183632,809362
2023-04-13 06:12,809368,154740,470996,183632,809368
2023-04-13 06:13,809375,154746,470996,183633,809375
2023-04-13 06:14,809381,154752,470996,183633,809381
2023-04-13 06:15,809386,154756,470996,183634,809386
2023-04-13 06:16,809392,154761,470996,183635,809392
2023-04-13 06:17,809398,154765,470996,183637,809398
2023-04-13 06:18,809403,154770,470996,183637,809403
2023-04-13 06:19,809409,154776,470996,183637,809409
2023-04-13 06:20,809415,154770,471007,183638,809415
2023-04-13 06:21,809421,154773,471009,183639,809421
2023-04-13 06:22,809427,154779,471009,183639,809427
2023-04-13 06:23,809433,154784,471010,183639,809433
2023-04-13 06:24,809439,154790,471010,183639,809439
2023-04-13 06:25,809445,154794,471011,183640,809445
2023-04-13 06:26,809451,154799,471011,183641,809451
2023-04-13 06:27,809457,154802,471014,183641,809457
2023-04-13 06:28,809463,154808,471014,183641,809463
2023-04-13 06:29,809468,154813,471014,183641,809468
2023-04-13 06:30,809474,154819,471014,183641,809474
2023-04-13 06:31,809481,154824,471015,183642,809481
2023-04-13 06:32,809486,154829,471015,183642,809486
2023-04-13 06:33,809492,154834,471016,183642,809492
2023-04-13 06:35,809499,154838,471016,183645,809499
2023-04-13 06:36,809505,154840,471019,183646,809505
2023-04-13 06:37,809510,154844,471019,183647,809510
2023-04-13 06:38,809516,154847,471020,183649,809516
2023-04-13 06:39,809522,154852,471020,183650,809522
2023-04-13 06:40,809528,154857,471020,183651,809528
2023-04-13 06:41,809534,154861,471020,183653,809534
2023-04-13 06:42,809539,154866,471019,183654,809539
2023-04-13 06:43,809545,154869,471019,183657,809545
2023-04-13 06:44,809553,154875,471020,183658,809553
2023-04-13 06:45,809559,154881,471020,183658,809559
2023-04-13 06:46,809565,154884,471023,183658,809565
2023-04-13 06:47,809570,154888,471023,183659,809570
2023-04-13 06:48,809576,154889,471027,183660,809576
2023-04-13 06:49,809583,154896,471027,183660,809583
2023-04-13 06:50,809589,154898,471031,183660,809589
2023-04-13 06:51,809595,154903,471031,183661,809595
2023-04-13 06:52,809602,154906,471032,183664,809602
2023-04-13 06:53,809609,154912,471032,183665,809609
2023-04-13 06:54,809615,154915,471034,183666,809615
2023-04-13 06:55,809621,154920,471034,183667,809621
2023-04-13 06:56,809626,154922,471035,183669,809626
2023-04-13 06:57,809632,154928,471035,183669,809632
2023-04-13 06:58,809638,154931,471036,183671,809638
2023-04-13 06:59,809644,154934,471036,183674,809644
2023-04-13 07:00,809652,154937,471039,183676,809652
2023-04-13 07:01,809662,154946,471039,183677,809662
2023-04-13 07:02,809673,154951,471041,183681,809673
2023-04-13 07:03,809683,154960,471041,183682,809683
2023-04-13 07:04,809694,154970,471041,183683,809694
2023-04-13 07:05,809704,154978,471041,183685,809704
2023-04-13 07:06,809716,154985,471041,183690,809716
2023-04-13 07:07,809726,154994,471041,183691,809726
2023-04-13 07:08,809737,155003,471042,183692,809737
2023-04-13 07:09,809747,155011,471042,183694,809747
2023-04-13 07:10,809758,155021,471042,183695,809758
2023-04-13 07:11,809768,155030,471042,183696,809768
2023-04-13 07:12,809779,155035,471044,183700,809779
2023-04-13 07:13,809790,155044,471044,183702,809790
2023-04-13 07:14,809800,155051,471046,183703,809800
2023-04-13 07:15,809811,155062,471046,183703,809811
2023-04-13 07:16,809822,155069,471049,183704,809822
2023-04-13 07:17,809833,155079,471050,183704,809833
2023-04-13 07:18,809843,155089,471050,183704,809843
2023-04-13 07:19,809854,155097,471051,183706,809854
2023-04-13 07:20,809865,155105,471051,183709,809865
2023-04-13 07:22,809876,155111,471054,183711,809876
2023-04-13 07:23,809887,155120,471054,183713,809887
2023-04-13 07:24,809898,155129,471054,183715,809898
2023-04-13 07:25,809908,155137,471054,183717,809908
2023-04-13 07:26,809921,155149,471055,183717,809921
2023-04-13 07:27,809931,155158,471055,183718,809931
2023-04-13 07:28,809942,155166,471058,183718,809942
2023-04-13 07:29,809953,155174,471058,183721,809953
2023-04-13 07:30,809965,155184,471058,183723,809965
2023-04-13 07:31,809977,155193,471058,183726,809977
2023-04-13 07:32,809989,155203,471059,183727,809989
2023-04-13 07:33,810000,155210,471059,183731,810000
2023-04-13 07:34,810011,155216,471061,183734,810011
2023-04-13 07:35,810022,155225,471061,183736,810022
2023-04-13 07:36,810031,155232,471062,183737,810031
2023-04-13 07:37,810042,155242,471062,183738,810042
2023-04-13 07:38,810054,155251,471064,183739,810054
2023-04-13 07:39,810064,155259,471064,183741,810064
2023-04-13 07:40,810074,155267,471064,183743,810074
2023-04-13 07:41,810087,155280,471064,183743,810087
2023-04-13 07:42,810098,155289,471065,183744,810098
2023-04-13 07:43,810108,155298,471065,183745,810108
2023-04-13 07:44,810119,155306,471067,183746,810119
2023-04-13 07:45,810130,155315,471067,183748,810130
2023-04-13 07:46,810141,155321,471071,183749,810141
2023-04-13 07:47,810151,155330,471071,183750,810151
2023-04-13 07:48,810162,155338,471074,183750,810162
2023-04-13 07:49,810174,155346,471074,183754,810174
2023-04-13 07:50,810186,155354,471078,183754,810186
2023-04-13 07:51,810197,155362,471078,183757,810197
2023-04-13 07:52,810207,155369,471079,183759,810207
2023-04-13 07:53,810218,155379,471079,183760,810218
2023-04-13 07:54,810228,155384,471080,183764,810228
2023-04-13 07:55,810242,155395,471080,183767,810242
2023-04-13 07:56,810252,155400,471082,183770,810252
2023-04-13 07:57,810263,155411,471082,183770,810263
2023-04-13 07:58,810274,155410,471086,183778,810274
2023-04-13 07:59,810285,155418,471086,183781,810285
2023-04-13 08:00,810304,155426,471093,183785,810304
2023-04-13 08:01,810326,155446,471093,183787,810326
2023-04-13 08:02,810348,155461,471097,183790,810348
2023-04-13 08:03,810370,155483,471097,183790,810370
2023-04-13 08:04,810392,155501,471099,183792,810392
2023-04-13 08:05,810413,155520,471099,183794,810413
2023-04-13 08:06,810435,155531,471106,183798,810435
2023-04-13 08:07,810456,155551,471106,183799,810456
2023-04-13 08:09,810477,155563,471112,183802,810477
2023-04-13 08:10,810500,155583,471112,183805,810500
2023-04-13 08:11,810522,155594,471117,183811,810522
2023-04-13 08:12,810544,155615,471117,183812,810544
2023-04-13 08:13,810568,155630,471125,183813,810568
2023-04-13 08:14,810589,155646,471125,183818,810589
2023-04-13 08:15,810610,155660,471128,183822,810610
2023-04-13 08:16,810630,155679,471128,183823,810630
2023-04-13 08:17,810652,155696,471130,183826,810652
2023-04-13 08:18,810672,155715,471130,183827,810672
2023-04-13 08:19,810693,155728,471134,183831,810693
2023-04-13 08:20,810715,155746,471134,183835,810715
2023-04-13 08:21,810736,155763,471136,183837,810736
2023-04-13 08:22,810758,155781,471136,183841,810758
2023-04-13 08:23,810780,155797,471140,183843,810780
2023-04-13 08:24,810803,155815,471140,183848,810803
2023-04-13 08:25,810825,155828,471142,183855,810825
2023-04-13 08:26,810847,155849,471142,183856,810847
2023-04-13 08:27,810869,155865,471145,183859,810869
2023-04-13 08:28,810889,155884,471145,183860,810889
2023-04-13 08:29,810911,155902,471147,183862,810911
2023-04-13 08:30,810934,155925,471147,183862,810934
2023-04-13 08:31,810957,155947,471147,183863,810957
2023-04-13 08:32,810980,155967,471147,183866,810980
2023-04-13 08:33,811002,155985,471148,183869,811002
2023-04-13 08:34,811023,156006,471148,183869,811023
2023-04-13 08:35,811045,156020,471152,183873,811045
2023-04-13 08:36,811068,156041,471152,183875,811068
2023-04-13 08:37,811090,156057,471157,183876,811090
2023-04-13 08:38,811110,156073,471157,183880,811110
2023-04-13 08:39,811133,156088,471161,183884,811133
2023-04-13 08:40,811154,156102,471161,183891,811154
2023-04-13 08:41,811180,156120,471166,183894,811180
2023-04-13 08:42,811206,156144,471166,183896,811206
2023-04-13 08:43,811228,156162,471166,183900,811228
2023-04-13 08:44,811250,156183,471166,183901,811250
2023-04-13 08:45,811271,156197,471169,183905,811271
2023-04-13 08:46,811293,156217,471169,183907,811293
2023-04-13 08:47,811313,156228,471175,183910,811313
2023-04-13 08:48,811337,156250,471175,183912,811337
2023-04-13 08:49,811358,156260,471183,183915,811358
2023-04-13 08:50,811380,156280,471183,183917,811380
2023-04-13 08:51,811401,156299,471184,183918,811401
2023-04-13 08:52,811422,156317,471184,183921,811422
2023-04-13 08:53,811444,156333,471187,183924,811444
2023-04-13 08:54,811464,156351,471187,183926,811464
2023-04-13 08:55,811486,156372,471187,183927,811486
2023-04-13 08:57,811505,156387,471187,183931,811505
2023-04-13 08:58,811527,156403,471191,183933,811527
2023-04-13 08:59,811547,156419,471191,183937,811547
2023-04-13 09:00,811569,156432,471198,183939,811569
2023-04-13 09:01,811577,156434,471198,183945,811577
2023-04-13 09:02,811584,156435,471201,183948,811584
2023-04-13 09:03,811594,156440,471201,183953,811594
2023-04-13 09:04,811600,156439,471205,183956,811600
2023-04-13 09:05,811608,156443,471205,183960,811608
2023-04-13 09:06,811614,156433,471215,183966,811614
2023-04-13 09:07,811623,156438,471215,183970,811623
2023-04-13 09:08,811631,156441,471219,183971,811631
2023-04-13 09:09,811638,156440,471223,183975,811638
2023-04-13 09:10,811645,156443,471223,183979,811645
2023-04-13 09:11,811653,156446,471225,183982,811653
2023-04-13 09:12,811660,156450,471225,183985,811660
2023-04-13 09:13,811667,156447,471230,183990,811667
2023-04-13 09:14,811675,156452,471230,183993,811675
2023-04-13 09:15,811684,156455,471232,183997,811684
2023-04-13 09:16,811691,156460,471232,183999,811691
2023-04-13 09:17,811698,156461,471235,184002,811698
2023-04-13 09:18,811705,156464,471235,184006,811705
2023-04-13 09:19,811712,156457,471244,184011,811712
2023-04-13 09:20,811719,156459,471244,184016,811719
2023-04-13 09:21,811727,156460,471249,184018,811727
2023-04-13 09:22,811734,156464,471249,184021,811734
2023-04-13 09:23,811741,156465,471254,184022,811741
2023-04-13 09:24,811748,156470,471254,184024,811748
2023-04-13 09:25,811755,156469,471260,184026,811755
2023-04-13 09:26,811762,156475,471260,184027,811762
2023-04-13 09:27,811769,156477,471262,184030,811769
2023-04-13 09:28,811777,156484,471262,184031,811777
2023-04-13 09:29,811784,156487,471265,184032,811784
2023-04-13 09:30,811791,156490,471265,184036,811791
2023-04-13 09:31,811799,156496,471266,184037,811799
2023-04-13 09:32,811806,156499,471266,184041,811806
2023-04-13 09:33,811815,156502,471269,184044,811815
2023-04-13 09:34,811821,156505,471269,184047,811821
2023-04-13 09:35,811828,156508,471272,184048,811828
2023-04-13 09:36,811835,156508,471272,184055,811835
2023-04-13 09:37,811843,156507,471277,184059,811843
2023-04-13 09:38,811850,156513,471277,184060,811850
2023-04-13 09:39,811858,156518,471279,184061,811858
2023-04-13 09:40,811865,156522,471279,184064,811865
2023-04-13 09:41,811873,156525,471283,184065,811873
2023-04-13 09:42,811880,156531,471283,184066,811880
2023-04-13 09:43,811887,156533,471288,184066,811887
2023-04-13 09:45,811894,156537,471288,184069,811894
2023-04-13 09:46,811901,156539,471290,184072,811901
2023-04-13 09:47,811909,156543,471290,184076,811909
2023-04-13 09:48,811917,156546,471294,184077,811917
2023-04-13 09:49,811926,156550,471294,184082,811926
2023-04-13 09:50,811936,156554,471298,184084,811936
2023-04-13 09:51,811943,156559,471298,184086,811943
2023-04-13 09:52,811950,156555,471305,184090,811950
2023-04-13 09:53,811958,156559,471308,184091,811958
2023-04-13 09:54,811965,156557,471314,184094,811965
2023-04-13 09:55,811972,156563,471314,184095,811972
2023-04-13 09:56,811979,156560,471319,184100,811979
2023-04-13 09:57,811988,156568,471319,184101,811988
2023-04-13 09:58,811996,156566,471326,184104,811996
2023-04-13 09:59,812003,156573,471326,184104,812003
2023-04-13 10:00,812016,156575,471333,184108,812016
2023-04-13 10:01,812036,156593,471333,184110,812036
2023-04-13 10:02,812057,156608,471338,184111,812057
2023-04-13 10:03,812077,156626,471338,184113,812077
2023-04-13 10:04,812100,156641,471343,184116,812100
2023-04-13 10:05,812122,156663,471343,184116,812122
2023-04-13 10:06,812142,156676,471344,184122,812142
2023-04-13 10:07,812164,156693,471344,184127,812164
2023-04-13 10:08,812184,156706,471349,184129,812184
2023-04-13 10:09,812206,156726,471349,184131,812206
2023-04-13 10:10,812227,156737,471354,184136,812227
2023-04-13 10:11,812245,156752,471354,184139,812245
2023-04-13 10:12,812265,156764,471358,184143,812265
2023-04-13 10:13,812287,156783,471360,184144,812287
2023-04-13 10:14,812307,156800,471360,184147,812307
2023-04-13 10:15,812328,156817,471361,184150,812328
2023-04-13 10:16,812351,156837,471361,184153,812351
2023-04-13 10:17,812370,156844,471369,184157,812370
2023-04-13 10:18,812391,156863,471369,184159,812391
2023-04-13 10:19,812412,156877,471372,184163,812412
2023-04-13 10:20,812432,156895,471372,184165,812432
2023-04-13 10:21,812453,156909,471374,184170,812453
2023-04-13 10:22,812475,156929,471374,184172,812475
2023-04-13 10:23,812495,156945,471375,184175,812495
2023-04-13 10:24,812515,156962,471375,184178,812515
2023-04-13 10:25,812537,156975,471382,184180,812537
2023-04-13 10:26,812557,156990,471382,184185,812557
2023-04-13 10:27,812578,157003,471389,184186,812578
2023-04-13 10:28,812598,157021,471389,184188,812598
2023-04-13 10:29,812619,157035,471393,184191,812619
2023-04-13 10:30,812638,157052,471393,184193,812638
2023-04-13 10:31,812659,157060,471400,184199,812659
2023-04-13 10:33,812678,157075,471400,184203,812678
2023-04-13 10:34,812700,157091,471404,184205,812700
2023-04-13 10:35,812719,157105,471404,184210,812719
2023-04-13 10:36,812738,157119,471407,184212,812738
2023-04-13 10:37,812760,157139,471407,184214,812760
2023-04-13 10:38,812781,157154,471410,184217,812781
2023-04-13 10:39,812802,157173,471410,184219,812802
2023-04-13 10:40,812821,157177,471423,184221,812821
2023-04-13 10:41,812843,157196,471423,184224,812843
2023-04-13 10:42,812864,157207,471427,184230,812864
2023-04-13 10:43,812883,157221,471427,184235,812883
2023-04-13 10:44,812903,157232,471434,184237,812903
2023-04-13 10:45,812924,157252,471434,184238,812924
2023-04-13 10:46,812943,157263,471440,184240,812943
2023-04-13 10:47,812963,157282,471440,184241,812963
2023-04-13 10:48,812983,157296,471444,184243,812983
2023-04-13 10:49,813004,157313,471444,184247,813004
2023-04-13 10:50,813026,157327,471451,184248,813026
2023-04-13 10:51,813046,157342,471452,184252,813046
2023-04-13 10:52,813068,157359,471452,184257,813068
2023-04-13 10:53,813089,157369,471457,184263,813089
2023-04-13 10:54,813109,157387,471457,184265,813109
2023-04-13 10:55,813129,157392,471466,184271,813129
2023-04-13 10:56,813148,157408,471466,184274,813148
2023-04-13 10:57,813167,157421,471469,184277,813167
2023-04-13 10:58,813189,157442,471469,184278,813189
2023-04-13 10:59,813209,157452,471474,184283,813209
2023-04-13 11:00,813226,157468,471474,184284,813226
2023-04-13 11:01,813237,157466,471480,184291,813237
2023-04-13 11:02,813247,157474,471480,184293,813247
2023-04-13 11:03,813258,157478,471484,184296,813258
2023-04-13 11:04,813268,157486,471484,184298,813268
2023-04-13 11:05,813279,157486,471490,184303,813279
2023-04-13 11:06,813290,157492,471490,184308,813290
2023-04-13 11:07,813300,157491,471497,184312,813300
2023-04-13 11:08,813311,157497,471499,184315,813311
2023-04-13 11:09,813321,157498,471506,184317,813321
2023-04-13 11:10,813330,157507,471506,184317,813330
2023-04-13 11:11,813339,157511,471509,184319,813339
2023-04-13 11:12,813349,157514,471513,184322,813349
2023-04-13 11:13,813359,157520,471513,184326,813359
2023-04-13 11:14,813369,157520,471519,184330,813369
2023-04-13 11:15,813379,157528,471519,184332,813379
2023-04-13 11:16,813390,157525,471528,184337,813390
2023-04-13 11:17,813401,157535,471528,184338,813401
2023-04-13 11:18,813410,157529,471540,184341,813410
2023-04-13 11:19,813420,157537,471540,184343,813420
2023-04-13 11:21,813429,157537,471547,184345,813429
2023-04-13 11:22,813439,157545,471547,184347,813439
2023-04-13 11:23,813449,157549,471548,184352,813449
2023-04-13 11:24,813460,157559,471548,184353,813460
2023-04-13 11:25,813471,157563,471550,184358,813471
2023-04-13 11:26,813481,157570,471550,184361,813481
2023-04-13 11:27,813490,157569,471559,184362,813490
2023-04-13 11:28,813500,157578,471559,184363,813500
2023-04-13 11:29,813512,157585,471562,184365,813512
2023-04-13 11:30,813521,157584,471565,184372,813521
2023-04-13 11:31,813531,157592,471565,184374,813531
2023-04-13 11:32,813541,157594,471570,184377,813541
2023-04-13 11:33,813551,157601,471570,184380,813551
2023-04-13 11:34,813560,157605,471572,184383,813560
2023-04-13 11:35,813570,157613,471572,184385,813570
2023-04-13 11:36,813580,157618,471575,184387,813580
2023-04-13 11:37,813589,157624,471575,184390,813589
2023-04-13 11:38,813599,157629,471579,184391,813599
2023-04-13 11:39,813611,157640,471579,184392,813611
2023-04-13 11:40,813620,157639,471584,184397,813620
2023-04-13 11:41,813630,157643,471584,184403,813630
2023-04-13 11:42,813639,157644,471591,184404,813639
2023-04-13 11:43,813649,157653,471591,184405,813649
2023-04-13 11:44,813659,157656,471596,184407,813659
2023-04-13 11:45,813669,157664,471596,184409,813669
2023-04-13 11:46,813679,157662,471603,184414,813679
2023-04-13 11:47,813689,157670,471603,184416,813689
2023-04-13 11:48,813701,157666,471612,184423,813701
2023-04-13 11:49,813711,157673,471612,184426,813711
2023-04-13 11:50,813721,157668,471622,184431,813721
2023-04-13 11:51,813732,157678,471622,184432,813732
2023-04-13 11:52,813742,157677,471627,184438,813742
2023-04-13 11:53,813752,157682,471627,184443,813752
2023-04-13 11:54,813764,157692,471629,184443,813764
2023-04-13 11:55,813774,157699,471629,184446,813774
2023-04-13 11:56,813785,157699,471632,184454,813785
2023-04-13 11:57,813795,157705,471632,184458,813795
2023-04-13 11:58,813808,157708,471638,184462,813808
2023-04-13 11:59,813817,157709,471638,184470,813817
2023-04-13 12:00,813835,157709,471651,184475,813835
2023-04-13 12:01,813852,157722,471651,184479,813852
2023-04-13 12:02,813871,157732,471656,184483,813871
2023-04-13 12:03,813891,157745,471658,184488,813891
2023-04-13 12:04,813910,157756,471658,184496,813910
2023-04-13 12:05,813927,157763,471667,184497,813927
2023-04-13 12:06,813946,157776,471667,184503,813946
2023-04-13 12:08,813964,157788,471668,184508,813964
2023-04-13 12:09,813986,157810,471668,184508,813986
2023-04-13 12:10,814006,157817,471676,184513,814006
2023-04-13 12:11,814024,157832,471676,184516,814024
2023-04-13 12:12,814042,157834,471688,184520,814042
2023-04-13 12:13,814062,157848,471688,184526,814062
2023-04-13 12:14,814079,157862,471688,184529,814079
2023-04-13 12:15,814097,157866,471702,184529,814097
2023-04-13 12:16,814117,157880,471704,184533,814117
2023-04-13 12:17,814136,157895,471704,184537,814136
2023-04-13 12:18,814156,157901,471715,184540,814156
2023-04-13 12:19,814173,157917,471715,184541,814173
2023-04-13 12:20,814191,157919,471728,184544,814191
2023-04-13 12:21,814210,157932,471728,184550,814210
2023-04-13 12:22,814229,157943,471735,184551,814229
2023-04-13 12:23,814246,157953,471735,184558,814246
2023-04-13 12:24,814265,157959,471740,184566,814265
2023-04-13 12:25,814284,157974,471740,184570,814284
2023-04-13 12:26,814303,157981,471748,184574,814303
2023-04-13 12:27,814321,157995,471748,184578,814321
2023-04-13 12:28,814341,158006,471750,184585,814341
2023-04-13 12:29,814362,158022,471750,184590,814362
2023-04-13 12:30,814380,158034,471755,184591,814380
2023-04-13 12:31,814400,158052,471755,184593,814400
2023-04-13 12:32,814418,158055,471765,184598,814418
2023-04-13 12:33,814438,158073,471765,184600,814438
2023-04-13 12:34,814456,158082,471773,184601,814456
2023-04-13 12:35,814473,158096,471773,184604,814473
2023-04-13 12:36,814491,158101,471784,184606,814491
2023-04-13 12:37,814510,158115,471784,184611,814510
2023-04-13 12:38,814528,158118,471796,184614,814528
2023-04-13 12:39,814546,158135,471796,184615,814546
2023-04-13 12:40,814566,158143,471801,184622,814566
2023-04-13 12:41,814584,158157,471801,184626,814584
2023-04-13 12:42,814603,158170,471804,184629,814603
2023-04-13 12:43,814622,158182,471804,184636,814622
2023-04-13 12:44,814643,158195,471808,184640,814643
2023-04-13 12:45,814662,158211,471808,184643,814662
2023-04-13 12:46,814680,158214,471818,184648,814680
2023-04-13 12:47,814698,158230,471818,184650,814698
2023-04-13 12:48,814717,158243,471821,184653,814717
2023-04-13 12:49,814736,158257,471821,184658,814736
2023-04-13 12:50,814754,158262,471831,184661,814754
2023-04-13 12:51,814776,158277,471831,184668,814776
2023-04-13 12:52,814793,158279,471843,184671,814793
2023-04-13 12:53,814814,158295,471844,184675,814814
2023-04-13 12:54,814831,158306,471844,184681,814831
2023-04-13 12:56,814850,158307,471852,184691,814850
2023-04-13 12:57,814869,158325,471852,184692,814869
2023-04-13 12:58,814886,158332,471857,184697,814886
2023-04-13 12:59,814904,158347,471857,184700,814904
2023-04-13 13:00,814929,158362,471860,184707,814929
2023-04-13 13:01,814936,158365,471860,184711,814936
2023-04-13 13:02,814943,158358,471870,184715,814943
2023-04-13 13:03,814949,158360,471870,184719,814949
2023-04-13 13:05,814956,158358,471872,184726,814956
2023-04-13 13:06,814964,158361,471872,184731,814964
2023-04-13 13:07,814970,158359,471878,184733,814970
2023-04-13 13:08,814976,158359,471878,184739,814976
2023-04-13 13:09,814983,158360,471883,184740,814983
2023-04-13 13:10,814989,158363,471883,184743,814989
2023-04-13 13:11,814996,158364,471887,184745,814996
2023-04-13 13:12,815003,158369,471887,184747,815003
2023-04-13 13:13,815009,158368,471892,184749,815009
2023-04-13 13:14,815016,158374,471892,184750,815016
2023-04-13 13:15,815022,158365,471903,184754,815022
2023-04-13 13:16,815028,158366,471903,184759,815028
2023-04-13 13:17,815034,158365,471909,184760,815034
2023-04-13 13:18,815041,158370,471909,184762,815041
2023-04-13 13:19,815047,158369,471914,184764,815047
2023-04-13 13:20,815054,158372,471914,184768,815054
2023-04-13 13:21,815060,158372,471919,184769,815060
2023-04-13 13:22,815066,158376,471920,184770,815066
2023-04-13 13:23,815073,158381,471920,184772,815073
2023-04-13 13:24,815083,158381,471926,184776,815083
2023-04-13 13:25,815089,158386,471926,184777,815089
2023-04-13 13:26,815096,158390,471926,184780,815096
2023-04-13 13:27,815103,158393,471926,184784,815103
2023-04-13 13:28,815109,158396,471926,184787,815109
2023-04-13 13:29,815116,158386,471939,184791,815116
2023-04-13 13:30,815122,158387,471939,184796,815122
2023-04-13 13:31,815129,158383,471947,184799,815129
2023-04-13 13:32,815137,158386,471949,184802,815137
2023-04-13 13:33,815144,158391,471949,184804,815144
2023-04-13 13:34,815153,158389,471957,184807,815153
2023-04-13 13:35,815160,158394,471957,184809,815160
2023-04-13 13:36,815168,158399,471960,184809,815168
2023-04-13 13:37,815175,158404,471960,184811,815175
2023-04-13 13:38,815183,158402,471965,184816,815183
2023-04-13 13:39,815189,158401,471968,184820,815189
2023-04-13 13:40,815196,158407,471968,184821,815196
2023-04-13 13:41,815203,158402,471976,184825,815203
2023-04-13 13:42,815210,158405,471976,184829,815210
2023-04-13 13:43,815217,158407,471979,184831,815217
2023-04-13 13:44,815227,158408,471984,184835,815227
2023-04-13 13:45,815233,158413,471984,184836,815233
2023-04-13 13:46,815241,158414,471990,184837,815241
2023-04-13 13:47,815249,158420,471990,184839,815249
2023-04-13 13:48,815257,158424,471993,184840,815257
2023-04-13 13:49,815264,158427,471993,184844,815264
2023-04-13 13:50,815270,158429,471995,184846,815270
2023-04-13 13:52,815277,158432,471995,184850,815277
2023-04-13 13:53,815284,158435,471997,184852,815284
2023-04-13 13:54,815290,158440,471997,184853,815290
2023-04-13 13:55,815298,158443,471999,184856,815298
2023-04-13 13:56,815306,158449,471999,184858,815306
2023-04-13 13:57,815312,158445,472005,184862,815312
2023-04-13 13:58,815320,158449,472005,184866,815320
2023-04-13 13:59,815327,158450,472009,184868,815327
2023-04-13 14:00,815335,158455,472009,184871,815335
2023-04-13 14:01,815352,158463,472015,184874,815352
2023-04-13 14:02,815366,158477,472015,184874,815366
2023-04-13 14:03,815382,158487,472017,184878,815382
2023-04-13 14:04,815398,158499,472017,184882,815398
2023-04-13 14:05,815413,158506,472024,184883,815413
2023-04-13 14:06,815427,158516,472026,184885,815427
2023-04-13 14:07,815442,158527,472026,184889,815442
2023-04-13 14:08,815457,158530,472033,184894,815457
2023-04-13 14:09,815472,158540,472033,184899,815472
2023-04-13 14:10,815486,158550,472036,184900,815486
2023-04-13 14:11,815501,158560,472036,184905,815501
2023-04-13 14:12,815516,158564,472042,184910,815516
2023-04-13 14:13,815530,158576,472042,184912,815530
2023-04-13 14:14,815547,158586,472046,184915,815547
2023-04-13 14:15,815562,158599,472046,184917,815562
2023-04-13 14:16,815576,158606,472050,184920,815576
2023-04-13 14:17,815591,158619,472050,184922,815591
2023-04-13 14:18,815605,158626,472053,184926,815605
2023-04-13 14:19,815620,158639,472053,184928,815620
2023-04-13 14:20,815634,158633,472067,184934,815634
2023-04-13 14:21,815649,158644,472067,184938,815649
2023-04-13 14:22,815663,158650,472073,184940,815663
2023-04-13 14:23,815676,158663,472073,184940,815676
2023-04-13 14:24,815691,158669,472077,184945,815691
2023-04-13 14:25,815706,158681,472077,184948,815706
2023-04-13 14:26,815720,158690,472078,184952,815720
2023-04-13 14:27,815735,158702,472078,184955,815735
2023-04-13 14:28,815749,158710,472081,184958,815749
2023-04-13 14:29,815763,158720,472081,184962,815763
2023-04-13 14:30,815777,158728,472085,184964,815777
2023-04-13 14:31,815791,158737,472085,184969,815791
2023-04-13 14:32,815806,158749,472086,184971,815806
2023-04-13 14:33,815821,158763,472086,184972,815821
2023-04-13 14:34,815836,158766,472096,184974,815836
2023-04-13 14:35,815850,158778,472096,184976,815850
2023-04-13 14:36,815865,158782,472105,184978,815865
2023-04-13 14:37,815880,158793,472105,184982,815880
2023-04-13 14:38,815896,158794,472112,184990,815896
2023-04-13 14:40,815910,158807,472112,184991,815910
2023-04-13 14:41,815925,158815,472115,184995,815925
2023-04-13 14:42,815938,158826,472115,184997,815938
2023-04-13 14:43,815952,158836,472118,184998,815952
2023-04-13 14:44,815966,158848,472118,185000,815966
2023-04-13 14:45,815982,158862,472120,185000,815982
2023-04-13 14:46,815996,158873,472123,185000,815996
2023-04-13 14:47,816010,158878,472123,185009,816010
2023-04-13 14:48,816026,158891,472123,185012,816026
2023-04-13 14:49,816040,158895,472130,185015,816040
2023-04-13 14:50,816054,158904,472130,185020,816054
2023-04-13 14:51,816069,158912,472133,185024,816069
2023-04-13 14:52,816084,158925,472133,185026,816084
2023-04-13 14:53,816098,158929,472137,185032,816098
2023-04-13 14:54,816113,158942,472137,185034,816113
2023-04-13 14:55,816127,158947,472142,185038,816127
2023-04-13 14:56,816141,158957,472142,185042,816141
2023-04-13 14:57,816155,158966,472144,185045,816155
2023-04-13 14:58,816170,158979,472144,185047,816170
2023-04-13 14:59,816183,158987,472147,185049,816183
2023-04-13 15:00,816202,159004,472147,185051,816202
2023-04-13 15:01,816223,159015,472151,185057,816223
2023-04-13 15:02,816245,159033,472151,185061,816245
2023-04-13 15:03,816268,159048,472156,185064,816268
2023-04-13 15:04,816291,159066,472156,185069,816291
2023-04-13 15:05,816317,159080,472164,185073,816317
2023-04-13 15:06,816341,159100,472164,185077,816341
2023-04-13 15:07,816362,159114,472167,185081,816362
2023-04-13 15:08,816386,159134,472167,185085,816386
2023-04-13 15:09,816408,159145,472173,185090,816408
2023-04-13 15:10,816430,159164,472173,185093,816430
2023-04-13 15:11,816456,159186,472175,185095,816456
2023-04-13 15:12,816477,159201,472175,185101,816477
2023-04-13 15:13,816502,159214,472182,185106,816502
2023-04-13 15:14,816525,159231,472184,185110,816525
2023-04-13 15:15,816547,159253,472184,185110,816547
2023-04-13 15:16,816571,159273,472186,185112,816571
2023-04-13 15:17,816594,159291,472186,185117,816594
2023-04-13 15:18,816615,159306,472191,185118,816615
2023-04-13 15:19,816639,159327,472191,185121,816639
2023-04-13 15:20,816662,159345,472195,185122,816662
2023-04-13 15:21,816685,159361,472196,185128,816685
2023-04-13 15:22,816707,159379,472196,185132,816707
2023-04-13 15:23,816730,159393,472200,185137,816730
2023-04-13 15:24,816752,159407,472205,185140,816752
2023-04-13 15:25,816775,159425,472205,185145,816775
2023-04-13 15:27,816796,159432,472214,185150,816796
2023-04-13 15:28,816818,159451,472214,185153,816818
2023-04-13 15:29,816842,159468,472219,185155,816842
2023-04-13 15:30,816864,159485,472219,185160,816864
2023-04-13 15:31,816886,159501,472223,185162,816886
2023-04-13 15:32,816908,159519,472223,185166,816908
2023-04-13 15:33,816933,159536,472227,185170,816933
2023-04-13 15:34,816956,159557,472227,185172,816956
2023-04-13 15:35,816977,159569,472233,185175,816977
2023-04-13 15:36,817000,159587,472233,185180,817000
2023-04-13 15:37,817023,159600,472239,185184,817023
2023-04-13 15:38,817045,159619,472239,185187,817045
2023-04-13 15:39,817067,159637,472239,185191,817067
2023-04-13 15:40,817089,159658,472239,185192,817089
2023-04-13 15:41,817113,159680,472239,185194,817113
2023-04-13 15:42,817136,159699,472239,185198,817136
2023-04-13 15:43,817157,159719,472239,185199,817157
2023-04-13 15:44,817180,159739,472239,185202,817180
2023-04-13 15:45,817202,159758,472239,185205,817202
2023-04-13 15:46,817224,159762,472254,185208,817224
2023-04-13 15:47,817247,159777,472255,185215,817247
2023-04-13 15:48,817269,159796,472255,185218,817269
2023-04-13 15:49,817291,159813,472259,185219,817291
2023-04-13 15:50,817313,159834,472259,185220,817313
2023-04-13 15:51,817335,159854,472259,185222,817335
2023-04-13 15:52,817357,159873,472259,185225,817357
2023-04-13 15:53,817381,159897,472259,185225,817381
2023-04-13 15:54,817404,159903,472271,185230,817404
2023-04-13 15:55,817426,159925,472271,185230,817426
2023-04-13 15:56,817450,159939,472277,185234,817450
2023-04-13 15:57,817472,159959,472277,185236,817472
2023-04-13 15:58,817496,159977,472284,185235,817496
2023-04-13 15:59,817518,159997,472284,185237,817518
2023-04-13 16:00,817536,160001,472294,185241,817536
2023-04-13 16:01,817551,160015,472294,185242,817551
2023-04-13 16:02,817567,160025,472297,185245,817567
2023-04-13 16:03,817583,160035,472300,185248,817583
2023-04-13 16:04,817598,160043,472305,185250,817598
2023-04-13 16:05,817614,160057,472305,185252,817614
2023-04-13 16:06,817629,160067,472307,185255,817629
2023-04-13 16:07,817646,160081,472307,185258,817646
2023-04-13 16:08,817664,160090,472313,185261,817664
2023-04-13 16:09,817679,160103,472313,185263,817679
2023-04-13 16:10,817695,160113,472316,185266,817695
2023-04-13 16:11,817712,160126,472316,185270,817712
2023-04-13 16:12,817727,160135,472319,185273,817727
2023-04-13 16:14,817744,160150,472319,185275,817744
2023-04-13 16:15,817760,160162,472323,185275,817760
2023-04-13 16:16,817775,160173,472323,185279,817775
2023-04-13 16:17,817792,160182,472327,185283,817792
2023-04-13 16:18,817806,160195,472327,185284,817806
2023-04-13 16:19,817822,160201,472335,185286,817822
2023-04-13 16:20,817841,160215,472337,185289,817841
2023-04-13 16:21,817858,160229,472338,185291,817858
2023-04-13 16:22,817873,160240,472338,185295,817873
2023-04-13 16:23,817888,160251,472340,185297,817888
2023-04-13 16:24,817905,160263,472340,185302,817905
2023-04-13 16:25,817920,160268,472349,185303,817920
2023-04-13 16:26,817937,160279,472350,185308,817937
2023-04-13 16:27,817952,160294,472350,185308,817952
2023-04-13 16:28,817968,160301,472358,185309,817968
2023-04-13 16:29,817984,160313,472358,185313,817984
2023-04-13 16:30,818000,160321,472364,185315,818000
2023-04-13 16:31,818016,160335,472364,185317,818016
2023-04-13 16:32,818032,160342,472371,185319,818032
2023-04-13 16:33,818047,160353,472371,185323,818047
2023-04-13 16:34,818064,160362,472377,185325,818064
2023-04-13 16:35,818078,160374,472377,185327,818078
2023-04-13 16:36,818095,160385,472379,185331,818095
2023-04-13 16:37,818110,160397,472379,185334,818110
2023-04-13 16:38,818126,160405,472385,185336,818126
2023-04-13 16:39,818143,160420,472385,185338,818143
2023-04-13 16:40,818158,160429,472389,185340,818158
2023-04-13 16:41,818175,160441,472391,185343,818175
2023-04-13 16:42,818190,160451,472391,185348,818190
2023-04-13 16:43,818206,160457,472397,185352,818206
2023-04-13 16:44,818221,160471,472397,185353,818221
2023-04-13 16:45,818238,160480,472402,185356,818238
2023-04-13 16:46,818253,160494,472402,185357,818253
2023-04-13 16:47,818270,160504,472408,185358,818270
2023-04-13 16:48,818285,160517,472408,185360,818285
2023-04-13 16:49,818301,160522,472416,185363,818301
2023-04-13 16:50,818317,160537,472416,185364,818317
2023-04-13 16:51,818333,160544,472423,185366,818333
2023-04-13 16:52,818349,160557,472423,185369,818349
2023-04-13 16:53,818364,160569,472427,185368,818364
2023-04-13 16:54,818379,160582,472427,185370,818379
2023-04-13 16:55,818397,160591,472433,185373,818397
2023-04-13 16:56,818413,160606,472434,185373,818413
2023-04-13 16:57,818428,160620,472434,185374,818428
2023-04-13 16:58,818445,160626,472442,185377,818445
2023-04-13 16:59,818460,160641,472442,185377,818460
2023-04-13 17:00,818480,160653,472448,185379,818480
2023-04-13 17:02,818500,160671,472448,185381,818500
2023-04-13 17:03,818519,160683,472451,185385,818519
2023-04-13 17:04,818539,160701,472451,185387,818539
2023-04-13 17:05,818557,160713,472455,185389,818557
2023-04-13 17:06,818577,160727,472455,185395,818577
2023-04-13 17:07,818596,160736,472463,185397,818596
2023-04-13 17:08,818617,160758,472463,185396,818617
2023-04-13 17:09,818636,160769,472469,185398,818636
2023-04-13 17:10,818656,160786,472469,185401,818656
2023-04-13 17:11,818675,160800,472473,185402,818675
2023-04-13 17:12,818695,160812,472476,185407,818695
2023-04-13 17:13,818716,160831,472477,185408,818716
2023-04-13 17:14,818735,160846,472477,185412,818735
2023-04-13 17:15,818756,160860,472481,185415,818756
2023-04-13 17:16,818777,160881,472481,185415,818777
2023-04-13 17:17,818796,160895,472484,185417,818796
2023-04-13 17:18,818818,160911,472484,185423,818818
2023-04-13 17:19,818839,160921,472491,185427,818839
2023-04-13 17:20,818858,160940,472491,185427,818858
2023-04-13 17:21,818876,160955,472494,185427,818876
2023-04-13 17:22,818898,160976,472494,185428,818898
2023-04-13 17:23,818918,160990,472499,185429,818918
2023-04-13 17:24,818939,161010,472499,185430,818939
2023-04-13 17:25,818959,161020,472505,185434,818959
2023-04-13 17:26,818978,161035,472505,185438,818978
2023-04-13 17:27,819000,161045,472513,185442,819000
2023-04-13 17:28,819021,161063,472513,185445,819021
2023-04-13 17:29,819042,161072,472518,185452,819042
2023-04-13 17:30,819062,161091,472518,185453,819062
2023-04-13 17:31,819084,161107,472522,185455,819084
2023-04-13 17:32,819103,161120,472524,185459,819103
2023-04-13 17:33,819123,161135,472524,185464,819123
2023-04-13 17:34,819144,161148,472528,185468,819144
2023-04-13 17:35,819163,161162,472528,185473,819163
2023-04-13 17:36,819183,161180,472528,185475,819183
2023-04-13 17:37,819202,161194,472528,185480,819202
2023-04-13 17:38,819221,161210,472528,185483,819221
2023-04-13 17:39,819242,161213,472544,185485,819242
2023-04-13 17:40,819261,161230,472543,185488,819261
2023-04-13 17:41,819281,161244,472546,185491,819281
2023-04-13 17:42,819301,161263,472546,185492,819301
2023-04-13 17:43,819319,161274,472551,185494,819319
2023-04-13 17:44,819339,161292,472551,185496,819339
2023-04-13 17:45,819359,161303,472557,185499,819359
2023-04-13 17:46,819378,161318,472557,185503,819378
2023-04-13 17:47,819399,161329,472562,185508,819399
2023-04-13 17:49,819418,161344,472562,185512,819418
2023-04-13 17:50,819437,161358,472565,185514,819437
2023-04-13 17:51,819456,161375,472565,185516,819456
2023-04-13 17:52,819477,161389,472570,185518,819477
2023-04-13 17:53,819496,161401,472574,185521,819496
2023-04-13 17:54,819517,161420,472574,185523,819517
2023-04-13 17:55,819536,161433,472578,185525,819536
2023-04-13 17:56,819556,161447,472578,185531,819556
2023-04-13 17:57,819576,161455,472587,185534,819576
2023-04-13 17:58,819595,161471,472587,185537,819595
2023-04-13 17:59,819614,161482,472594,185538,819614
2023-04-13 18:00,819632,161499,472594,185539,819632
2023-04-13 18:01,819641,161504,472596,185541,819641
2023-04-13 18:02,819651,161510,472596,185545,819651
2023-04-13 18:03,819662,161515,472601,185546,819662
2023-04-13 18:04,819673,161522,472603,185548,819673
2023-04-13 18:05,819682,161525,472607,185550,819682
2023-04-13 18:06,819692,161531,472607,185554,819692
2023-04-13 18:07,819701,161533,472609,185559,819701
2023-04-13 18:08,819711,161543,472609,185559,819711
2023-04-13 18:09,819720,161545,472613,185562,819720
2023-04-13 18:10,819729,161548,472613,185568,819729
2023-04-13 18:11,819739,161551,472619,185569,819739
2023-04-13 18:12,819748,161555,472619,185574,819748
2023-04-13 18:13,819757,161559,472624,185574,819757
2023-04-13 18:14,819766,161566,472624,185576,819766
2023-04-13 18:15,819776,161570,472630,185576,819776
2023-04-13 18:16,819785,161577,472630,185578,819785
2023-04-13 18:17,819795,161579,472635,185581,819795
2023-04-13 18:18,819804,161585,472635,185584,819804
2023-04-13 18:19,819815,161589,472641,185585,819815
2023-04-13 18:20,819825,161598,472641,185586,819825
2023-04-13 18:21,819835,161595,472651,185589,819835
2023-04-13 18:22,819846,161605,472651,185590,819846
2023-04-13 18:23,819857,161608,472655,185594,819857
2023-04-13 18:24,819866,161611,472657,185598,819866
2023-04-13 18:25,819875,161620,472657,185598,819875
2023-04-13 18:26,819885,161621,472663,185601,819885
2023-04-13 18:27,819896,161629,472663,185604,819896
2023-04-13 18:28,819907,161633,472667,185607,819907
2023-04-13 18:29,819917,161640,472667,185610,819917
2023-04-13 18:30,819926,161640,472673,185613,819926
2023-04-13 18:31,819936,161648,472673,185615,819936
2023-04-13 18:32,819946,161651,472677,185618,819946
2023-04-13 18:33,819957,161659,472677,185621,819957
2023-04-13 18:34,819966,161660,472683,185623,819966
2023-04-13 18:35,819975,161662,472685,185628,819975
2023-04-13 18:37,819985,161663,472691,185631,819985
2023-04-13 18:38,819994,161668,472691,185635,819994
2023-04-13 18:39,820005,161675,472694,185636,820005
2023-04-13 18:40,820015,161679,472697,185639,820015
2023-04-13 18:41,820024,161686,472697,185641,820024
2023-04-13 18:42,820033,161684,472705,185644,820033
2023-04-13 18:43,820043,161692,472705,185646,820043
2023-04-13 18:44,820053,161692,472711,185650,820053
2023-04-13 18:45,820063,161697,472711,185655,820063
2023-04-13 18:46,820073,161702,472715,185656,820073
2023-04-13 18:47,820082,161708,472717,185657,820082
2023-04-13 18:48,820093,161717,472717,185659,820093
2023-04-13 18:49,820102,161719,472723,185660,820102
2023-04-13 18:50,820112,161723,472728,185661,820112
2023-04-13 18:51,820121,161719,472737,185665,820121
2023-04-13 18:52,820133,161727,472737,185669,820133
2023-04-13 18:53,820144,161732,472741,185671,820144
2023-04-13 18:54,820155,161736,472741,185678,820155
2023-04-13 18:55,820165,161733,472751,185681,820165
2023-04-13 18:56,820175,161741,472751,185683,820175
2023-04-13 18:57,820184,161744,472755,185685,820184
2023-04-13 18:58,820195,161755,472755,185685,820195
2023-04-13 18:59,820205,161756,472760,185689,820205
2023-04-13 19:00,820214,161764,472760,185690,820214
2023-04-13 19:01,820223,161765,472766,185692,820223
2023-04-13 19:02,820234,161773,472766,185695,820234
2023-04-13 19:03,820246,161776,472775,185695,820246
2023-04-13 19:04,820256,161782,472775,185699,820256
2023-04-13 19:05,820266,161791,472776,185699,820266
2023-04-13 19:06,820277,161793,472783,185701,820277
2023-04-13 19:07,820287,161796,472783,185708,820287
2023-04-13 19:08,820296,161800,472787,185709,820296
2023-04-13 19:09,820307,161806,472787,185714,820307
2023-04-13 19:10,820317,161809,472793,185715,820317
2023-04-13 19:11,820326,161815,472793,185718,820326
2023-04-13 19:12,820337,161818,472798,185721,820337
2023-04-13 19:13,820348,161828,472798,185722,820348
2023-04-13 19:14,820358,161826,472806,185726,820358
2023-04-13 19:15,820369,161826,472808,185735,820369
2023-04-13 19:16,820378,161830,472808,185740,820378
2023-04-13 19:17,820389,161832,472812,185745,820389
2023-04-13 19:18,820398,161837,472812,185749,820398
2023-04-13 19:19,820408,161844,472812,185752,820408
2023-04-13 19:20,820420,161852,472812,185756,820420
2023-04-13 19:21,820431,161854,472819,185758,820431
2023-04-13 19:23,820441,161858,472822,185761,820441
2023-04-13 19:24,820450,161863,472822,185765,820450
2023-04-13 19:25,820460,161866,472828,185766,820460
2023-04-13 19:26,820471,161875,472828,185768,820471
2023-04-13 19:27,820482,161880,472831,185771,820482
2023-04-13 19:28,820492,161884,472831,185777,820492
2023-04-13 19:29,820502,161890,472833,185779,820502
2023-04-13 19:30,820512,161898,472833,185781,820512
2023-04-13 19:31,820521,161904,472835,185782,820521
2023-04-13 19:32,820531,161913,472835,185783,820531
2023-04-13 19:33,820543,161921,472836,185786,820543
2023-04-13 19:34,820554,161931,472836,185787,820554
2023-04-13 19:35,820564,161935,472841,185788,820564
2023-04-13 19:36,820573,161939,472841,185793,820573
2023-04-13 19:37,820585,161944,472846,185795,820585
2023-04-13 19:38,820594,161952,472846,185796,820594
2023-04-13 19:39,820604,161957,472849,185798,820604
2023-04-13 19:40,820614,161963,472849,185802,820614
2023-04-13 19:41,820624,161963,472858,185803,820624
2023-04-13 19:42,820634,161970,472858,185806,820634
2023-04-13 19:43,820643,161969,472865,185809,820643
2023-04-13 19:44,820653,161972,472865,185816,820653
2023-04-13 19:45,820664,161978,472871,185815,820664
2023-04-13 19:46,820676,161990,472871,185815,820676
2023-04-13 19:47,820687,161987,472881,185819,820687
2023-04-13 19:48,820696,161993,472881,185822,820696
2023-04-13 19:49,820708,161996,472888,185824,820708
2023-04-13 19:50,820718,162006,472888,185824,820718
2023-04-13 19:51,820729,162012,472892,185825,820729
2023-04-13 19:52,820739,162020,472892,185827,820739
2023-04-13 19:53,820749,162024,472895,185830,820749
2023-04-13 19:54,820759,162032,472895,185832,820759
2023-04-13 19:55,820768,162033,472899,185836,820768
2023-04-13 19:56,820779,162041,472899,185839,820779
2023-04-13 19:57,820789,162046,472900,185843,820789
2023-04-13 19:58,820799,162053,472902,185844,820799
2023-04-13 19:59,820809,162060,472903,185846,820809
2023-04-13 20:00,820821,162068,472903,185850,820821
2023-04-13 20:01,820836,162073,472906,185857,820836
2023-04-13 20:02,820850,162084,472906,185860,820850
2023-04-13 20:03,820864,162089,472914,185861,820864
2023-04-13 20:04,820879,162097,472915,185867,820879
2023-04-13 20:05,820893,162103,472920,185870,820893
2023-04-13 20:06,820909,162117,472920,185872,820909
2023-04-13 20:07,820923,162123,472924,185876,820923
2023-04-13 20:08,820938,162129,472928,185881,820938
2023-04-13 20:09,820953,162141,472929,185883,820953
2023-04-13 20:11,820966,162151,472929,185886,820966
2023-04-13 20:12,820981,162162,472932,185887,820981
2023-04-13 20:13,820995,162176,472932,185887,820995
2023-04-13 20:14,821009,162182,472937,185890,821009
2023-04-13 20:15,821024,162191,472939,185894,821024
2023-04-13 20:16,821039,162201,472940,185898,821039
2023-04-13 20:17,821056,162207,472946,185903,821056
2023-04-13 20:18,821070,162219,472946,185905,821070
2023-04-13 20:19,821084,162224,472953,185907,821084
2023-04-13 20:20,821100,162238,472953,185909,821100
2023-04-13 20:21,821115,162244,472957,185914,821115
2023-04-13 20:22,821129,162257,472957,185915,821129
2023-04-13 20:23,821143,162267,472960,185916,821143
2023-04-13 20:24,821158,162280,472960,185918,821158
2023-04-13 20:25,821171,162290,472962,185919,821171
2023-04-13 20:26,821186,162303,472962,185921,821186
2023-04-13 20:27,821200,162311,472965,185924,821200
2023-04-13 20:28,821214,162322,472965,185927,821214
2023-04-13 20:29,821231,162335,472968,185928,821231
2023-04-13 20:30,821244,162344,472968,185932,821244
2023-04-13 20:31,821258,162353,472972,185933,821258
2023-04-13 20:32,821273,162364,472972,185937,821273
2023-04-13 20:33,821287,162372,472977,185938,821287
2023-04-13 20:34,821302,162382,472980,185940,821302
2023-04-13 20:35,821316,162395,472980,185941,821316
2023-04-13 20:36,821330,162397,472989,185944,821330
2023-04-13 20:37,821344,162410,472989,185945,821344
2023-04-13 20:38,821359,162418,472992,185949,821359
2023-04-13 20:39,821375,162433,472992,185950,821375
2023-04-13 20:40,821389,162441,472995,185953,821389
2023-04-13 20:41,821403,162441,473001,185961,821403
2023-04-13 20:42,821419,162457,473001,185961,821419
2023-04-13 20:43,821433,162466,473001,185966,821433
2023-04-13 20:44,821448,162475,473005,185968,821448
2023-04-13 20:45,821463,162483,473010,185970,821463
2023-04-13 20:46,821476,162493,473010,185973,821476
2023-04-13 20:47,821492,162499,473016,185977,821492
2023-04-13 20:48,821508,162510,473019,185979,821508
2023-04-13 20:49,821522,162518,473019,185985,821522
2023-04-13 20:50,821539,162524,473029,185986,821539
2023-04-13 20:51,821555,162537,473029,185989,821555
2023-04-13 20:52,821569,162540,473034,185995,821569
2023-04-13 20:53,821583,162553,473034,185996,821583
2023-04-13 20:54,821597,162557,473037,186003,821597
2023-04-13 20:55,821611,162567,473037,186007,821611
2023-04-13 20:57,821626,162574,473042,186010,821626
2023-04-13 20:58,821640,162583,473042,186015,821640
2023-04-13 20:59,821656,162590,473048,186018,821656
2023-04-13 21:00,821670,162597,473048,186025,821670
2023-04-13 21:01,821677,162597,473053,186027,821677
2023-04-13 21:02,821683,162599,473056,186028,821683
2023-04-13 21:03,821689,162603,473056,186030,821689
2023-04-13 21:04,821696,162601,473063,186032,821696
2023-04-13 21:05,821702,162606,473063,186033,821702
2023-04-13 21:06,821709,162602,473072,186035,821709
2023-04-13 21:07,821716,162607,473072,186037,821716
2023-04-13 21:08,821724,162613,473074,186037,821724
2023-04-13 21:09,821731,162618,473074,186039,821731
2023-04-13 21:10,821737,162619,473079,186039,821737
2023-04-13 21:11,821743,162619,473082,186042,821743
2023-04-13 21:12,821749,162618,473082,186049,821749
2023-04-13 21:13,821755,162615,473088,186052,821755
2023-04-13 21:14,821761,162617,473088,186056,821761
2023-04-13 21:15,821767,162617,473093,186057,821767
2023-04-13 21:16,821774,162619,473097,186058,821774
2023-04-13 21:17,821780,162623,473097,186060,821780
2023-04-13 21:18,821786,162618,473102,186066,821786
2023-04-13 21:19,821792,162621,473102,186069,821792
2023-04-13 21:20,821798,162621,473104,186073,821798
2023-04-13 21:21,821804,162626,473104,186074,821804
2023-04-13 21:22,821810,162620,473110,186080,821810
2023-04-13 21:23,821816,162623,473110,186083,821816
2023-04-13 21:24,821822,162621,473115,186086,821822
2023-04-13 21:25,821828,162618,473121,186089,821828
2023-04-13 21:26,821835,162620,473121,186094,821835
2023-04-13 21:27,821842,162617,473128,186097,821842
2023-04-13 21:28,821847,162620,473128,186099,821847
2023-04-13 21:29,821855,162620,473134,186101,821855
2023-04-13 21:30,821862,162625,473134,186103,821862
2023-04-13 21:31,821868,162623,473140,186105,821868
2023-04-13 21:32,821875,162625,473141,186109,821875
2023-04-13 21:33,821883,162630,473141,186112,821883
2023-04-13 21:34,821890,162632,473142,186116,821890
2023-04-13 21:35,821896,162634,473142,186120,821896
2023-04-13 21:36,821902,162632,473148,186122,821902
2023-04-13 21:37,821908,162636,473148,186124,821908
2023-04-13 21:38,821915,162632,473157,186126,821915
2023-04-13 21:39,821921,162632,473157,186132,821921
2023-04-13 21:40,821927,162635,473159,186133,821927
2023-04-13 21:41,821933,162634,473160,186139,821933
2023-04-13 21:43,821939,162635,473160,186144,821939
2023-04-13 21:44,821946,162634,473167,186145,821946
2023-04-13 21:45,821952,162636,473170,186146,821952
2023-04-13 21:46,821958,162639,473170,186149,821958
2023-04-13 21:47,821964,162644,473170,186150,821964
2023-04-13 21:48,821971,162645,473173,186153,821971
2023-04-13 21:49,821977,162642,473176,186159,821977
2023-04-13 21:50,821983,162646,473176,186161,821983
2023-04-13 21:51,821989,162647,473180,186162,821989
2023-04-13 21:52,821995,162648,473180,186167,821995
2023-04-13 21:53,822001,162642,473188,186171,822001
2023-04-13 21:54,822008,162644,473188,186176,822008
2023-04-13 21:55,822014,162640,473196,186178,822014
2023-04-13 21:56,822020,162639,473196,186185,822020
2023-04-13 21:57,822027,162635,473204,186188,822027
2023-04-13 21:58,822033,162635,473204,186194,822033
2023-04-13 21:59,822039,162633,473211,186195,822039
2023-04-13 22:00,822045,162637,473211,186197,822045
2023-04-13 22:01,822051,162632,473217,186202,822051
2023-04-13 22:02,822058,162637,473217,186204,822058
2023-04-13 22:03,822065,162635,473220,186210,822065
2023-04-13 22:04,822071,162636,473221,186214,822071
2023-04-13 22:05,822077,162635,473223,186219,822077
2023-04-13 22:06,822084,162639,473223,186222,822084
2023-04-13 22:07,822090,162633,473229,186228,822090
2023-04-13 22:08,822096,162637,473229,186230,822096
2023-04-13 22:09,822103,162642,473229,186232,822103
2023-04-13 22:10,822110,162647,473229,186234,822110
2023-04-13 22:11,822116,162652,473229,186235,822116
2023-04-13 22:12,822122,162647,473237,186238,822122
2023-04-13 22:13,822128,162649,473237,186242,822128
2023-04-13 22:14,822136,162649,473243,186244,822136
2023-04-13 22:15,822141,162651,473243,186247,822141
2023-04-13 22:16,822148,162643,473251,186254,822148
2023-04-13 22:17,822155,162646,473251,186258,822155
2023-04-13 22:18,822162,162646,473256,186260,822162
2023-04-13 22:19,822169,162650,473256,186263,822169
2023-04-13 22:20,822176,162649,473260,186267,822176
2023-04-13 22:21,822183,162652,473260,186271,822183
2023-04-13 22:22,822189,162647,473266,186276,822189
2023-04-13 22:23,822195,162648,473266,186281,822195
2023-04-13 22:24,822202,162644,473273,186285,822202
2023-04-13 22:25,822209,162642,473278,186289,822209
2023-04-13 22:26,822216,162647,473278,186291,822216
2023-04-13 22:27,822224,162646,473284,186294,822224
2023-04-13 22:28,822230,162648,473284,186298,822230
2023-04-13 22:30,822237,162639,473300,186298,822237
2023-04-13 22:31,822244,162643,473300,186301,822244
2023-04-13 22:32,822250,162643,473304,186303,822250
2023-04-13 22:33,822257,162649,473304,186304,822257
2023-04-13 22:34,822263,162643,473311,186309,822263
2023-04-13 22:35,822269,162642,473311,186316,822269
2023-04-13 22:36,822275,162635,473318,186322,822275
2023-04-13 22:37,822281,162636,473318,186327,822281
2023-04-13 22:38,822287,162626,473327,186334,822287
2023-04-13 22:39,822295,162631,473327,186337,822295
2023-04-13 22:40,822301,162629,473329,186343,822301
2023-04-13 22:41,822307,162633,473330,186344,822307
2023-04-13 22:42,822313,162638,473330,186345,822313
2023-04-13 22:43,822319,162630,473340,186349,822319
2023-04-13 22:44,822326,162635,473340,186351,822326
2023-04-13 22:45,822332,162626,473350,186356,822332
2023-04-13 22:46,822338,162627,473350,186361,822338
2023-04-13 22:47,822345,162622,473359,186364,822345
2023-04-13 22:48,822351,162624,473359,186368,822351
2023-04-13 22:49,822358,162620,473366,186372,822358
2023-04-13 22:50,822364,162620,473366,186378,822364
2023-04-13 22:51,822370,162617,473372,186381,822370
2023-04-13 22:52,822378,162619,473372,186387,822378
2023-04-13 22:53,822384,162615,473377,186392,822384
2023-04-13 22:54,822390,162616,473377,186397,822390
2023-04-13 22:55,822396,162612,473383,186401,822396
2023-04-13 22:56,822403,162615,473383,186405,822403
2023-04-13 22:57,822410,162609,473393,186408,822410
2023-04-13 22:58,822416,162608,473393,186415,822416
2023-04-13 22:59,822422,162599,473406,186417,822422
2023-04-13 23:00,822433,162606,473406,186421,822433
2023-04-13 23:01,822446,162610,473411,186425,822446
2023-04-13 23:02,822461,162623,473411,186427,822461
2023-04-13 23:03,822475,162632,473414,186429,822475
2023-04-13 23:04,822490,162643,473414,186433,822490
2023-04-13 23:05,822506,162647,473422,186437,822506
2023-04-13 23:06,822520,162656,473422,186442,822520
2023-04-13 23:07,822535,162664,473427,186444,822535
2023-04-13 23:08,822549,162666,473433,186450,822549
2023-04-13 23:09,822563,162673,473433,186457,822563
2023-04-13 23:10,822576,162677,473437,186462,822576
2023-04-13 23:11,822591,162688,473439,186464,822591
2023-04-13 23:12,822603,162693,473444,186466,822603
2023-04-13 23:13,822618,162705,473444,186469,822618
2023-04-13 23:14,822631,162711,473450,186470,822631
2023-04-13 23:15,822645,162723,473450,186472,822645
2023-04-13 23:16,822659,162726,473460,186473,822659
2023-04-13 23:18,822672,162736,473460,186476,822672
2023-04-13 23:19,822686,162736,473469,186481,822686
2023-04-13 23:20,822699,162746,473469,186484,822699
2023-04-13 23:21,822713,162747,473476,186490,822713
2023-04-13 23:22,822726,162755,473479,186492,822726
2023-04-13 23:23,822739,162767,473479,186493,822739
2023-04-13 23:24,822754,162772,473484,186498,822754
2023-04-13 23:25,822768,162780,473484,186504,822768
2023-04-13 23:26,822781,162784,473490,186507,822781
2023-04-13 23:27,822794,162791,473490,186513,822794
2023-04-13 23:28,822808,162803,473490,186515,822808
2023-04-13 23:29,822823,162815,473490,186518,822823
2023-04-13 23:30,822836,162826,473490,186520,822836
2023-04-13 23:31,822850,162836,473490,186524,822850
2023-04-13 23:32,822864,162847,473490,186527,822864
2023-04-13 23:33,822879,162858,473490,186531,822879
2023-04-13 23:34,822893,162870,473490,186533,822893
2023-04-13 23:35,822907,162878,473490,186539,822907
2023-04-13 23:36,822922,162867,473513,186542,822922
2023-04-13 23:37,822935,162875,473513,186547,822935
2023-04-13 23:38,822950,162884,473516,186550,822950
2023-04-13 23:39,822963,162894,473516,186553,822963
2023-04-13 23:40,822977,162904,473517,186556,822977
2023-04-13 23:41,822991,162914,473517,186560,822991
2023-04-13 23:42,823006,162922,473519,186565,823006
2023-04-13 23:43,823021,162932,473519,186570,823021
2023-04-13 23:44,823036,162937,473525,186574,823036
2023-04-13 23:45,823049,162945,473525,186579,823049
2023-04-13 23:46,823062,162953,473528,186581,823062
2023-04-13 23:47,823075,162963,473528,186584,823075
2023-04-13 23:48,823090,162968,473534,186588,823090
2023-04-13 23:49,823103,162977,473534,186592,823103
2023-04-13 23:50,823116,162981,473539,186596,823116
2023-04-13 23:51,823129,162986,473543,186600,823129
2023-04-13 23:52,823143,162991,473549,186603,823143
2023-04-13 23:53,823158,163004,473549,186605,823158
2023-04-13 23:54,823172,163006,473556,186610,823172
2023-04-13 23:55,823186,163019,473556,186611,823186
2023-04-13 23:56,823199,163021,473561,186617,823199
2023-04-13 23:57,823213,163035,473561,186617,823213
2023-04-13 23:58,823226,163044,473562,186620,823226
2023-04-13 23:59,823239,163056,473562,186621,823239
2023-04-14 00:00,823248,163058,473567,186623,823248
2023-04-14 00:01,823256,163062,473567,186627,823256
2023-04-14 00:02,823263,163058,473574,186631,823263
2023-04-14 00:03,823272,163066,473574,186632,823272
2023-04-14 00:05,823280,163066,473580,186634,823280
2023-04-14 00:06,823288,163071,473580,186637,823288
2023-04-14 00:07,823295,163068,473589,186638,823295
2023-04-14 00:08,823302,163071,473589,186642,823302
2023-04-14 00:09,823311,163077,473589,186645,823311
2023-04-14 00:10,823319,163081,473589,186649,823319
2023-04-14 00:11,823328,163075,473601,186652,823328
2023-04-14 00:12,823336,163079,473601,186656,823336
2023-04-14 00:13,823343,163076,473605,186662,823343
2023-04-14 00:14,823351,163080,473605,186666,823351
2023-04-14 00:15,823358,163082,473608,186668,823358
2023-04-14 00:16,823366,163088,473608,186670,823366
2023-04-14 00:17,823373,163086,473614,186673,823373
2023-04-14 00:18,823380,163089,473614,186677,823380
2023-04-14 00:19,823388,163091,473617,186680,823388
2023-04-14 00:20,823396,163099,473617,186680,823396
2023-04-14 00:21,823403,163094,473626,186683,823403
2023-04-14 00:22,823411,163101,473626,186684,823411
2023-04-14 00:23,823419,163103,473631,186685,823419
2023-04-14 00:24,823430,163111,473631,186688,823430
2023-04-14 00:25,823440,163112,473637,186691,823440
2023-04-14 00:26,823447,163115,473637,186695,823447
2023-04-14 00:27,823454,163114,473644,186696,823454
2023-04-14 00:28,823462,163119,473644,186699,823462
2023-04-14 00:29,823470,163126,473645,186699,823470
2023-04-14 00:30,823479,163132,473645,186702,823479
2023-04-14 00:31,823486,163134,473648,186704,823486
2023-04-14 00:32,823493,163138,473648,186707,823493
2023-04-14 00:33,823501,163142,473651,186708,823501
2023-04-14 00:34,823509,163147,473651,186711,823509
2023-04-14 00:35,823517,163146,473656,186715,823517
2023-04-14 00:36,823524,163144,473656,186724,823524
2023-04-14 00:37,823531,163143,473660,186728,823531
2023-04-14 00:38,823539,163147,473660,186732,823539
2023-04-14 00:39,823547,163145,473665,186737,823547
2023-04-14 00:40,823555,163152,473665,186738,823555
2023-04-14 00:41,823562,163152,473669,186741,823562
2023-04-14 00:42,823570,163157,473669,186744,823570
2023-04-14 00:43,823577,163157,473672,186748,823577
2023-04-14 00:44,823585,163161,473672,186752,823585
2023-04-14 00:45,823592,163162,473676,186754,823592
2023-04-14 00:46,823599,163168,473676,186755,823599
2023-04-14 00:47,823607,163167,473684,186756,823607
2023-04-14 00:48,823614,163175,473684,186755,823614
2023-04-14 00:49,823621,163172,473692,186757,823621
2023-04-14 00:50,823629,163178,473692,186759,823629
2023-04-14 00:52,823636,163178,473697,186761,823636
2023-04-14 00:53,823644,163180,473702,186762,823644
2023-04-14 00:54,823651,163183,473702,186766,823651
2023-04-14 00:55,823658,163181,473707,186770,823658
2023-04-14 00:56,823666,163189,473707,186770,823666
2023-04-14 00:57,823673,163192,473710,186771,823673
2023-04-14 00:58,823680,163194,473710,186776,823680
2023-04-14 00:59,823688,163197,473713,186778,823688
2023-04-14 01:00,823698,163201,473715,186782,823698
2023-04-14 01:01,823727,163229,473715,186783,823727
2023-04-14 01:02,823757,163249,473719,186789,823757
2023-04-14 01:03,823788,163278,473719,186791,823788
2023-04-14 01:04,823816,163305,473720,186791,823816
2023-04-14 01:05,823847,163334,473720,186793,823847
2023-04-14 01:06,823877,163353,473726,186798,823877
2023-04-14 01:07,823906,163379,473727,186800,823906
2023-04-14 01:08,823937,163405,473727,186805,823937
2023-04-14 01:09,823967,163426,473734,186807,823967
2023-04-14 01:10,823995,163454,473734,186807,823995
2023-04-14 01:11,824027,163481,473736,186810,824027
2023-04-14 01:12,824056,163508,473736,186812,824056
2023-04-14 01:13,824086,163535,473738,186813,824086
2023-04-14 01:14,824115,163563,473738,186814,824115
2023-04-14 01:15,824147,163591,473741,186815,824147
2023-04-14 01:16,824177,163617,473741,186819,824177
2023-04-14 01:17,824206,163642,473744,186820,824206
2023-04-14 01:18,824235,163666,473744,186825,824235
2023-04-14 01:19,824266,163693,473746,186827,824266
2023-04-14 01:20,824295,163722,473746,186827,824295
2023-04-14 01:21,824325,163750,473747,186828,824325
2023-04-14 01:22,824357,163777,473747,186833,824357
2023-04-14 01:23,824386,163803,473749,186834,824386
2023-04-14 01:24,824416,163832,473749,186835,824416
2023-04-14 01:25,824445,163856,473752,186837,824445
2023-04-14 01:26,824474,163883,473752,186839,824474
2023-04-14 01:27,824506,163911,473754,186841,824506
2023-04-14 01:28,824535,163937,473754,186844,824535
2023-04-14 01:29,824564,163962,473756,186846,824564
2023-04-14 01:30,824595,163992,473756,186847,824595
2023-04-14 01:31,824625,164017,473761,186847,824625
2023-04-14 01:32,824655,164046,473761,186848,824655
2023-04-14 01:33,824684,164070,473765,186849,824684
2023-04-14 01:34,824713,164095,473765,186853,824713
2023-04-14 01:35,824745,164120,473769,186856,824745
2023-04-14 01:36,824775,164147,473769,186859,824775
2023-04-14 01:37,824805,164172,473771,186862,824805
2023-04-14 01:39,824833,164198,473771,186864,824833
2023-04-14 01:40,824865,164225,473774,186866,824865
2023-04-14 01:41,824895,164254,473774,186867,824895
2023-04-14 01:42,824925,164279,473778,186868,824925
2023-04-14 01:43,824954,164307,473778,186869,824954
2023-04-14 01:44,824986,164335,473779,186872,824986
2023-04-14 01:45,825015,164361,473782,186872,825015
2023-04-14 01:46,825044,164390,473782,186872,825044
2023-04-14 01:47,825074,164417,473785,186872,825074
2023-04-14 01:48,825104,164446,473785,186873,825104
2023-04-14 01:49,825134,164472,473788,186874,825134
2023-04-14 01:50,825166,164504,473788,186874,825166
2023-04-14 01:51,825196,164531,473791,186874,825196
2023-04-14 01:52,825227,164559,473791,186877,825227
2023-04-14 01:53,825256,164587,473791,186878,825256
2023-04-14 01:54,825286,164616,473791,186879,825286
2023-04-14 01:55,825317,164647,473791,186879,825317
2023-04-14 01:56,825347,164675,473793,186879,825347
2023-04-14 01:57,825376,164699,473793,186884,825376
2023-04-14 01:58,825408,164728,473796,186884,825408
2023-04-14 01:59,825437,164754,473796,186887,825437
2023-04-14 02:00,825463,164775,473798,186890,825463
2023-04-14 02:01,825483,164794,473798,186891,825483
2023-04-14 02:02,825503,164811,473800,186892,825503
2023-04-14 02:03,825525,164830,473800,186895,825525
2023-04-14 02:04,825545,164844,473804,186897,825545
2023-04-14 02:05,825565,164864,473804,186897,825565
2023-04-14 02:06,825587,164884,473805,186898,825587
2023-04-14 02:07,825607,164904,473805,186898,825607
2023-04-14 02:08,825626,164921,473807,186898,825626
2023-04-14 02:09,825647,164940,473807,186900,825647
2023-04-14 02:10,825669,164958,473808,186903,825669
2023-04-14 02:11,825689,164978,473808,186903,825689
2023-04-14 02:12,825710,164994,473812,186904,825710
2023-04-14 02:13,825731,165015,473812,186904,825731
2023-04-14 02:14,825753,165036,473813,186904,825753
2023-04-14 02:15,825773,165054,473813,186906,825773
2023-04-14 02:16,825794,165071,473816,186907,825794
2023-04-14 02:17,825815,165091,473816,186908,825815
2023-04-14 02:18,825835,165108,473817,186910,825835
2023-04-14 02:19,825855,165127,473817,186911,825855
2023-04-14 02:20,825877,165146,473820,186911,825877
2023-04-14 02:21,825896,165162,473820,186914,825896
2023-04-14 02:22,825918,165183,473821,186914,825918
2023-04-14 02:23,825938,165204,473821,186913,825938
2023-04-14 02:24,825959,165224,473822,186913,825959
2023-04-14 02:26,825979,165243,473822,186914,825979
2023-04-14 02:27,826001,165261,473825,186915,826001
2023-04-14 02:28,826021,165279,473825,186917,826021
2023-04-14 02:29,826041,165296,473824,186921,826041
2023-04-14 02:30,826062,165317,473824,186921,826062
2023-04-14 02:31,826082,165334,473826,186922,826082
2023-04-14 02:32,826104,165355,473826,186923,826104
2023-04-14 02:33,826125,165374,473827,186924,826125
2023-04-14 02:34,826145,165393,473827,186925,826145
2023-04-14 02:35,826166,165411,473828,186927,826166
2023-04-14 02:36,826186,165431,473828,186927,826186
2023-04-14 02:37,826207,165449,473831,186927,826207
2023-04-14 02:38,826228,165469,473831,186928,826228
2023-04-14 02:39,826248,165486,473833,186929,826248
2023-04-14 02:40,826268,165506,473833,186929,826268
2023-04-14 02:41,826289,165528,473832,186929,826289
2023-04-14 02:42,826310,165548,473832,186930,826310
2023-04-14 02:43,826331,165566,473834,186931,826331
2023-04-14 02:44,826351,165584,473834,186933,826351
2023-04-14 02:45,826371,165600,473836,186935,826371
2023-04-14 02:46,826391,165619,473836,186936,826391
2023-04-14 02:47,826413,165640,473836,186937,826413
2023-04-14 02:48,826434,165660,473836,186938,826434
2023-04-14 02:49,826454,165679,473836,186939,826454
2023-04-14 02:50,826476,165699,473836,186941,826476
2023-04-14 02:51,826497,165718,473837,186942,826497
2023-04-14 02:52,826516,165737,473837,186942,826516
2023-04-14 02:53,826537,165754,473838,186945,826537
2023-04-14 02:54,826559,165776,473838,186945,826559
2023-04-14 02:55,826578,165792,473840,186946,826578
2023-04-14 02:56,826599,165813,473840,186946,826599
2023-04-14 02:57,826620,165828,473845,186947,826620
2023-04-14 02:58,826640,165847,473845,186948,826640
2023-04-14 02:59,826660,165865,473846,186949,826660
2023-04-14 03:00,826674,165879,473846,186949,826674
2023-04-14 03:01,826686,165890,473847,186949,826686
2023-04-14 03:02,826696,165900,473847,186949,826696
2023-04-14 03:03,826706,165907,473847,186952,826706
2023-04-14 03:04,826716,165917,473847,186952,826716
2023-04-14 03:05,826726,165925,473847,186954,826726
2023-04-14 03:06,826737,165935,473848,186954,826737
2023-04-14 03:07,826747,165945,473848,186954,826747
2023-04-14 03:08,826757,165951,473851,186955,826757
2023-04-14 03:09,826767,165961,473851,186955,826767
2023-04-14 03:10,826779,165973,473851,186955,826779
2023-04-14 03:11,826788,165980,473852,186956,826788
2023-04-14 03:12,826800,165992,473852,186956,826800
2023-04-14 03:14,826810,165999,473855,186956,826810
2023-04-14 03:15,826820,166009,473855,186956,826820
2023-04-14 03:16,826830,166016,473856,186958,826830
2023-04-14 03:17,826841,166027,473856,186958,826841
2023-04-14 03:18,826851,166036,473856,186959,826851
2023-04-14 03:19,826861,166045,473856,186960,826861
2023-04-14 03:20,826871,166052,473859,186960,826871
2023-04-14 03:21,826882,166063,473859,186960,826882
2023-04-14 03:22,826891,166072,473859,186960,826891
2023-04-14 03:23,826902,166082,473859,186961,826902
2023-04-14 03:24,826912,166091,473860,186961,826912
2023-04-14 03:25,826922,166101,473860,186961,826922
2023-04-14 03:26,826932,166110,473860,186962,826932
2023-04-14 03:27,826944,166122,473860,186962,826944
2023-04-14 03:28,826954,166132,473859,186963,826954
2023-04-14 03:29,826964,166141,473859,186964,826964
2023-04-14 03:30,826975,166150,473860,186965,826975
2023-04-14 03:31,826985,166160,473860,186965,826985
2023-04-14 03:32,826995,166170,473860,186965,826995
2023-04-14 03:33,827007,166180,473860,186967,827007
2023-04-14 03:34,827017,166190,473860,186967,827017
2023-04-14 03:35,827027,166200,473860,186967,827027
2023-04-14 03:36,827039,166211,473861,186967,827039
2023-04-14 03:37,827049,166220,473861,186968,827049
2023-04-14 03:38,827059,166229,473862,186968,827059
2023-04-14 03:39,827069,166239,473862,186968,827069
2023-04-14 03:40,827079,166249,473862,186968,827079
2023-04-14 03:41,827090,166259,473862,186969,827090
2023-04-14 03:42,827100,166269,473862,186969,827100
2023-04-14 03:43,827110,166279,473862,186969,827110
2023-04-14 03:44,827120,166287,473863,186970,827120
2023-04-14 03:45,827130,166296,473863,186971,827130
2023-04-14 03:46,827140,166305,473864,186971,827140
2023-04-14 03:47,827150,166315,473864,186971,827150
2023-04-14 03:48,827161,166326,473864,186971,827161
2023-04-14 03:49,827171,166336,473864,186971,827171
2023-04-14 03:50,827181,166343,473866,186972,827181
2023-04-14 03:51,827191,166353,473866,186972,827191
2023-04-14 03:52,827202,166361,473869,186972,827202
2023-04-14 03:53,827212,166371,473869,186972,827212
2023-04-14 03:54,827222,166379,473871,186972,827222
2023-04-14 03:55,827232,166389,473871,186972,827232
2023-04-14 03:56,827243,166400,473871,186972,827243
2023-04-14 03:57,827252,166409,473871,186972,827252
2023-04-14 03:58,827263,166418,473872,186973,827263
2023-04-14 04:00,827273,166428,473872,186973,827273
2023-04-14 04:01,827298,166453,473872,186973,827298
2023-04-14 04:02,827321,166476,473872,186973,827321
2023-04-14 04:03,827346,166500,473873,186973,827346
2023-04-14 04:04,827371,166525,473873,186973,827371
2023-04-14 04:05,827396,166549,473873,186974,827396
2023-04-14 04:06,827421,166573,473873,186975,827421
2023-04-14 04:07,827445,166595,473874,186976,827445
2023-04-14 04:08,827470,166620,473874,186976,827470
2023-04-14 04:09,827493,166639,473877,186977,827493
2023-04-14 04:10,827518,166664,473877,186977,827518
2023-04-14 04:11,827544,166687,473878,186979,827544
2023-04-14 04:12,827569,166711,473878,186980,827569
2023-04-14 04:13,827595,166735,473879,186981,827595
2023-04-14 04:14,827619,166759,473879,186981,827619
2023-04-14 04:15,827643,166782,473880,186981,827643
2023-04-14 04:16,827668,166806,473880,186982,827668
2023-04-14 04:17,827693,166829,473881,186983,827693
2023-04-14 04:18,827719,166855,473881,186983,827719
2023-04-14 04:19,827743,166877,473883,186983,827743
2023-04-14 04:20,827767,166901,473883,186983,827767
2023-04-14 04:21,827791,166924,473884,186983,827791
2023-04-14 04:22,827817,166948,473884,186985,827817
2023-04-14 04:23,827841,166971,473884,186986,827841
2023-04-14 04:24,827865,166994,473884,186987,827865
2023-04-14 04:25,827892,167021,473884,186987,827892
2023-04-14 04:26,827916,167045,473884,186987,827916
2023-04-14 04:27,827940,167065,473887,186988,827940
2023-04-14 04:28,827965,167090,473887,186988,827965
2023-04-14 04:29,827989,167114,473887,186988,827989
2023-04-14 04:30,828015,167140,473887,186988,828015
2023-04-14 04:31,828039,167163,473888,186988,828039
2023-04-14 04:32,828063,167187,473888,186988,828063
2023-04-14 04:33,828087,167210,473889,186988,828087
2023-04-14 04:34,828114,167237,473889,186988,828114
2023-04-14 04:35,828137,167259,473890,186988,828137
2023-04-14 04:36,828161,167283,473890,186988,828161
2023-04-14 04:37,828187,167309,473890,186988,828187
2023-04-14 04:38,828211,167333,473890,186988,828211
2023-04-14 04:39,828236,167357,473891,186988,828236
2023-04-14 04:40,828260,167381,473891,186988,828260
2023-04-14 04:41,828285,167405,473892,186988,828285
2023-04-14 04:42,828308,167428,473892,186988,828308
2023-04-14 04:43,828334,167454,473892,186988,828334
2023-04-14 04:44,828358,167478,473892,186988,828358
2023-04-14 04:46,828383,167502,473893,186988,828383
2023-04-14 04:47,828408,167527,473893,186988,828408
2023-04-14 04:48,828432,167549,473894,186989,828432
2023-04-14 04:49,828456,167572,473894,186990,828456
2023-04-14 04:50,828483,167599,473894,186990,828483
2023-04-14 04:51,828506,167622,473894,186990,828506
2023-04-14 04:52,828530,167644,473895,186991,828530
2023-04-14 04:53,828554,167668,473895,186991,828554
2023-04-14 04:54,828579,167691,473896,186992,828579
2023-04-14 04:55,828605,167716,473896,186993,828605
2023-04-14 04:56,828629,167739,473897,186993,828629
2023-04-14 04:57,828653,167763,473897,186993,828653
2023-04-14 04:58,828679,167789,473897,186993,828679
2023-04-14 04:59,828704,167814,473897,186993,828704
2023-04-14 05:00,828725,167835,473897,186993,828725
2023-04-14 05:01,828738,167848,473897,186993,828738
2023-04-14 05:02,828752,167860,473899,186993,828752
2023-04-14 05:03,828767,167875,473899,186993,828767
2023-04-14 05:04,828779,167887,473899,186993,828779
2023-04-14 05:05,828794,167902,473899,186993,828794
2023-04-14 05:06,828807,167913,473901,186993,828807
2023-04-14 05:07,828821,167927,473901,186993,828821
2023-04-14 05:08,828835,167940,473901,186994,828835
2023-04-14 05:09,828848,167952,473901,186995,828848
2023-04-14 05:10,828863,167967,473901,186995,828863
2023-04-14 05:11,828876,167980,473901,186995,828876
2023-04-14 05:12,828890,167993,473902,186995,828890
2023-04-14 05:13,828904,168007,473902,186995,828904
2023-04-14 05:14,828918,168020,473903,186995,828918
2023-04-14 05:15,828931,168033,473903,186995,828931
2023-04-14 05:16,828945,168045,473905,186995,828945
2023-04-14 05:17,828959,168057,473905,186997,828959
2023-04-14 05:18,828973,168068,473907,186998,828973
2023-04-14 05:19,828986,168081,473907,186998,828986
2023-04-14 05:20,829000,168095,473907,186998,829000
2023-04-14 05:21,829014,168109,473907,186998,829014
2023-04-14 05:22,829028,168120,473909,186999,829028
2023-04-14 05:23,829041,168132,473909,187000,829041
2023-04-14 05:24,829055,168146,473909,187000,829055
2023-04-14 05:25,829069,168159,473909,187001,829069
2023-04-14 05:26,829083,168173,473909,187001,829083
2023-04-14 05:27,829097,168187,473909,187001,829097
2023-04-14 05:28,829111,168201,473909,187001,829111
2023-04-14 05:29,829123,168213,473909,187001,829123
2023-04-14 05:30,829137,168227,473909,187001,829137
2023-04-14 05:31,829151,168241,473909,187001,829151
2023-04-14 05:33,829165,168253,473909,187003,829165
2023-04-14 05:34,829179,168268,473909,187002,829179
2023-04-14 05:35,829193,168282,473909,187002,829193
2023-04-14 05:36,829206,168295,473909,187002,829206
2023-04-14 05:37,829220,168309,473909,187002,829220
2023-04-14 05:38,829234,168323,473909,187002,829234
2023-04-14 05:39,829248,168335,473910,187003,829248
2023-04-14 05:40,829262,168349,473910,187003,829262
2023-04-14 05:41,829276,168363,473910,187003,829276
2023-04-14 05:42,829290,168377,473910,187003,829290
2023-04-14 05:43,829304,168390,473911,187003,829304
2023-04-14 05:44,829317,168403,473911,187003,829317
2023-04-14 05:45,829331,168416,473911,187004,829331
2023-04-14 05:46,829345,168429,473911,187005,829345
2023-04-14 05:47,829359,168440,473912,187007,829359
2023-04-14 05:48,829372,168453,473912,187007,829372
2023-04-14 05:49,829386,168465,473912,187009,829386
2023-04-14 05:50,829400,168478,473912,187010,829400
2023-04-14 05:51,829415,168491,473913,187011,829415
2023-04-14 05:52,829428,168504,473913,187011,829428
2023-04-14 05:53,829442,168518,473913,187011,829442
2023-04-14 05:54,829457,168533,473913,187011,829457
2023-04-14 05:55,829470,168544,473914,187012,829470
2023-04-14 05:56,829483,168557,473914,187012,829483
2023-04-14 05:57,829498,168571,473914,187013,829498
2023-04-14 05:58,829513,168586,473914,187013,829513
2023-04-14 05:59,829526,168598,473915,187013,829526
2023-04-14 06:00,829537,168607,473915,187015,829537
2023-04-14 06:01,829547,168616,473915,187016,829547
2023-04-14 06:02,829558,168626,473915,187017,829558
2023-04-14 06:03,829567,168634,473916,187017,829567
2023-04-14 06:04,829577,168641,473916,187020,829577
2023-04-14 06:05,829587,168651,473916,187020,829587
2023-04-14 06:06,829598,168662,473916,187020,829598
2023-04-14 06:07,829608,168671,473917,187020,829608
2023-04-14 06:08,829617,168679,473917,187021,829617
2023-04-14 06:09,829627,168687,473919,187021,829627
2023-04-14 06:10,829636,168696,473919,187021,829636
2023-04-14 06:11,829646,168705,473919,187022,829646
2023-04-14 06:12,829656,168714,473919,187023,829656
2023-04-14 06:13,829665,168720,473921,187024,829665
2023-04-14 06:14,829675,168728,473921,187026,829675
2023-04-14 06:16,829684,168735,473921,187028,829684
2023-04-14 06:17,829694,168745,473921,187028,829694
2023-04-14 06:18,829704,168754,473922,187028,829704
2023-04-14 06:19,829714,168763,473922,187029,829714
2023-04-14 06:20,829724,168770,473924,187030,829724
2023-04-14 06:21,829733,168779,473924,187030,829733
2023-04-14 06:22,829743,168786,473924,187033,829743
2023-04-14 06:23,829753,168794,473924,187035,829753
2023-04-14 06:24,829763,168801,473925,187037,829763
2023-04-14 06:25,829772,168810,473925,187037,829772
2023-04-14 06:26,829781,168816,473925,187040,829781
2023-04-14 06:27,829791,168825,473925,187041,829791
2023-04-14 06:28,829800,168833,473925,187042,829800
2023-04-14 06:29,829811,168844,473925,187042,829811
2023-04-14 06:30,829821,168849,473926,187046,829821
2023-04-14 06:31,829830,168858,473926,187046,829830
2023-04-14 06:32,829840,168862,473929,187049,829840
2023-04-14 06:33,829850,168872,473929,187049,829850
2023-04-14 06:34,829859,168878,473930,187051,829859
2023-04-14 06:35,829869,168887,473930,187052,829869
2023-04-14 06:36,829879,168893,473932,187054,829879
2023-04-14 06:37,829888,168902,473932,187054,829888
2023-04-14 06:38,829898,168912,473932,187054,829898
2023-04-14 06:39,829908,168921,473932,187055,829908
2023-04-14 06:40,829917,168929,473933,187055,829917
2023-04-14 06:41,829927,168938,473933,187056,829927
2023-04-14 06:42,829936,168943,473935,187058,829936
2023-04-14 06:43,829945,168952,473935,187058,829945
2023-04-14 06:44,829956,168962,473936,187058,829956
2023-04-14 06:45,829965,168971,473936,187058,829965
2023-04-14 06:46,829975,168980,473936,187059,829975
2023-04-14 06:47,829985,168989,473936,187060,829985
2023-04-14 06:48,829995,168996,473938,187061,829995
2023-04-14 06:49,830004,169004,473938,187062,830004
2023-04-14 06:50,830014,169011,473939,187064,830014
2023-04-14 06:51,830023,169019,473939,187065,830023
2023-04-14 06:52,830033,169026,473940,187067,830033
2023-04-14 06:53,830043,169036,473940,187067,830043
2023-04-14 06:54,830052,169042,473940,187070,830052
2023-04-14 06:55,830063,169052,473940,187071,830063
2023-04-14 06:56,830073,169057,473941,187075,830073
2023-04-14 06:57,830082,169067,473941,187074,830082
2023-04-14 06:58,830093,169076,473941,187076,830093
2023-04-14 06:59,830103,169086,473941,187076,830103
2023-04-14 07:00,830110,169092,473941,187077,830110
2023-04-14 07:01,830118,169100,473941,187077,830118
2023-04-14 07:03,830125,169107,473941,187077,830125
2023-04-14 07:04,830133,169112,473941,187080,830133
2023-04-14 07:05,830141,169119,473941,187081,830141
2023-04-14 07:06,830148,169125,473941,187082,830148
2023-04-14 07:07,830156,169129,473942,187085,830156
2023-04-14 07:08,830164,169137,473942,187085,830164
2023-04-14 07:09,830171,169144,473942,187085,830171
2023-04-14 07:10,830179,169152,473942,187085,830179
2023-04-14 07:11,830188,169161,473942,187085,830188
2023-04-14 07:12,830195,169166,473942,187087,830195
2023-04-14 07:13,830203,169170,473946,187087,830203
2023-04-14 07:14,830211,169176,473946,187089,830211
2023-04-14 07:15,830219,169179,473947,187093,830219
2023-04-14 07:16,830227,169185,473949,187093,830227
2023-04-14 07:17,830235,169192,473949,187094,830235
2023-04-14 07:18,830243,169198,473949,187096,830243
2023-04-14 07:19,830250,169204,473949,187097,830250
2023-04-14 07:20,830258,169205,473952,187101,830258
2023-04-14 07:21,830265,169209,473952,187104,830265
2023-04-14 07:22,830273,169217,473952,187104,830273
2023-04-14 07:23,830281,169225,473952,187104,830281
2023-04-14 07:24,830288,169230,473952,187106,830288
2023-04-14 07:25,830296,169236,473952,187108,830296
2023-04-14 07:26,830303,169241,473952,187110,830303
2023-04-14 07:27,830311,169249,473952,187110,830311
2023-04-14 07:28,830319,169258,473952,187109,830319
2023-04-14 07:29,830327,169265,473952,187110,830327
2023-04-14 07:30,830334,169267,473952,187115,830334
2023-04-14 07:31,830342,169273,473952,187117,830342
2023-04-14 07:32,830349,169271,473959,187119,830349
2023-04-14 07:33,830357,169276,473959,187122,830357
2023-04-14 07:34,830365,169281,473960,187124,830365
2023-04-14 07:35,830373,169287,473960,187126,830373
2023-04-14 07:36,830381,169291,473963,187127,830381
2023-04-14 07:37,830388,169296,473963,187129,830388
2023-04-14 07:38,830397,169302,473965,187130,830397
2023-04-14 07:39,830404,169308,473965,187131,830404
2023-04-14 07:40,830412,169309,473969,187134,830412
2023-04-14 07:41,830420,169317,473969,187134,830420
2023-04-14 07:42,830428,169321,473971,187136,830428
2023-04-14 07:43,830435,169327,473971,187137,830435
2023-04-14 07:44,830443,169330,473975,187138,830443
2023-04-14 07:45,830451,169337,473975,187139,830451
2023-04-14 07:46,830459,169343,473976,187140,830459
2023-04-14 07:47,830467,169347,473976,187144,830467
2023-04-14 07:48,830475,169351,473978,187146,830475
2023-04-14 07:50,830483,169358,473978,187147,830483
2023-04-14 07:51,830490,169363,473979,187148,830490
2023-04-14 07:52,830498,169371,473979,187148,830498
2023-04-14 07:53,830505,169372,473982,187151,830505
2023-04-14 07:54,830513,169379,473982,187152,830513
2023-04-14 07:55,830521,169386,473982,187153,830521
2023-04-14 07:56,830528,169393,473982,187153,830528
2023-04-14 07:57,830536,169397,473983,187156,830536
2023-04-14 07:58,830543,169400,473983,187160,830543
2023-04-14 07:59,830551,169404,473986,187161,830551
2023-04-14 08:00,830560,169409,473990,187161,830560
2023-04-14 08:01,830572,169419,473990,187163,830572
2023-04-14 08:02,830586,169427,473994,187165,830586
2023-04-14 08:03,830598,169438,473994,187166,830598
2023-04-14 08:04,830611,169449,473994,187168,830611
2023-04-14 08:05,830624,169459,473994,187171,830624
2023-04-14 08:06,830638,169467,473999,187172,830638
2023-04-14 08:07,830651,169480,473999,187172,830651
2023-04-14 08:08,830664,169489,474001,187174,830664
2023-04-14 08:09,830677,169502,474001,187174,830677
2023-04-14 08:10,830690,169513,474001,187176,830690
2023-04-14 08:11,830703,169523,474001,187179,830703
2023-04-14 08:12,830715,169530,474003,187182,830715
2023-04-14 08:13,830728,169541,474003,187184,830728
2023-04-14 08:14,830741,169550,474005,187186,830741
2023-04-14 08:15,830754,169562,474005,187187,830754
2023-04-14 08:16,830767,169572,474007,187188,830767
2023-04-14 08:17,830779,169582,474007,187190,830779
2023-04-14 08:18,830792,169589,474009,187194,830792
2023-04-14 08:19,830806,169602,474009,187195,830806
2023-04-14 08:20,830818,169605,474012,187201,830818
2023-04-14 08:21,830832,169616,474012,187204,830832
2023-04-14 08:22,830845,169626,474012,187207,830845
2023-04-14 08:23,830858,169638,474012,187208,830858
2023-04-14 08:24,830872,169647,474014,187211,830872
2023-04-14 08:25,830885,169659,474014,187212,830885
2023-04-14 08:26,830898,169668,474017,187213,830898
2023-04-14 08:27,830911,169680,474017,187214,830911
2023-04-14 08:28,830925,169690,474017,187218,830925
2023-04-14 08:29,830938,169700,474017,187221,830938
2023-04-14 08:30,830951,169710,474019,187222,830951
2023-04-14 08:31,830963,169718,474019,187226,830963
2023-04-14 08:32,830976,169728,474022,187226,830976
2023-04-14 08:33,830989,169740,474022,187227,830989
2023-04-14 08:34,831002,169751,474024,187227,831002
2023-04-14 08:35,831015,169764,474024,187227,831015
2023-04-14 08:37,831028,169772,474027,187229,831028
2023-04-14 08:38,831041,169784,474027,187230,831041
2023-04-14 08:39,831054,169793,474029,187232,831054
2023-04-14 08:40,831066,169804,474029,187233,831066
2023-04-14 08:41,831079,169815,474031,187233,831079
2023-04-14 08:42,831093,169827,474031,187235,831093
2023-04-14 08:43,831106,169837,474033,187236,831106
2023-04-14 08:44,831119,169850,474033,187236,831119
2023-04-14 08:45,831132,169852,474039,187241,831132
2023-04-14 08:46,831146,169864,474039,187243,831146
2023-04-14 08:47,831159,169869,474044,187246,831159
2023-04-14 08:48,831172,169882,474044,187246,831172
2023-04-14 08:49,831184,169888,474048,187248,831184
2023-04-14 08:50,831198,169900,474048,187250,831198
2023-04-14 08:51,831211,169910,474048,187253,831211
2023-04-14 08:52,831224,169919,474049,187256,831224
2023-04-14 08:53,831237,169930,474049,187258,831237
2023-04-14 08:54,831250,169938,474053,187259,831250
2023-04-14 08:55,831263,169950,474053,187260,831263
2023-04-14 08:56,831276,169958,474057,187261,831276
2023-04-14 08:57,831290,169970,474057,187263,831290
2023-04-14 08:58,831304,169983,474057,187264,831304
2023-04-14 08:59,831316,169995,474057,187264,831316
2023-04-14 09:00,831326,170000,474059,187267,831326
2023-04-14 09:01,831333,170007,474059,187267,831333
2023-04-14 09:02,831339,170007,474063,187269,831339
2023-04-14 09:03,831345,170011,474063,187271,831345
2023-04-14 09:04,831352,170012,474066,187274,831352
2023-04-14 09:05,831359,170018,474066,187275,831359
2023-04-14 09:06,831365,170018,474068,187279,831365
2023-04-14 09:07,831371,170023,474068,187280,831371
2023-04-14 09:08,831377,170023,474071,187283,831377
2023-04-14 09:09,831383,170029,474071,187283,831383
2023-04-14 09:10,831390,170032,474074,187284,831390
2023-04-14 09:11,831396,170034,474077,187285,831396
2023-04-14 09:12,831402,170037,474077,187288,831402
2023-04-14 09:13,831408,170038,474081,187289,831408
2023-04-14 09:14,831415,170045,474081,187289,831415
2023-04-14 09:15,831422,170048,474083,187291,831422
2023-04-14 09:16,831428,170049,474083,187296,831428
2023-04-14 09:17,831434,170051,474087,187296,831434
2023-04-14 09:18,831441,170055,474087,187299,831441
2023-04-14 09:19,831447,170056,474091,187300,831447
2023-04-14 09:20,831454,170063,474091,187300,831454
2023-04-14 09:21,831460,170065,474093,187302,831460
2023-04-14 09:22,831466,170068,474094,187304,831466
2023-04-14 09:24,831472,170071,474094,187307,831472
2023-04-14 09:25,831480,170074,474096,187310,831480
2023-04-14 09:26,831486,170079,474096,187311,831486
2023-04-14 09:27,831493,170081,474100,187312,831493
2023-04-14 09:28,831499,170086,474100,187313,831499
2023-04-14 09:29,831505,170089,474102,187314,831505
2023-04-14 09:30,831512,170095,474102,187315,831512
2023-04-14 09:31,831518,170097,474104,187317,831518
2023-04-14 09:32,831525,170103,474104,187318,831525
2023-04-14 09:33,831532,170102,474104,187326,831532
2023-04-14 09:34,831541,170111,474104,187326,831541
2023-04-14 09:35,831547,170111,474108,187328,831547
2023-04-14 09:36,831553,170114,474108,187331,831553
2023-04-14 09:37,831560,170117,474110,187333,831560
2023-04-14 09:38,831568,170121,474110,187337,831568
2023-04-14 09:39,831575,170127,474110,187338,831575
2023-04-14 09:40,831581,170131,474110,187340,831581
2023-04-14 09:41,831589,170136,474113,187340,831589
2023-04-14 09:42,831595,170141,474113,187341,831595
2023-04-14 09:43,831601,170141,474116,187344,831601
2023-04-14 09:44,831607,170143,474116,187348,831607
2023-04-14 09:45,831613,170146,474118,187349,831613
2023-04-14 09:46,831620,170148,474118,187354,831620
2023-04-14 09:47,831626,170148,474122,187356,831626
2023-04-14 09:48,831632,170153,474122,187357,831632
2023-04-14 09:49,831640,170158,474123,187359,831640
2023-04-14 09:50,831647,170164,474123,187360,831647
2023-04-14 09:51,831653,170169,474124,187360,831653
2023-04-14 09:52,831660,170173,474124,187363,831660
2023-04-14 09:53,831666,170176,474127,187363,831666
2023-04-14 09:54,831673,170177,474132,187364,831673
2023-04-14 09:55,831680,170183,474132,187365,831680
2023-04-14 09:56,831686,170185,474133,187368,831686
2023-04-14 09:57,831692,170187,474133,187372,831692
2023-04-14 09:58,831699,170188,474135,187376,831699
2023-04-14 09:59,831704,170191,474135,187378,831704
2023-04-14 10:00,831725,170205,474136,187384,831725
2023-04-14 10:01,831755,170234,474136,187385,831755
2023-04-14 10:02,831783,170260,474138,187385,831783
2023-04-14 10:03,831811,170284,474138,187389,831811
2023-04-14 10:04,831840,170304,474144,187392,831840
2023-04-14 10:05,831867,170330,474144,187393,831867
2023-04-14 10:06,831894,170352,474147,187395,831894
2023-04-14 10:07,831921,170377,474146,187398,831921
2023-04-14 10:08,831949,170404,474146,187399,831949
2023-04-14 10:09,831978,170430,474147,187401,831978
2023-04-14 10:10,832005,170455,474147,187403,832005
2023-04-14 10:12,832034,170478,474150,187406,832034
2023-04-14 10:13,832061,170501,474150,187410,832061
2023-04-14 10:14,832090,170526,474153,187411,832090
2023-04-14 10:15,832116,170552,474153,187411,832116
2023-04-14 10:16,832145,170577,474156,187412,832145
2023-04-14 10:17,832173,170596,474158,187419,832173
2023-04-14 10:18,832200,170619,474158,187423,832200
2023-04-14 10:19,832228,170643,474159,187426,832228
2023-04-14 10:20,832256,170668,474159,187429,832256
2023-04-14 10:21,832284,170691,474161,187432,832284
2023-04-14 10:22,832311,170714,474161,187436,832311
2023-04-14 10:23,832339,170730,474166,187443,832339
2023-04-14 10:24,832367,170758,474166,187443,832367
2023-04-14 10:25,832395,170780,474170,187445,832395
2023-04-14 10:26,832423,170804,474170,187449,832423
2023-04-14 10:27,832451,170829,474170,187452,832451
2023-04-14 10:28,832478,170847,474174,187457,832478
2023-04-14 10:29,832507,170871,474174,187462,832507
2023-04-14 10:30,832534,170894,474178,187462,832534
2023-04-14 10:31,832561,170915,474178,187468,832561
2023-04-14 10:32,832589,170938,474183,187468,832589
2023-04-14 10:33,832618,170965,474183,187470,832618
2023-04-14 10:34,832646,170988,474183,187475,832646
2023-04-14 10:35,832673,171006,474190,187477,832673
2023-04-14 10:36,832702,171028,474193,187481,832702
2023-04-14 10:37,832728,171054,474193,187481,832728
2023-04-14 10:38,832757,171076,474197,187484,832757
2023-04-14 10:39,832784,171099,474197,187488,832784
2023-04-14 10:40,832813,171121,474202,187490,832813
2023-04-14 10:41,832842,171147,474202,187493,832842
2023-04-14 10:42,832868,171164,474205,187499,832868
2023-04-14 10:43,832898,171192,474205,187501,832898
2023-04-14 10:44,832925,171213,474209,187503,832925
2023-04-14 10:45,832952,171234,474209,187509,832952
2023-04-14 10:46,832980,171255,474212,187513,832980
2023-04-14 10:47,833006,171279,474212,187515,833006
2023-04-14 10:48,833036,171305,474213,187518,833036
2023-04-14 10:49,833064,171329,474213,187522,833064
2023-04-14 10:50,833092,171351,474216,187525,833092
2023-04-14 10:51,833119,171376,474216,187527,833119
2023-04-14 10:52,833147,171396,474219,187532,833147
2023-04-14 10:53,833176,171424,474219,187533,833176
2023-04-14 10:54,833205,171443,474222,187540,833205
2023-04-14 10:55,833233,171470,474222,187541,833233
2023-04-14 10:56,833261,171495,474224,187542,833261
2023-04-14 10:58,833288,171521,474224,187543,833288
2023-04-14 10:59,833316,171541,474229,187546,833316
2023-04-14 11:00,833344,171566,474229,187549,833344
2023-04-14 11:01,833375,171591,474232,187552,833375
2023-04-14 11:02,833402,171612,474232,187558,833402
2023-04-14 11:03,833431,171632,474241,187558,833431
2023-04-14 11:04,833461,171658,474241,187562,833461
2023-04-14 11:05,833491,171680,474244,187567,833491
2023-04-14 11:06,833521,171705,474244,187572,833521
2023-04-14 11:07,833552,171734,474244,187574,833552
2023-04-14 11:08,833583,171764,474244,187575,833583
2023-04-14 11:09,833612,171789,474244,187579,833612
2023-04-14 11:10,833642,171815,474244,187583,833642
2023-04-14 11:11,833671,171841,474244,187586,833671
2023-04-14 11:12,833702,171868,474244,187590,833702
2023-04-14 11:13,833731,171896,474244,187591,833731
2023-04-14 11:14,833760,171919,474244,187597,833760
2023-04-14 11:15,833791,171935,474260,187596,833791
2023-04-14 11:16,833820,171957,474264,187599,833820
2023-04-14 11:17,833849,171980,474264,187605,833849
2023-04-14 11:18,833878,172000,474268,187610,833878
2023-04-14 11:19,833909,172028,474271,187610,833909
2023-04-14 11:20,833938,172056,474271,187611,833938
2023-04-14 11:21,833968,172084,474272,187612,833968
2023-04-14 11:22,833998,172106,474275,187617,833998
2023-04-14 11:23,834027,172132,474275,187620,834027
2023-04-14 11:24,834057,172158,474277,187622,834057
2023-04-14 11:25,834087,172183,474277,187627,834087
2023-04-14 11:26,834115,172202,474279,187634,834115
2023-04-14 11:27,834144,172230,474279,187635,834144
2023-04-14 11:28,834176,172256,474282,187638,834176
2023-04-14 11:30,834205,172279,474282,187644,834205
2023-04-14 11:31,834244,172305,474291,187648,834244
2023-04-14 11:32,834274,172332,474291,187651,834274
2023-04-14 11:33,834305,172359,474294,187652,834305
2023-04-14 11:34,834357,172410,474294,187653,834357
2023-04-14 11:35,834387,172430,474296,187661,834387
2023-04-14 11:36,834419,172461,474296,187662,834419
2023-04-14 11:37,834449,172485,474300,187664,834449
2023-04-14 11:38,834479,172511,474300,187668,834479
2023-04-14 11:39,834508,172530,474306,187672,834508
2023-04-14 11:40,834539,172560,474306,187673,834539
2023-04-14 11:41,834568,172581,474311,187676,834568
2023-04-14 11:42,834598,172610,474311,187677,834598
2023-04-14 11:44,834628,172633,474316,187679,834628
2023-04-14 11:45,834658,172659,474319,187680,834658
2023-04-14 11:46,834690,172685,474325,187680,834690
2023-04-14 11:47,834719,172712,474325,187682,834719
2023-04-14 11:48,834748,172736,474328,187684,834748
2023-04-14 11:49,834777,172758,474328,187691,834777
2023-04-14 11:50,834808,172782,474334,187692,834808
2023-04-14 11:51,834839,172812,474334,187693,834839
2023-04-14 11:52,834869,172830,474342,187697,834869
2023-04-14 11:53,834900,172859,474342,187699,834900
2023-04-14 11:54,834930,172880,474348,187702,834930
2023-04-14 11:55,834960,172906,474348,187706,834960
2023-04-14 11:56,834990,172932,474349,187709,834990
2023-04-14 11:57,835019,172957,474349,187713,835019
2023-04-14 11:58,835050,172982,474353,187715,835050
2023-04-14 11:59,835080,173011,474353,187716,835080
2023-04-14 12:00,835106,173026,474361,187719,835106
2023-04-14 12:01,835121,173039,474361,187721,835121
2023-04-14 12:02,835137,173047,474367,187723,835137
2023-04-14 12:03,835152,173061,474367,187724,835152
2023-04-14 12:04,835167,173070,474371,187726,835167
2023-04-14 12:05,835182,173082,474371,187729,835182
2023-04-14 12:06,835198,173089,474377,187732,835198
2023-04-14 12:07,835214,173101,474377,187736,835214
2023-04-14 12:08,835229,173110,474381,187738,835229
2023-04-14 12:09,835244,173120,474381,187743,835244
2023-04-14 12:10,835260,173131,474384,187745,835260
2023-04-14 12:11,835276,173142,474387,187747,835276
2023-04-14 12:12,835291,173153,474390,187748,835291
2023-04-14 12:13,835305,173166,474390,187749,835305
2023-04-14 12:14,835320,173172,474397,187751,835320
2023-04-14 12:15,835337,173187,474397,187753,835337
2023-04-14 12:16,835352,173187,474409,187756,835352
2023-04-14 12:17,835368,173199,474409,187760,835368
2023-04-14 12:18,835383,173203,474418,187762,835383
2023-04-14 12:19,835398,173217,474418,187763,835398
2023-04-14 12:20,835413,173226,474422,187765,835413
2023-04-14 12:21,835429,173241,474422,187766,835429
2023-04-14 12:22,835444,173248,474427,187769,835444
2023-04-14 12:23,835459,173260,474427,187772,835459
2023-04-14 12:24,835475,173274,474427,187774,835475
2023-04-14 12:25,835491,173286,474427,187778,835491
2023-04-14 12:26,835506,173299,474427,187780,835506
2023-04-14 12:27,835522,173311,474427,187784,835522
2023-04-14 12:28,835537,173323,474427,187787,835537
2023-04-14 12:29,835552,173331,474427,187794,835552
2023-04-14 12:30,835568,173345,474427,187796,835568
2023-04-14 12:32,835583,173353,474427,187803,835583
2023-04-14 12:33,835598,173346,474447,187805,835598
2023-04-14 12:34,835614,173354,474447,187813,835614
2023-04-14 12:35,835631,173358,474456,187817,835631
2023-04-14 12:36,835645,173364,474458,187823,835645
2023-04-14 12:37,835662,173377,474459,187826,835662
2023-04-14 12:38,835677,173385,474459,187833,835677
2023-04-14 12:39,835692,173391,474463,187838,835692
2023-04-14 12:40,835707,173403,474463,187841,835707
2023-04-14 12:41,835724,173412,474469,187843,835724
2023-04-14 12:42,835739,173424,474469,187846,835739
2023-04-14 12:43,835754,173431,474473,187850,835754
2023-04-14 12:44,835770,173442,474473,187855,835770
2023-04-14 12:45,835788,173452,474478,187858,835788
2023-04-14 12:46,835802,173464,474478,187860,835802
2023-04-14 12:47,835817,173469,474484,187864,835817
2023-04-14 12:48,835833,173484,474484,187865,835833
2023-04-14 12:49,835849,173492,474489,187868,835849
2023-04-14 12:50,835864,173504,474489,187871,835864
2023-04-14 12:51,835879,173514,474490,187875,835879
2023-04-14 12:52,835894,173525,474490,187879,835894
2023-04-14 12:53,835910,173531,474496,187883,835910
2023-04-14 12:54,835925,173539,474496,187890,835925
2023-04-14 12:55,835942,173544,474505,187893,835942
2023-04-14 12:56,835957,173555,474505,187897,835957
2023-04-14 12:57,835974,173560,474513,187901,835974
2023-04-14 12:58,835989,173574,474513,187902,835989
2023-04-14 12:59,836004,173578,474521,187905,836004
2023-04-14 13:00,836023,173596,474521,187906,836023
2023-04-14 13:01,836047,173615,474524,187908,836047
2023-04-14 13:02,836068,173634,474524,187910,836068
2023-04-14 13:03,836090,173652,474526,187912,836090
2023-04-14 13:04,836111,173667,474526,187918,836111
2023-04-14 13:05,836133,173684,474531,187918,836133
2023-04-14 13:06,836154,173703,474533,187918,836154
2023-04-14 13:07,836175,173719,474536,187920,836175
2023-04-14 13:08,836198,173739,474536,187923,836198
2023-04-14 13:09,836220,173757,474540,187923,836220
2023-04-14 13:10,836241,173775,474540,187926,836241
2023-04-14 13:11,836262,173788,474543,187931,836262
2023-04-14 13:12,836283,173804,474543,187936,836283
2023-04-14 13:13,836304,173818,474548,187938,836304
2023-04-14 13:14,836325,173838,474548,187939,836325
2023-04-14 13:15,836347,173854,474550,187943,836347
2023-04-14 13:16,836368,173873,474550,187945,836368
2023-04-14 13:18,836389,173882,474559,187948,836389
2023-04-14 13:19,836411,173901,474559,187951,836411
2023-04-14 13:20,836433,173916,474563,187954,836433
2023-04-14 13:21,836454,173934,474563,187957,836454
2023-04-14 13:22,836475,173943,474570,187962,836475
2023-04-14 13:23,836495,173963,474570,187962,836495
2023-04-14 13:24,836518,173982,474572,187964,836518
2023-04-14 13:25,836539,174000,474574,187965,836539
2023-04-14 13:26,836560,174019,474574,187967,836560
2023-04-14 13:27,836581,174026,474583,187972,836581
2023-04-14 13:28,836602,174047,474583,187972,836602
2023-04-14 13:29,836623,174057,474589,187977,836623
2023-04-14 13:30,836646,174077,474589,187980,836646
2023-04-14 13:31,836669,174099,474590,187980,836669
2023-04-14 13:32,836690,174118,474590,187982,836690
2023-04-14 13:33,836711,174134,474593,187984,836711
2023-04-14 13:34,836734,174152,474593,187989,836734
2023-04-14 13:35,836754,174165,474600,187989,836754
2023-04-14 13:36,836775,174185,474600,187990,836775
2023-04-14 13:37,836798,174204,474603,187991,836798
2023-04-14 13:38,836818,174223,474603,187992,836818
2023-04-14 13:39,836840,174240,474605,187995,836840
2023-04-14 13:40,836861,174257,474605,187999,836861
2023-04-14 13:41,836882,174273,474607,188002,836882
2023-04-14 13:42,836903,174288,474607,188008,836903
2023-04-14 13:43,836926,174300,474613,188013,836926
2023-04-14 13:44,836949,174318,474613,188018,836949
2023-04-14 13:45,836971,174336,474614,188021,836971
2023-04-14 13:46,836991,174354,474614,188023,836991
2023-04-14 13:47,837014,174371,474617,188026,837014
2023-04-14 13:48,837035,174389,474617,188029,837035
2023-04-14 13:49,837056,174402,474622,188032,837056
2023-04-14 13:50,837077,174421,474622,188034,837077
2023-04-14 13:51,837099,174433,474630,188036,837099
2023-04-14 13:52,837119,174451,474630,188038,837119
2023-04-14 13:53,837140,174465,474635,188040,837140
2023-04-14 13:54,837162,174485,474635,188042,837162
2023-04-14 13:55,837183,174497,474639,188047,837183
2023-04-14 13:56,837205,174516,474639,188050,837205
2023-04-14 13:57,837226,174530,474643,188053,837226
2023-04-14 13:58,837247,174547,474643,188057,837247
2023-04-14 13:59,837269,174564,474644,188061,837269
2023-04-14 14:00,837295,174589,474644,188062,837295
2023-04-14 14:01,837319,174606,474649,188064,837319
2023-04-14 14:02,837345,174627,474652,188066,837345
2023-04-14 14:03,837372,174652,474652,188068,837372
2023-04-14 14:04,837397,174670,474656,188071,837397
2023-04-14 14:06,837423,174694,474656,188073,837423
2023-04-14 14:07,837449,174714,474661,188074,837449
2023-04-14 14:08,837474,174737,474661,188076,837474
2023-04-14 14:09,837501,174758,474665,188078,837501
2023-04-14 14:10,837528,174785,474665,188078,837528
2023-04-14 14:11,837552,174799,474672,188081,837552
2023-04-14 14:12,837578,174824,474672,188082,837578
2023-04-14 14:13,837605,174841,474678,188086,837605
2023-04-14 14:14,837631,174866,474678,188087,837631
2023-04-14 14:15,837656,174885,474682,188089,837656
2023-04-14 14:16,837683,174909,474682,188092,837683
2023-04-14 14:17,837708,174931,474683,188094,837708
2023-04-14 14:18,837733,174954,474683,188096,837733
2023-04-14 14:19,837759,174976,474685,188098,837759
2023-04-14 14:20,837786,175001,474685,188100,837786
2023-04-14 14:21,837811,175020,474690,188101,837811
2023-04-14 14:22,837837,175045,474690,188102,837837
2023-04-14 14:23,837863,175064,474695,188104,837863
2023-04-14 14:24,837891,175092,474695,188104,837891
2023-04-14 14:25,837917,175111,474700,188106,837917
2023-04-14 14:26,837942,175133,474700,188109,837942
2023-04-14 14:27,837968,175152,474704,188112,837968
2023-04-14 14:28,837996,175175,474705,188116,837996
2023-04-14 14:29,838023,175197,474705,188121,838023
2023-04-14 14:30,838050,175222,474706,188122,838050
2023-04-14 14:31,838075,175245,474706,188124,838075
2023-04-14 14:32,838102,175263,474710,188129,838102
2023-04-14 14:33,838127,175285,474710,188132,838127
2023-04-14 14:34,838153,175302,474717,188134,838153
2023-04-14 14:35,838178,175325,474717,188136,838178
2023-04-14 14:36,838204,175342,474720,188142,838204
2023-04-14 14:37,838231,175365,474720,188146,838231
2023-04-14 14:38,838259,175390,474723,188146,838259
2023-04-14 14:39,838285,175413,474723,188149,838285
2023-04-14 14:40,838312,175434,474728,188150,838312
2023-04-14 14:41,838338,175460,474728,188150,838338
2023-04-14 14:42,838364,175485,474728,188151,838364
2023-04-14 14:43,838391,175507,474729,188155,838391
2023-04-14 14:44,838417,175532,474729,188156,838417
2023-04-14 14:45,838443,175555,474730,188158,838443
2023-04-14 14:46,838470,175576,474733,188161,838470
2023-04-14 14:47,838496,175598,474733,188165,838496
2023-04-14 14:48,838523,175622,474735,188166,838523
2023-04-14 14:49,838549,175647,474735,188167,838549
2023-04-14 14:50,838574,175668,474737,188169,838574
2023-04-14 14:51,838602,175694,474737,188171,838602
2023-04-14 14:52,838627,175712,474742,188173,838627
2023-04-14 14:54,838654,175737,474742,188175,838654
2023-04-14 14:55,838678,175755,474746,188177,838678
2023-04-14 14:56,838704,175780,474746,188178,838704
2023-04-14 14:57,838732,175801,474749,188182,838732
2023-04-14 14:58,838757,175823,474749,188185,838757
2023-04-14 14:59,838783,175843,474754,188186,838783
2023-04-14 15:00,838809,175865,474754,188190,838809
2023-04-14 15:01,838840,175892,474756,188192,838840
2023-04-14 15:02,838868,175917,474756,188195,838868
2023-04-14 15:03,838899,175937,474763,188199,838899
2023-04-14 15:04,838928,175964,474763,188201,838928
2023-04-14 15:05,838957,175986,474766,188205,838957
2023-04-14 15:06,838985,176014,474766,188205,838985
2023-04-14 15:07,839014,176036,474769,188209,839014
2023-04-14 15:08,839045,176065,474769,188211,839045
2023-04-14 15:09,839073,176088,474770,188215,839073
2023-04-14 15:10,839101,176114,474770,188217,839101
2023-04-14 15:11,839130,176138,474773,188219,839130
2023-04-14 15:12,839161,176168,474773,188220,839161
2023-04-14 15:13,839189,176193,474771,188225,839189
2023-04-14 15:14,839217,176220,474771,188226,839217
2023-04-14 15:15,839247,176241,474775,188231,839247
2023-04-14 15:16,839277,176269,474775,188233,839277
2023-04-14 15:17,839305,176293,474778,188234,839305
2023-04-14 15:18,839334,176319,474778,188237,839334
2023-04-14 15:19,839362,176336,474783,188243,839362
2023-04-14 15:20,839395,176368,474783,188244,839395
2023-04-14 15:21,839423,176390,474785,188248,839423
2023-04-14 15:22,839451,176416,474785,188250,839451
2023-04-14 15:23,839480,176439,474789,188252,839480
2023-04-14 15:24,839511,176468,474789,188254,839511
2023-04-14 15:25,839539,176493,474789,188257,839539
2023-04-14 15:26,839566,176519,474789,188258,839566
2023-04-14 15:27,839595,176543,474789,188263,839595
2023-04-14 15:28,839625,176571,474789,188265,839625
2023-04-14 15:29,839656,176598,474789,188269,839656
2023-04-14 15:30,839684,176624,474789,188271,839684
2023-04-14 15:31,839713,176650,474789,188274,839713
2023-04-14 15:32,839742,176674,474789,188279,839742
2023-04-14 15:33,839770,176680,474808,188282,839770
2023-04-14 15:34,839802,176709,474808,188285,839802
2023-04-14 15:35,839829,176732,474811,188286,839829
2023-04-14 15:36,839861,176761,474811,188289,839861
2023-04-14 15:37,839890,176782,474815,188293,839890
2023-04-14 15:38,839920,176808,474815,188297,839920
2023-04-14 15:39,839949,176826,474822,188301,839949
2023-04-14 15:40,839979,176856,474822,188301,839979
2023-04-14 15:42,840007,176876,474826,188305,840007
2023-04-14 15:43,840037,176906,474826,188305,840037
2023-04-14 15:44,840064,176925,474832,188307,840064
2023-04-14 15:45,840094,176952,474832,188310,840094
2023-04-14 15:46,840123,176973,474835,188315,840123
2023-04-14 15:47,840152,176997,474835,188320,840152
2023-04-14 15:48,840182,177019,474838,188325,840182
2023-04-14 15:49,840212,177045,474839,188328,840212
2023-04-14 15:50,840243,177076,474839,188328,840243
2023-04-14 15:51,840273,177099,474842,188332,840273
2023-04-14 15:52,840304,177127,474842,188335,840304
2023-04-14 15:53,840335,177151,474847,188337,840335
2023-04-14 15:54,840363,177173,474847,188343,840363
2023-04-14 15:55,840394,177198,474850,188346,840394
2023-04-14 15:56,840424,177222,474850,188352,840424
2023-04-14 15:57,840453,177242,474855,188356,840453
2023-04-14 15:58,840481,177267,474855,188359,840481
2023-04-14 15:59,840511,177287,474861,188363,840511
2023-04-14 16:00,840539,177311,474861,188367,840539
2023-04-14 16:01,840570,177336,474862,188372,840570
2023-04-14 16:02,840600,177363,474862,188375,840600
2023-04-14 16:03,840628,177386,474863,188379,840628
2023-04-14 16:04,840659,177414,474863,188382,840659
2023-04-14 16:05,840689,177432,474870,188387,840689
2023-04-14 16:06,840718,177458,474870,188390,840718
2023-04-14 16:07,840747,177480,474873,188394,840747
2023-04-14 16:08,840776,177507,474873,188396,840776
2023-04-14 16:09,840806,177533,474876,188397,840806
2023-04-14 16:10,840836,177560,474876,188400,840836
2023-04-14 16:11,840866,177574,474886,188406,840866
2023-04-14 16:12,840897,177598,474886,188413,840897
2023-04-14 16:13,840929,177616,474894,188419,840929
2023-04-14 16:14,840958,177641,474894,188423,840958
2023-04-14 16:15,840987,177669,474894,188424,840987
2023-04-14 16:16,841017,177690,474902,188425,841017
2023-04-14 16:17,841046,177713,474902,188431,841046
2023-04-14 16:18,841077,177738,474906,188433,841077
2023-04-14 16:19,841106,177765,474906,188435,841106
2023-04-14 16:20,841137,177788,474906,188443,841137
2023-04-14 16:21,841167,177817,474906,188444,841167
2023-04-14 16:22,841196,177846,474906,188444,841196
2023-04-14 16:23,841226,177860,474921,188445,841226
2023-04-14 16:24,841256,177887,474921,188448,841256
2023-04-14 16:25,841285,177911,474923,188451,841285
2023-04-14 16:26,841314,177934,474923,188457,841314
2023-04-14 16:27,841345,177960,474924,188461,841345
2023-04-14 16:29,841375,177986,474924,188465,841375
2023-04-14 16:30,841402,178007,474927,188468,841402
2023-04-14 16:31,841434,178039,474927,188468,841434
2023-04-14 16:32,841463,178063,474927,188473,841463
2023-04-14 16:33,841493,178091,474927,188475,841493
2023-04-14 16:34,841522,178111,474930,188481,841522
2023-04-14 16:35,841553,178136,474930,188487,841553
2023-04-14 16:36,841582,178153,474937,188492,841582
2023-04-14 16:37,841611,178174,474940,188497,841611
2023-04-14 16:38,841642,178202,474940,188500,841642
2023-04-14 16:39,841675,178232,474940,188503,841675
2023-04-14 16:40,841705,178256,474943,188506,841705
2023-04-14 16:41,841734,178273,474951,188510,841734
2023-04-14 16:42,841764,178299,474951,188514,841764
2023-04-14 16:43,841793,178322,474956,188515,841793
2023-04-14 16:44,841825,178351,474956,188518,841825
2023-04-14 16:45,841855,178378,474957,188520,841855
2023-04-14 16:46,841885,178405,474957,188523,841885
2023-04-14 16:47,841914,178429,474960,188525,841914
2023-04-14 16:48,841945,178458,474960,188527,841945
2023-04-14 16:49,841974,178479,474964,188531,841974
2023-04-14 16:50,842005,178506,474964,188535,842005
2023-04-14 16:51,842034,178527,474970,188537,842034
2023-04-14 16:52,842063,178550,474970,188543,842063
2023-04-14 16:53,842093,178567,474977,188549,842093
2023-04-14 16:54,842123,178596,474977,188550,842123
2023-04-14 16:55,842154,178616,474984,188554,842154
2023-04-14 16:56,842182,178638,474986,188558,842182
2023-04-14 16:57,842212,178663,474986,188563,842212
2023-04-14 16:58,842242,178687,474992,188563,842242
2023-04-14 16:59,842274,178714,474992,188568,842274
2023-04-14 17:00,842298,178732,474997,188569,842298
2023-04-14 17:01,842319,178749,474997,188573,842319
2023-04-14 17:02,842341,178763,475002,188576,842341
2023-04-14 17:03,842363,178783,475002,188578,842363
2023-04-14 17:04,842384,178795,475008,188581,842384
2023-04-14 17:05,842404,178810,475010,188584,842404
2023-04-14 17:06,842426,178832,475010,188584,842426
2023-04-14 17:07,842448,178844,475017,188587,842448
2023-04-14 17:08,842469,178862,475017,188590,842469
2023-04-14 17:09,842491,178866,475027,188598,842491
2023-04-14 17:10,842511,178884,475027,188600,842511
2023-04-14 17:11,842533,178900,475030,188603,842533
2023-04-14 17:12,842553,178914,475032,188607,842553
2023-04-14 17:13,842573,178930,475032,188611,842573
2023-04-14 17:14,842596,178942,475041,188613,842596
2023-04-14 17:16,842617,178953,475041,188623,842617
2023-04-14 17:17,842639,178969,475045,188625,842639
2023-04-14 17:18,842660,178987,475045,188628,842660
2023-04-14 17:19,842682,178998,475051,188633,842682
2023-04-14 17:20,842703,179015,475051,188637,842703
2023-04-14 17:21,842723,179024,475056,188643,842723
2023-04-14 17:22,842744,179042,475056,188646,842744
2023-04-14 17:23,842766,179054,475060,188652,842766
2023-04-14 17:24,842786,179073,475060,188653,842786
2023-04-14 17:25,842806,179084,475066,188656,842806
2023-04-14 17:26,842827,179100,475066,188661,842827
2023-04-14 17:27,842848,179109,475074,188665,842848
2023-04-14 17:28,842869,179126,475074,188669,842869
2023-04-14 17:29,842889,179137,475079,188673,842889
2023-04-14 17:30,842910,179153,475079,188678,842910
2023-04-14 17:31,842932,179167,475084,188681,842932
2023-04-14 17:32,842954,179187,475084,188683,842954
2023-04-14 17:33,842974,179195,475094,188685,842974
2023-04-14 17:34,842996,179213,475094,188689,842996
2023-04-14 17:35,843017,179224,475097,188696,843017
2023-04-14 17:36,843037,179239,475100,188698,843037
2023-04-14 17:37,843061,179260,475100,188701,843061
2023-04-14 17:38,843081,179269,475106,188706,843081
2023-04-14 17:39,843103,179286,475106,188711,843103
2023-04-14 17:40,843123,179292,475113,188718,843123
2023-04-14 17:41,843146,179311,475113,188722,843146
2023-04-14 17:42,843166,179322,475118,188726,843166
2023-04-14 17:43,843187,179336,475118,188733,843187
2023-04-14 17:44,843207,179347,475124,188736,843207
2023-04-14 17:45,843228,179367,475124,188737,843228
2023-04-14 17:46,843250,179386,475126,188738,843250
2023-04-14 17:47,843271,179400,475126,188745,843271
2023-04-14 17:48,843291,179414,475128,188749,843291
2023-04-14 17:49,843313,179431,475128,188754,843313
2023-04-14 17:50,843334,179442,475134,188758,843334
2023-04-14 17:51,843356,179461,475134,188761,843356
2023-04-14 17:52,843377,179476,475137,188764,843377
2023-04-14 17:53,843399,179491,475140,188768,843399
2023-04-14 17:54,843419,179509,475140,188770,843419
2023-04-14 17:55,843440,179524,475144,188772,843440
2023-04-14 17:56,843459,179541,475144,188774,843459
2023-04-14 17:57,843480,179551,475151,188778,843480
2023-04-14 17:58,843501,179567,475151,188783,843501
2023-04-14 17:59,843523,179576,475159,188788,843523
2023-04-14 18:00,843531,179581,475159,188791,843531
2023-04-14 18:01,843538,179576,475166,188796,843538
2023-04-14 18:03,843543,179578,475166,188799,843543
2023-04-14 18:04,843549,179577,475169,188803,843549
2023-04-14 18:05,843556,179576,475169,188811,843556
2023-04-14 18:06,843562,179572,475175,188815,843562
2023-04-14 18:07,843568,179571,475175,188822,843568
2023-04-14 18:08,843573,179569,475180,188824,843573
2023-04-14 18:09,843579,179571,475180,188828,843579
2023-04-14 18:10,843585,179569,475187,188829,843585
2023-04-14 18:11,843591,179563,475194,188834,843591
2023-04-14 18:12,843599,179568,475194,188837,843599
2023-04-14 18:13,843604,179563,475202,188839,843604
2023-04-14 18:14,843613,179569,475202,188842,843613
2023-04-14 18:15,843618,179565,475206,188847,843618
2023-04-14 18:16,843624,179564,475206,188854,843624
2023-04-14 18:17,843631,179563,475210,188858,843631
2023-04-14 18:18,843637,179564,475211,188862,843637
2023-04-14 18:19,843643,179566,475211,188866,843643
2023-04-14 18:20,843648,179560,475219,188869,843648
2023-04-14 18:21,843654,179565,475219,188870,843654
2023-04-14 18:22,843660,179563,475225,188872,843660
2023-04-14 18:23,843666,179565,475225,188876,843666
2023-04-14 18:24,843671,179556,475233,188882,843671
2023-04-14 18:25,843678,179558,475233,188887,843678
2023-04-14 18:26,843683,179556,475236,188891,843683
2023-04-14 18:27,843690,179557,475236,188897,843690
2023-04-14 18:28,843696,179555,475241,188900,843696
2023-04-14 18:29,843702,179559,475241,188902,843702
2023-04-14 18:30,843708,179556,475245,188907,843708
2023-04-14 18:31,843715,179557,475245,188913,843715
2023-04-14 18:32,843721,179559,475246,188916,843721
2023-04-14 18:33,843727,179563,475246,188918,843727
2023-04-14 18:34,843734,179558,475253,188923,843734
2023-04-14 18:35,843741,179561,475253,188927,843741
2023-04-14 18:36,843747,179562,475256,188929,843747
2023-04-14 18:37,843752,179561,475258,188933,843752
2023-04-14 18:38,843759,179561,475258,188940,843759
2023-04-14 18:39,843765,179558,475262,188945,843765
2023-04-14 18:40,843771,179562,475262,188947,843771
2023-04-14 18:41,843777,179561,475264,188952,843777
2023-04-14 18:42,843783,179563,475264,188956,843783
2023-04-14 18:43,843789,179556,475274,188959,843789
2023-04-14 18:44,843795,179557,475274,188964,843795
2023-04-14 18:45,843804,179560,475279,188965,843804
2023-04-14 18:46,843810,179565,475279,188966,843810
2023-04-14 18:47,843815,179555,475285,188975,843815
2023-04-14 18:48,843822,179561,475285,188976,843822
2023-04-14 18:49,843828,179561,475289,188978,843828
2023-04-14 18:51,843834,179563,475289,188982,843834
2023-04-14 18:52,843840,179556,475296,188988,843840
2023-04-14 18:53,843845,179558,475296,188991,843845
2023-04-14 18:54,843851,179560,475298,188993,843851
2023-04-14 18:55,843857,179557,475303,188997,843857
2023-04-14 18:56,843863,179561,475303,188999,843863
2023-04-14 18:57,843869,179557,475310,189002,843869
2023-04-14 18:58,843876,179556,475310,189010,843876
2023-04-14 18:59,843882,179554,475314,189014,843882
2023-04-14 19:00,843889,179558,475314,189017,843889
2023-04-14 19:01,843901,179562,475319,189020,843901
2023-04-14 19:02,843912,179563,475324,189025,843912
2023-04-14 19:03,843923,179571,475324,189028,843923
2023-04-14 19:04,843933,179574,475329,189030,843933
2023-04-14 19:05,843945,179585,475329,189031,843945
2023-04-14 19:06,843958,179589,475336,189033,843958
2023-04-14 19:07,843968,179592,475336,189040,843968
2023-04-14 19:08,843979,179597,475338,189044,843979
2023-04-14 19:09,843992,179603,475343,189046,843992
2023-04-14 19:10,844003,179612,475343,189048,844003
2023-04-14 19:11,844014,179611,475353,189050,844014
2023-04-14 19:12,844025,179618,475353,189054,844025
2023-04-14 19:13,844037,179621,475354,189062,844037
2023-04-14 19:14,844047,179626,475354,189067,844047
2023-04-14 19:15,844058,179625,475358,189075,844058
2023-04-14 19:16,844069,179634,475358,189077,844069
2023-04-14 19:17,844080,179636,475365,189079,844080
2023-04-14 19:18,844091,179642,475365,189084,844091
2023-04-14 19:19,844101,179647,475369,189085,844101
2023-04-14 19:20,844112,179652,475371,189089,844112
2023-04-14 19:21,844123,179659,475371,189093,844123
2023-04-14 19:22,844135,179665,475376,189094,844135
2023-04-14 19:23,844146,179675,475376,189095,844146
2023-04-14 19:24,844159,179680,475380,189099,844159
2023-04-14 19:25,844170,179685,475380,189105,844170
2023-04-14 19:26,844180,179688,475385,189107,844180
2023-04-14 19:27,844191,179696,475385,189110,844191
2023-04-14 19:28,844202,179696,475390,189116,844202
2023-04-14 19:29,844216,179700,475391,189125,844216
2023-04-14 19:30,844227,179705,475391,189131,844227
2023-04-14 19:31,844238,179708,475396,189134,844238
2023-04-14 19:32,844250,179718,475396,189136,844250
2023-04-14 19:33,844261,179724,475400,189137,844261
2023-04-14 19:34,844272,179732,475400,189140,844272
2023-04-14 19:35,844282,179733,475405,189144,844282
2023-04-14 19:37,844294,179740,475405,189149,844294
2023-04-14 19:38,844306,179743,475410,189153,844306
2023-04-14 19:39,844316,179748,475410,189158,844316
2023-04-14 19:40,844328,179756,475413,189159,844328
2023-04-14 19:41,844338,179759,475413,189166,844338
2023-04-14 19:42,844350,179760,475419,189171,844350
2023-04-14 19:43,844361,179762,475424,189175,844361
2023-04-14 19:44,844372,179766,475426,189180,844372
2023-04-14 19:45,844382,179770,475426,189186,844382
2023-04-14 19:46,844393,179772,475431,189190,844393
2023-04-14 19:47,844405,179775,475436,189194,844405
2023-04-14 19:48,844415,179785,475436,189194,844415
2023-04-14 19:49,844427,179781,475443,189203,844427
2023-04-14 19:50,844437,179786,475443,189208,844437
2023-04-14 19:51,844449,179789,475450,189210,844449
2023-04-14 19:52,844462,179798,475450,189214,844462
2023-04-14 19:53,844473,179792,475460,189221,844473
2023-04-14 19:54,844483,179794,475460,189229,844483
2023-04-14 19:55,844494,179797,475463,189234,844494
2023-04-14 19:56,844505,179806,475463,189236,844505
2023-04-14 19:57,844516,179811,475467,189238,844516
2023-04-14 19:58,844527,179819,475467,189241,844527
2023-04-14 19:59,844538,179824,475472,189242,844538
2023-04-14 20:00,844557,179839,475472,189246,844557
2023-04-14 20:01,844584,179860,475477,189247,844584
2023-04-14 20:02,844609,179880,475478,189251,844609
2023-04-14 20:03,844636,179904,475478,189254,844636
2023-04-14 20:04,844664,179926,475482,189256,844664
2023-04-14 20:05,844691,179950,475482,189259,844691
2023-04-14 20:06,844717,179966,475490,189261,844717
2023-04-14 20:07,844743,179987,475494,189262,844743
2023-04-14 20:08,844771,180013,475494,189264,844771
2023-04-14 20:09,844796,180026,475502,189268,844796
2023-04-14 20:10,844823,180048,475502,189273,844823
2023-04-14 20:11,844850,180072,475504,189274,844850
2023-04-14 20:12,844877,180093,475504,189280,844877
2023-04-14 20:13,844905,180111,475512,189282,844905
2023-04-14 20:14,844931,180132,475515,189284,844931
2023-04-14 20:15,844957,180153,475515,189289,844957
2023-04-14 20:16,844985,180168,475524,189293,844985
2023-04-14 20:17,845013,180194,475524,189295,845013
2023-04-14 20:18,845040,180213,475530,189297,845040
2023-04-14 20:19,845065,180234,475530,189301,845065
2023-04-14 20:20,845093,180257,475535,189301,845093
2023-04-14 20:21,845119,180279,475535,189305,845119
2023-04-14 20:22,845145,180300,475537,189308,845145
2023-04-14 20:24,845173,180324,475537,189312,845173
2023-04-14 20:25,845199,180340,475542,189317,845199
2023-04-14 20:26,845226,180364,475542,189320,845226
2023-04-14 20:27,845253,180382,475549,189322,845253
2023-04-14 20:28,845281,180408,475549,189324,845281
2023-04-14 20:29,845308,180429,475554,189325,845308
2023-04-14 20:30,845334,180452,475554,189328,845334
2023-04-14 20:31,845360,180475,475556,189329,845360
2023-04-14 20:32,845389,180500,475556,189333,845389
2023-04-14 20:33,845416,180519,475561,189336,845416
2023-04-14 20:34,845446,180545,475561,189340,845446
2023-04-14 20:35,845473,180566,475564,189343,845473
2023-04-14 20:36,845500,180590,475564,189346,845500
2023-04-14 20:37,845526,180610,475568,189348,845526
2023-04-14 20:38,845554,180634,475571,189349,845554
2023-04-14 20:39,845579,180649,475573,189357,845579
2023-04-14 20:40,845607,180673,475573,189361,845607
2023-04-14 20:41,845636,180691,475583,189362,845636
2023-04-14 20:42,845663,180712,475583,189368,845663
2023-04-14 20:43,845689,180728,475588,189373,845689
2023-04-14 20:44,845717,180751,475588,189378,845717
2023-04-14 20:45,845746,180775,475591,189380,845746
2023-04-14 20:46,845771,180797,475591,189383,845771
2023-04-14 20:47,845800,180814,475598,189388,845800
2023-04-14 20:48,845826,180835,475598,189393,845826
2023-04-14 20:49,845851,180852,475605,189394,845851
2023-04-14 20:50,845878,180873,475608,189397,845878
2023-04-14 20:51,845906,180898,475608,189400,845906
2023-04-14 20:52,845932,180919,475611,189402,845932
2023-04-14 20:53,845960,180945,475611,189404,845960
2023-04-14 20:54,845987,180962,475618,189407,845987
2023-04-14 20:55,846014,180983,475618,189413,846014
2023-04-14 20:56,846041,180996,475625,189420,846041
2023-04-14 20:57,846068,181022,475625,189421,846068
2023-04-14 20:58,846094,181037,475629,189428,846094
2023-04-14 20:59,846122,181062,475629,189431,846122
2023-04-14 21:00,846139,181065,475638,189436,846139
2023-04-14 21:01,846151,181070,475643,189438,846151
2023-04-14 21:02,846164,181079,475646,189439,846164
2023-04-14 21:03,846180,181091,475646,189443,846180
2023-04-14 21:04,846193,181093,475656,189444,846193
2023-04-14 21:05,846207,181099,475656,189452,846207
2023-04-14 21:06,846220,181105,475656,189459,846220
2023-04-14 21:07,846233,181116,475656,189461,846233
2023-04-14 21:08,846247,181126,475656,189465,846247
2023-04-14 21:09,846260,181136,475656,189468,846260
2023-04-14 21:10,846273,181124,475671,189478,846273
2023-04-14 21:12,846286,181129,475674,189483,846286
2023-04-14 21:13,846299,181137,475674,189488,846299
2023-04-14 21:14,846312,181139,475681,189492,846312
2023-04-14 21:15,846325,181148,475681,189496,846325
2023-04-14 21:16,846339,181155,475684,189500,846339
2023-04-14 21:17,846354,181165,475684,189505,846354
2023-04-14 21:18,846367,181168,475692,189507,846367
2023-04-14 21:19,846381,181175,475692,189514,846381
2023-04-14 21:20,846396,181181,475697,189518,846396
2023-04-14 21:21,846409,181188,475697,189524,846409
2023-04-14 21:22,846421,181189,475705,189527,846421
2023-04-14 21:23,846437,181203,475705,189529,846437
2023-04-14 21:24,846449,181206,475712,189531,846449
2023-04-14 21:25,846463,181217,475712,189534,846463
2023-04-14 21:26,846476,181219,475718,189539,846476
2023-04-14 21:27,846488,181227,475718,189543,846488
2023-04-14 21:28,846502,181226,475724,189552,846502
2023-04-14 21:29,846515,181236,475724,189555,846515
2023-04-14 21:30,846529,181244,475728,189557,846529
2023-04-14 21:31,846541,181254,475728,189559,846541
2023-04-14 21:32,846556,181263,475732,189561,846556
2023-04-14 21:33,846570,181273,475732,189565,846570
2023-04-14 21:34,846584,181273,475739,189572,846584
2023-04-14 21:35,846597,181280,475739,189578,846597
2023-04-14 21:36,846611,181287,475743,189581,846611
2023-04-14 21:37,846624,181299,475743,189582,846624
2023-04-14 21:38,846637,181301,475747,189589,846637
2023-04-14 21:39,846650,181310,475747,189593,846650
2023-04-14 21:40,846663,181315,475752,189596,846663
2023-04-14 21:41,846676,181327,475752,189597,846676
2023-04-14 21:42,846689,181332,475757,189600,846689
2023-04-14 21:43,846702,181338,475757,189607,846702
2023-04-14 21:44,846717,181345,475762,189610,846717
2023-04-14 21:45,846729,181354,475762,189613,846729
2023-04-14 21:46,846743,181361,475767,189615,846743
2023-04-14 21:47,846757,181365,475767,189625,846757
2023-04-14 21:48,846770,181370,475771,189629,846770
2023-04-14 21:49,846782,181376,475771,189635,846782
2023-04-14 21:50,846795,181381,475776,189638,846795
2023-04-14 21:51,846809,181391,475776,189642,846809
2023-04-14 21:52,846822,181392,475786,189644,846822
2023-04-14 21:53,846835,181401,475786,189648,846835
2023-04-14 21:54,846849,181406,475793,189650,846849
2023-04-14 21:55,846863,181416,475793,189654,846863
2023-04-14 21:56,846876,181416,475801,189659,846876
2023-04-14 21:57,846889,181427,475801,189661,846889
2023-04-14 21:58,846901,181431,475806,189664,846901
2023-04-14 22:00,846915,181440,475806,189669,846915
2023-04-14 22:01,846943,181459,475812,189672,846943
2023-04-14 22:02,846971,181483,475812,189676,846971
2023-04-14 22:03,846997,181501,475817,189679,846997
2023-04-14 22:04,847025,181514,475823,189688,847025
2023-04-14 22:05,847054,181541,475823,189690,847054
2023-04-14 22:06,847081,181557,475828,189696,847081
2023-04-14 22:07,847108,181577,475828,189703,847108
2023-04-14 22:08,847139,181600,475828,189711,847139
2023-04-14 22:09,847166,181620,475832,189714,847166
2023-04-14 22:10,847192,181641,475832,189719,847192
2023-04-14 22:11,847221,181659,475839,189723,847221
2023-04-14 22:12,847248,181683,475839,189726,847248
2023-04-14 22:13,847275,181697,475845,189733,847275
2023-04-14 22:14,847302,181719,475845,189738,847302
2023-04-14 22:15,847331,181734,475850,189747,847331
2023-04-14 22:16,847356,181754,475850,189752,847356
2023-04-14 22:17,847384,181775,475850,189759,847384
2023-04-14 22:18,847411,181799,475850,189762,847411
2023-04-14 22:19,847441,181823,475850,189768,847441
2023-04-14 22:20,847468,181831,475868,189769,847468
2023-04-14 22:21,847496,181858,475868,189770,847496
2023-04-14 22:22,847524,181869,475878,189777,847524
2023-04-14 22:23,847552,181887,475882,189783,847552
2023-04-14 22:24,847581,181916,475882,189783,847581
2023-04-14 22:25,847608,181934,475889,189785,847608
2023-04-14 22:26,847637,181959,475889,189789,847637
2023-04-14 22:27,847665,181982,475890,189793,847665
2023-04-14 22:28,847694,182002,475890,189802,847694
2023-04-14 22:29,847721,182021,475893,189807,847721
2023-04-14 22:30,847747,182041,475893,189813,847747
2023-04-14 22:31,847776,182062,475897,189817,847776
2023-04-14 22:32,847804,182084,475897,189823,847804
2023-04-14 22:33,847830,182101,475901,189828,847830
2023-04-14 22:34,847859,182124,475901,189834,847859
2023-04-14 22:35,847886,182133,475913,189840,847886
2023-04-14 22:36,847913,182157,475913,189843,847913
2023-04-14 22:37,847940,182175,475920,189845,847940
2023-04-14 22:38,847967,182194,475926,189847,847967
2023-04-14 22:39,847995,182217,475926,189852,847995
2023-04-14 22:40,848023,182235,475933,189855,848023
2023-04-14 22:41,848052,182260,475933,189859,848052
2023-04-14 22:42,848082,182283,475937,189862,848082
2023-04-14 22:43,848110,182306,475937,189867,848110
2023-04-14 22:44,848137,182321,475945,189871,848137
2023-04-14 22:45,848164,182340,475945,189879,848164
2023-04-14 22:47,848194,182366,475947,189881,848194
2023-04-14 22:48,848220,182383,475954,189883,848220
2023-04-14 22:49,848247,182405,475954,189888,848247
2023-04-14 22:50,848275,182423,475961,189891,848275
2023-04-14 22:51,848302,182444,475961,189897,848302
2023-04-14 22:52,848330,182459,475968,189903,848330
2023-04-14 22:53,848358,182486,475968,189904,848358
2023-04-14 22:54,848386,182506,475972,189908,848386
2023-04-14 22:55,848415,182532,475972,189911,848415
2023-04-14 22:56,848443,182551,475975,189917,848443
2023-04-14 22:57,848471,182577,475975,189919,848471
2023-04-14 22:58,848501,182591,475985,189925,848501
2023-04-14 22:59,848528,182614,475985,189929,848528
2023-04-14 23:00,848553,182627,475994,189932,848553
2023-04-14 23:01,848571,182632,476002,189937,848571
2023-04-14 23:02,848590,182643,476002,189945,848590
2023-04-14 23:03,848607,182646,476013,189948,848607
2023-04-14 23:04,848625,182656,476013,189956,848625
2023-04-14 23:05,848642,182664,476019,189959,848642
2023-04-14 23:06,848662,182680,476019,189963,848662
2023-04-14 23:07,848679,182684,476025,189970,848679
2023-04-14 23:08,848697,182699,476025,189973,848697
2023-04-14 23:09,848715,182710,476026,189979,848715
2023-04-14 23:10,848735,182726,476026,189983,848735
2023-04-14 23:11,848752,182727,476032,189993,848752
2023-04-14 23:12,848771,182740,476032,189999,848771
2023-04-14 23:13,848788,182744,476040,190004,848788
2023-04-14 23:14,848808,182761,476040,190007,848808
2023-04-14 23:15,848825,182770,476043,190012,848825
2023-04-14 23:16,848842,182783,476043,190016,848842
2023-04-14 23:17,848860,182797,476045,190018,848860
2023-04-14 23:18,848880,182816,476045,190019,848880
2023-04-14 23:19,848898,182823,476053,190022,848898
2023-04-14 23:20,848916,182838,476053,190025,848916
2023-04-14 23:21,848934,182846,476060,190028,848934
2023-04-14 23:22,848952,182862,476060,190030,848952
2023-04-14 23:23,848970,182868,476067,190035,848970
2023-04-14 23:24,848987,182883,476067,190037,848987
2023-04-14 23:25,849005,182887,476078,190040,849005
2023-04-14 23:26,849023,182904,476078,190041,849023
2023-04-14 23:27,849040,182912,476084,190044,849040
2023-04-14 23:28,849058,182925,476084,190049,849058
2023-04-14 23:29,849076,182933,476091,190052,849076
2023-04-14 23:30,849095,182941,476091,190063,849095
2023-04-14 23:31,849113,182947,476099,190067,849113
2023-04-14 23:32,849129,182960,476099,190070,849129
2023-04-14 23:34,849148,182965,476107,190076,849148
2023-04-14 23:35,849167,182979,476107,190081,849167
2023-04-14 23:36,849185,182983,476118,190084,849185
2023-04-14 23:37,849204,182997,476121,190086,849204
2023-04-14 23:38,849224,183015,476121,190088,849224
2023-04-14 23:39,849241,183022,476129,190090,849241
2023-04-14 23:40,849258,183038,476129,190091,849258
2023-04-14 23:41,849276,183044,476137,190095,849276
2023-04-14 23:42,849293,183060,476137,190096,849293
2023-04-14 23:43,849313,183068,476145,190100,849313
2023-04-14 23:44,849330,183078,476147,190105,849330
2023-04-14 23:45,849349,183093,476147,190109,849349
2023-04-14 23:46,849367,183101,476155,190111,849367
2023-04-14 23:47,849386,183116,476155,190115,849386
2023-04-14 23:48,849403,183124,476162,190117,849403
2023-04-14 23:49,849420,183130,476170,190120,849420
2023-04-14 23:50,849440,183146,476170,190124,849440
2023-04-14 23:51,849457,183151,476177,190129,849457
2023-04-14 23:52,849475,183159,476179,190137,849475
2023-04-14 23:53,849494,183171,476179,190144,849494
2023-04-14 23:54,849511,183178,476186,190147,849511
2023-04-14 23:55,849530,183193,476186,190151,849530
2023-04-14 23:56,849550,183205,476191,190154,849550
2023-04-14 23:57,849567,183216,476193,190158,849567
2023-04-14 23:58,849584,183226,476193,190165,849584
2023-04-14 23:59,849602,183236,476199,190167,849602
2023-04-15 00:00,849620,183248,476199,190173,849620
2023-04-15 00:01,849637,183259,476203,190175,849637
2023-04-15 00:02,849654,183273,476203,190178,849654
2023-04-15 00:03,849670,183283,476208,190179,849670
2023-04-15 00:04,849686,183293,476208,190185,849686
2023-04-15 00:05,849702,183296,476217,190189,849702
2023-04-15 00:06,849719,183310,476217,190192,849719
2023-04-15 00:07,849735,183321,476221,190193,849735
2023-04-15 00:08,849751,183335,476221,190195,849751
2023-04-15 00:09,849768,183342,476228,190198,849768
2023-04-15 00:10,849785,183354,476228,190203,849785
2023-04-15 00:11,849801,183360,476233,190208,849801
2023-04-15 00:12,849817,183372,476233,190212,849817
2023-04-15 00:13,849835,183381,476238,190216,849835
2023-04-15 00:14,849852,183393,476238,190221,849852
2023-04-15 00:15,849868,183401,476244,190223,849868
2023-04-15 00:16,849884,183415,476244,190225,849884
2023-04-15 00:17,849901,183429,476244,190228,849901
2023-04-15 00:18,849920,183444,476244,190232,849920
2023-04-15 00:19,849935,183454,476244,190237,849935
2023-04-15 00:20,849954,183472,476244,190238,849954
2023-04-15 00:22,849971,183486,476244,190241,849971
2023-04-15 00:23,849987,183498,476244,190245,849987
2023-04-15 00:24,850003,183485,476269,190249,850003
2023-04-15 00:25,850020,183500,476269,190251,850020
2023-04-15 00:26,850037,183511,476272,190254,850037
2023-04-15 00:27,850052,183524,476272,190256,850052
2023-04-15 00:28,850069,183535,476276,190258,850069
2023-04-15 00:29,850085,183545,476276,190264,850085
2023-04-15 00:30,850102,183550,476282,190270,850102
2023-04-15 00:31,850119,183565,476282,190272,850119
2023-04-15 00:32,850135,183571,476290,190274,850135
2023-04-15 00:33,850152,183584,476290,190278,850152
2023-04-15 00:34,850170,183589,476297,190284,850170
2023-04-15 00:35,850186,183602,476297,190287,850186
2023-04-15 00:36,850202,183610,476301,190291,850202
2023-04-15 00:37,850220,183625,476301,190294,850220
2023-04-15 00:38,850236,183635,476306,190295,850236
2023-04-15 00:39,850253,183651,476306,190296,850253
2023-04-15 00:40,850269,183658,476311,190300,850269
2023-04-15 00:41,850286,183674,476311,190301,850286
2023-04-15 00:42,850302,183686,476313,190303,850302
2023-04-15 00:43,850319,183700,476313,190306,850319
2023-04-15 00:44,850335,183709,476316,190310,850335
2023-04-15 00:45,850352,183723,476316,190313,850352
2023-04-15 00:46,850368,183730,476321,190317,850368
2023-04-15 00:47,850384,183739,476321,190324,850384
2023-04-15 00:48,850400,183748,476327,190325,850400
2023-04-15 00:49,850416,183762,476327,190327,850416
2023-04-15 00:50,850434,183776,476330,190328,850434
2023-04-15 00:51,850451,183787,476330,190334,850451
2023-04-15 00:52,850466,183796,476334,190336,850466
2023-04-15 00:53,850485,183810,476334,190341,850485
2023-04-15 00:54,850501,183820,476339,190342,850501
2023-04-15 00:55,850517,183834,476340,190343,850517
2023-04-15 00:56,850534,183847,476340,190347,850534
2023-04-15 00:57,850552,183848,476350,190354,850552
2023-04-15 00:58,850568,183859,476355,190354,850568
2023-04-15 00:59,850584,183871,476355,190358,850584
2023-04-15 01:00,850603,183875,476362,190366,850603
2023-04-15 01:01,850619,183890,476362,190367,850619
2023-04-15 01:02,850637,183901,476366,190370,850637
2023-04-15 01:03,850657,183917,476366,190374,850657
2023-04-15 01:04,850677,183930,476368,190379,850677
2023-04-15 01:05,850694,183939,476370,190385,850694
2023-04-15 01:06,850712,183954,476370,190388,850712
2023-04-15 01:07,850733,183971,476374,190388,850733
2023-04-15 01:08,850752,183989,476374,190389,850752
2023-04-15 01:10,850770,184001,476378,190391,850770
2023-04-15 01:11,850788,184012,476378,190398,850788
2023-04-15 01:12,850807,184027,476381,190399,850807
2023-04-15 01:13,850825,184040,476382,190403,850825
2023-04-15 01:14,850842,184054,476382,190406,850842
2023-04-15 01:15,850860,184066,476387,190407,850860
2023-04-15 01:16,850880,184084,476389,190407,850880
2023-04-15 01:17,850898,184094,476389,190415,850898
2023-04-15 01:18,850916,184100,476401,190415,850916
2023-04-15 01:19,850933,184116,476401,190416,850933
2023-04-15 01:20,850951,184132,476401,190418,850951
2023-04-15 01:21,850970,184147,476401,190422,850970
2023-04-15 01:22,850987,184162,476401,190424,850987
2023-04-15 01:23,851006,184179,476401,190426,851006
2023-04-15 01:24,851024,184193,476401,190430,851024
2023-04-15 01:25,851042,184205,476401,190436,851042
2023-04-15 01:26,851060,184223,476401,190436,851060
2023-04-15 01:27,851079,184226,476416,190437,851079
2023-04-15 01:28,851097,184241,476416,190440,851097
2023-04-15 01:29,851115,184253,476421,190441,851115
2023-04-15 01:30,851134,184269,476421,190444,851134
2023-04-15 01:31,851151,184281,476423,190447,851151
2023-04-15 01:32,851170,184294,476423,190453,851170
2023-04-15 01:33,851190,184311,476423,190456,851190
2023-04-15 01:34,851209,184324,476423,190462,851209
2023-04-15 01:35,851227,184335,476426,190466,851227
2023-04-15 01:36,851244,184352,476426,190466,851244
2023-04-15 01:37,851262,184363,476429,190470,851262
2023-04-15 01:38,851280,184381,476429,190470,851280
2023-04-15 01:39,851299,184392,476435,190472,851299
2023-04-15 01:40,851317,184409,476435,190473,851317
2023-04-15 01:41,851335,184419,476439,190477,851335
2023-04-15 01:42,851353,184436,476439,190478,851353
2023-04-15 01:43,851372,184450,476443,190479,851372
2023-04-15 01:44,851390,184464,476446,190480,851390
2023-04-15 01:45,851407,184480,476446,190481,851407
2023-04-15 01:46,851425,184492,476448,190485,851425
2023-04-15 01:47,851445,184510,476448,190487,851445
2023-04-15 01:48,851462,184522,476450,190490,851462
2023-04-15 01:49,851480,184537,476450,190493,851480
2023-04-15 01:50,851498,184545,476455,190498,851498
2023-04-15 01:51,851516,184564,476455,190497,851516
2023-04-15 01:52,851535,184575,476460,190500,851535
2023-04-15 01:53,851552,184589,476460,190503,851552
2023-04-15 01:54,851571,184605,476460,190506,851571
2023-04-15 01:55,851590,184625,476460,190505,851590
2023-04-15 01:56,851608,184640,476462,190506,851608
2023-04-15 01:57,851626,184656,476462,190508,851626
2023-04-15 01:58,851644,184666,476467,190511,851644
2023-04-15 02:00,851662,184682,476467,190513,851662
2023-04-15 02:01,851677,184693,476470,190514,851677
2023-04-15 02:02,851689,184704,476470,190515,851689
2023-04-15 02:03,851703,184714,476472,190517,851703
2023-04-15 02:04,851717,184726,476472,190519,851717
2023-04-15 02:05,851730,184734,476473,190523,851730
2023-04-15 02:06,851743,184746,476473,190524,851743
2023-04-15 02:07,851757,184756,476475,190526,851757
2023-04-15 02:08,851770,184768,476475,190527,851770
2023-04-15 02:09,851784,184776,476476,190532,851784
2023-04-15 02:10,851797,184789,476476,190532,851797
2023-04-15 02:11,851810,184798,476476,190536,851810
2023-04-15 02:12,851823,184811,476476,190536,851823
2023-04-15 02:13,851837,184820,476480,190537,851837
2023-04-15 02:14,851852,184833,476480,190539,851852
2023-04-15 02:15,851865,184840,476486,190539,851865
2023-04-15 02:16,851878,184852,476486,190540,851878
2023-04-15 02:17,851891,184861,476490,190540,851891
2023-04-15 02:18,851904,184874,476490,190540,851904
2023-04-15 02:19,851918,184884,476493,190541,851918
2023-04-15 02:20,851932,184895,476493,190544,851932
2023-04-15 02:21,851945,184908,476493,190544,851945
2023-04-15 02:22,851959,184920,476495,190544,851959
2023-04-15 02:23,851972,184928,476495,190549,851972
2023-04-15 02:24,851985,184937,476497,190551,851985
2023-04-15 02:25,851998,184949,476497,190552,851998
2023-04-15 02:26,852011,184959,476498,190554,852011
2023-04-15 02:27,852024,184970,476498,190556,852024
2023-04-15 02:28,852038,184980,476500,190558,852038
2023-04-15 02:29,852051,184989,476500,190562,852051
2023-04-15 02:30,852064,184999,476502,190563,852064
2023-04-15 02:31,852078,185011,476502,190565,852078
2023-04-15 02:32,852091,185021,476505,190565,852091
2023-04-15 02:33,852105,185033,476507,190565,852105
2023-04-15 02:34,852119,185045,476507,190567,852119
2023-04-15 02:35,852131,185056,476507,190568,852131
2023-04-15 02:36,852146,185070,476507,190569,852146
2023-04-15 02:37,852159,185083,476507,190569,852159
2023-04-15 02:38,852172,185094,476507,190571,852172
2023-04-15 02:39,852185,185106,476507,190572,852185
2023-04-15 02:40,852198,185117,476507,190574,852198
2023-04-15 02:41,852211,185127,476507,190577,852211
2023-04-15 02:42,852226,185141,476507,190578,852226
2023-04-15 02:43,852239,185145,476512,190582,852239
2023-04-15 02:44,852254,185157,476512,190585,852254
2023-04-15 02:45,852267,185167,476514,190586,852267
2023-04-15 02:46,852280,185180,476514,190586,852280
2023-04-15 02:48,852294,185191,476517,190586,852294
2023-04-15 02:49,852307,185203,476517,190587,852307
2023-04-15 02:50,852320,185213,476517,190590,852320
2023-04-15 02:51,852333,185223,476518,190592,852333
2023-04-15 02:52,852348,185237,476518,190593,852348
2023-04-15 02:53,852361,185246,476518,190597,852361
2023-04-15 02:54,852374,185258,476518,190598,852374
2023-04-15 02:55,852388,185270,476519,190599,852388
2023-04-15 02:56,852401,185282,476519,190600,852401
2023-04-15 02:57,852415,185291,476521,190603,852415
2023-04-15 02:58,852427,185303,476521,190603,852427
2023-04-15 02:59,852441,185313,476524,190604,852441
2023-04-15 03:00,852455,185327,476524,190604,852455
2023-04-15 03:01,852467,185338,476524,190605,852467
2023-04-15 03:02,852480,185348,476524,190608,852480
2023-04-15 03:03,852494,185356,476527,190611,852494
2023-04-15 03:04,852507,185367,476527,190613,852507
2023-04-15 03:05,852521,185379,476528,190614,852521
2023-04-15 03:06,852534,185391,476528,190615,852534
2023-04-15 03:07,852547,185402,476528,190617,852547
2023-04-15 03:08,852560,185415,476528,190617,852560
2023-04-15 03:09,852573,185425,476529,190619,852573
2023-04-15 03:10,852585,185437,476529,190619,852585
2023-04-15 03:11,852599,185449,476530,190620,852599
2023-04-15 03:12,852611,185459,476530,190622,852611
2023-04-15 03:13,852624,185469,476533,190622,852624
2023-04-15 03:14,852637,185482,476533,190622,852637
2023-04-15 03:15,852651,185493,476535,190623,852651
2023-04-15 03:16,852663,185505,476535,190623,852663
2023-04-15 03:17,852676,185517,476536,190623,852676
2023-04-15 03:18,852689,185529,476536,190624,852689
2023-04-15 03:19,852702,185543,476535,190624,852702
2023-04-15 03:20,852715,185554,476535,190626,852715
2023-04-15 03:21,852728,185565,476536,190627,852728
2023-04-15 03:22,852740,185576,476536,190628,852740
2023-04-15 03:23,852753,185588,476536,190629,852753
2023-04-15 03:24,852767,185601,476536,190630,852767
2023-04-15 03:25,852779,185611,476538,190630,852779
2023-04-15 03:26,852793,185623,476538,190632,852793
2023-04-15 03:27,852806,185634,476538,190634,852806
2023-04-15 03:28,852819,185647,476538,190634,852819
2023-04-15 03:29,852832,185660,476538,190634,852832
2023-04-15 03:30,852845,185672,476538,190635,852845
2023-04-15 03:31,852859,185684,476540,190635,852859
2023-04-15 03:32,852872,185695,476540,190637,852872
2023-04-15 03:33,852884,185703,476542,190639,852884
2023-04-15 03:34,852898,185717,476542,190639,852898
2023-04-15 03:36,852911,185725,476543,190643,852911
2023-04-15 03:37,852923,185737,476543,190643,852923
2023-04-15 03:38,852936,185750,476543,190643,852936
2023-04-15 03:39,852949,185762,476543,190644,852949
2023-04-15 03:40,852962,185775,476543,190644,852962
2023-04-15 03:41,852976,185788,476543,190645,852976
2023-04-15 03:42,852989,185800,476544,190645,852989
2023-04-15 03:43,853002,185812,476544,190646,853002
2023-04-15 03:44,853015,185822,476545,190648,853015
2023-04-15 03:45,853028,185833,476545,190650,853028
2023-04-15 03:46,853041,185842,476546,190653,853041
2023-04-15 03:47,853053,185851,476546,190656,853053
2023-04-15 03:48,853068,185864,476547,190657,853068
2023-04-15 03:49,853081,185876,476547,190658,853081
2023-04-15 03:50,853093,185888,476547,190658,853093
2023-04-15 03:51,853107,185902,476547,190658,853107
2023-04-15 03:52,853119,185913,476548,190658,853119
2023-04-15 03:53,853132,185926,476548,190658,853132
2023-04-15 03:54,853145,185938,476548,190659,853145
2023-04-15 03:55,853158,185950,476548,190660,853158
2023-04-15 03:56,853171,185962,476549,190660,853171
2023-04-15 03:57,853184,185975,476549,190660,853184
2023-04-15 03:58,853196,185986,476549,190661,853196
2023-04-15 03:59,853210,185999,476549,190662,853210
2023-04-15 04:00,853220,186008,476550,190662,853220
2023-04-15 04:01,853228,186013,476552,190663,853228
2023-04-15 04:02,853236,186020,476552,190664,853236
2023-04-15 04:03,853243,186026,476552,190665,853243
2023-04-15 04:04,853251,186034,476552,190665,853251
2023-04-15 04:05,853258,186041,476552,190665,853258
2023-04-15 04:06,853266,186049,476552,190665,853266
2023-04-15 04:07,853274,186056,476552,190666,853274
2023-04-15 04:08,853282,186064,476552,190666,853282
2023-04-15 04:09,853290,186072,476552,190666,853290
2023-04-15 04:10,853298,186078,476552,190668,853298
2023-04-15 04:11,853306,186082,476554,190670,853306
2023-04-15 04:12,853313,186089,476554,190670,853313
2023-04-15 04:13,853321,186095,476554,190672,853321
2023-04-15 04:14,853329,186103,476554,190672,853329
2023-04-15 04:15,853336,186108,476555,190673,853336
2023-04-15 04:16,853344,186115,476555,190674,853344
2023-04-15 04:17,853352,186121,476557,190674,853352
2023-04-15 04:18,853359,186128,476557,190674,853359
2023-04-15 04:19,853367,186135,476558,190674,853367
2023-04-15 04:20,853374,186142,476558,190674,853374
2023-04-15 04:22,853382,186149,476558,190675,853382
2023-04-15 04:23,853390,186157,476558,190675,853390
2023-04-15 04:24,853398,186165,476558,190675,853398
2023-04-15 04:25,853405,186171,476558,190676,853405
2023-04-15 04:26,853413,186178,476559,190676,853413
2023-04-15 04:27,853421,186186,476559,190676,853421
2023-04-15 04:28,853428,186192,476560,190676,853428
2023-04-15 04:29,853436,186199,476560,190677,853436
2023-04-15 04:30,853443,186204,476562,190677,853443
2023-04-15 04:31,853451,186212,476562,190677,853451
2023-04-15 04:32,853459,186219,476563,190677,853459
2023-04-15 04:33,853466,186225,476563,190678,853466
2023-04-15 04:34,853474,186232,476563,190679,853474
2023-04-15 04:35,853482,186240,476563,190679,853482
2023-04-15 04:36,853490,186248,476563,190679,853490
2023-04-15 04:37,853497,186255,476563,190679,853497
2023-04-15 04:38,853505,186262,476564,190679,853505
2023-04-15 04:39,853513,186270,476564,190679,853513
2023-04-15 04:40,853520,186275,476565,190680,853520
2023-04-15 04:41,853528,186283,476565,190680,853528
2023-04-15 04:42,853535,186290,476565,190680,853535
2023-04-15 04:43,853543,186298,476565,190680,853543
2023-04-15 04:44,853550,186303,476567,190680,853550
2023-04-15 04:45,853559,186312,476567,190680,853559
2023-04-15 04:46,853566,186317,476569,190680,853566
2023-04-15 04:47,853574,186324,476569,190681,853574
2023-04-15 04:48,853581,186331,476569,190681,853581
2023-04-15 04:49,853589,186339,476569,190681,853589
2023-04-15 04:50,853597,186345,476570,190682,853597
2023-04-15 04:51,853605,186353,476570,190682,853605
2023-04-15 04:52,853612,186358,476571,190683,853612
2023-04-15 04:53,853619,186365,476571,190683,853619
2023-04-15 04:54,853627,186373,476571,190683,853627
2023-04-15 04:55,853635,186381,476571,190683,853635
2023-04-15 04:56,853643,186387,476572,190684,853643
2023-04-15 04:57,853651,186394,476572,190685,853651
2023-04-15 04:58,853658,186399,476572,190687,853658
2023-04-15 04:59,853666,186407,476572,190687,853666
2023-04-15 05:00,853690,186431,476572,190687,853690
2023-04-15 05:01,853718,186458,476573,190687,853718
2023-04-15 05:02,853749,186487,476573,190689,853749
2023-04-15 05:03,853777,186512,476575,190690,853777
2023-04-15 05:04,853806,186541,476575,190690,853806
2023-04-15 05:05,853838,186572,476576,190690,853838
2023-04-15 05:06,853867,186601,476576,190690,853867
2023-04-15 05:07,853895,186629,476576,190690,853895
2023-04-15 05:09,853924,186658,476576,190690,853924
2023-04-15 05:10,853953,186686,476577,190690,853953
2023-04-15 05:11,853984,186717,476577,190690,853984
2023-04-15 05:12,854013,186746,476577,190690,854013
2023-04-15 05:13,854041,186774,476577,190690,854041
2023-04-15 05:14,854071,186802,476579,190690,854071
2023-04-15 05:15,854100,186831,476579,190690,854100
2023-04-15 05:16,854130,186860,476580,190690,854130
2023-04-15 05:17,854159,186888,476580,190691,854159
2023-04-15 05:18,854189,186917,476580,190692,854189
2023-04-15 05:19,854218,186946,476580,190692,854218
2023-04-15 05:20,854247,186973,476580,190694,854247
2023-04-15 05:21,854276,187002,476580,190694,854276
2023-04-15 05:22,854305,187031,476580,190694,854305
2023-04-15 05:23,854335,187061,476580,190694,854335
2023-04-15 05:24,854364,187090,476580,190694,854364
2023-04-15 05:25,854393,187119,476580,190694,854393
2023-04-15 05:26,854424,187149,476581,190694,854424
2023-04-15 05:27,854453,187178,476581,190694,854453
2023-04-15 05:28,854482,187206,476582,190694,854482
2023-04-15 05:29,854511,187233,476582,190696,854511
2023-04-15 05:30,854542,187264,476582,190696,854542
2023-04-15 05:31,854571,187293,476582,190696,854571
2023-04-15 05:32,854599,187320,476583,190696,854599
2023-04-15 05:33,854629,187350,476583,190696,854629
2023-04-15 05:34,854657,187375,476583,190699,854657
2023-04-15 05:35,854687,187405,476583,190699,854687
2023-04-15 05:36,854717,187433,476585,190699,854717
2023-04-15 05:37,854747,187463,476585,190699,854747
2023-04-15 05:38,854775,187490,476586,190699,854775
2023-04-15 05:39,854805,187519,476586,190700,854805
2023-04-15 05:40,854834,187550,476584,190700,854834
2023-04-15 05:41,854863,187578,476584,190701,854863
2023-04-15 05:42,854893,187608,476584,190701,854893
2023-04-15 05:43,854922,187636,476584,190702,854922
2023-04-15 05:44,854953,187666,476584,190703,854953
2023-04-15 05:45,854981,187693,476584,190704,854981
2023-04-15 05:46,855010,187721,476585,190704,855010
2023-04-15 05:47,855039,187750,476585,190704,855039
2023-04-15 05:48,855070,187781,476585,190704,855070
2023-04-15 05:49,855099,187810,476585,190704,855099
2023-04-15 05:50,855127,187837,476586,190704,855127
2023-04-15 05:51,855156,187864,476586,190706,855156
2023-04-15 05:52,855186,187893,476587,190706,855186
2023-04-15 05:53,855217,187924,476587,190706,855217
2023-04-15 05:55,855246,187952,476588,190706,855246
2023-04-15 05:56,855276,187982,476588,190706,855276
2023-04-15 05:57,855304,188008,476589,190707,855304
2023-04-15 05:58,855334,188038,476589,190707,855334
2023-04-15 05:59,855362,188062,476592,190708,855362
2023-04-15 06:00,855391,188091,476592,190708,855391
2023-04-15 06:01,855412,188112,476592,190708,855412
2023-04-15 06:02,855432,188132,476592,190708,855432
2023-04-15 06:03,855452,188152,476592,190708,855452
2023-04-15 06:04,855473,188173,476592,190708,855473
2023-04-15 06:05,855493,188192,476592,190709,855493
2023-04-15 06:06,855514,188212,476592,190710,855514
2023-04-15 06:07,855533,188231,476592,190710,855533
2023-04-15 06:08,855554,188251,476592,190711,855554
2023-04-15 06:09,855575,188268,476595,190712,855575
2023-04-15 06:10,855595,188288,476595,190712,855595
2023-04-15 06:11,855615,188306,476597,190712,855615
2023-04-15 06:12,855636,188325,476597,190714,855636
2023-04-15 06:13,855655,188343,476597,190715,855655
2023-04-15 06:14,855676,188363,476597,190716,855676
2023-04-15 06:15,855696,188380,476598,190718,855696
2023-04-15 06:16,855717,188400,476598,190719,855717
2023-04-15 06:17,855737,188417,476599,190721,855737
2023-04-15 06:18,855757,188436,476599,190722,855757
2023-04-15 06:19,855778,188456,476600,190722,855778
2023-04-15 06:20,855798,188475,476600,190723,855798
2023-04-15 06:21,855818,188494,476600,190724,855818
2023-04-15 06:22,855838,188513,476600,190725,855838
2023-04-15 06:23,855859,188533,476601,190725,855859
2023-04-15 06:24,855879,188553,476601,190725,855879
2023-04-15 06:25,855899,188573,476601,190725,855899
2023-04-15 06:26,855919,188593,476601,190725,855919
2023-04-15 06:27,855940,188610,476603,190727,855940
2023-04-15 06:28,855961,188630,476603,190728,855961
2023-04-15 06:29,855981,188647,476606,190728,855981
2023-04-15 06:30,856002,188668,476606,190728,856002
2023-04-15 06:31,856022,188686,476608,190728,856022
2023-04-15 06:32,856042,188704,476608,190730,856042
2023-04-15 06:33,856061,188721,476609,190731,856061
2023-04-15 06:34,856083,188743,476609,190731,856083
2023-04-15 06:35,856102,188757,476611,190734,856102
2023-04-15 06:36,856122,188776,476611,190735,856122
2023-04-15 06:37,856143,188794,476613,190736,856143
2023-04-15 06:38,856164,188814,476613,190737,856164
2023-04-15 06:39,856184,188830,476616,190738,856184
2023-04-15 06:41,856205,188850,476616,190739,856205
2023-04-15 06:42,856225,188869,476617,190739,856225
2023-04-15 06:43,856246,188890,476617,190739,856246
2023-04-15 06:44,856267,188908,476619,190740,856267
2023-04-15 06:45,856287,188927,476619,190741,856287
2023-04-15 06:46,856307,188946,476619,190742,856307
2023-04-15 06:47,856328,188964,476619,190745,856328
2023-04-15 06:48,856349,188978,476625,190746,856349
2023-04-15 06:49,856369,188998,476625,190746,856369
2023-04-15 06:50,856388,189014,476626,190748,856388
2023-04-15 06:51,856409,189034,476626,190749,856409
2023-04-15 06:52,856429,189052,476626,190751,856429
2023-04-15 06:53,856449,189071,476626,190752,856449
2023-04-15 06:54,856470,189090,476628,190752,856470
2023-04-15 06:55,856492,189112,476628,190752,856492
2023-04-15 06:56,856511,189128,476630,190753,856511
2023-04-15 06:57,856532,189147,476630,190755,856532
2023-04-15 06:58,856551,189162,476632,190757,856551
2023-04-15 06:59,856572,189182,476632,190758,856572
2023-04-15 07:00,856589,189193,476634,190762,856589
2023-04-15 07:01,856597,189200,476634,190763,856597
2023-04-15 07:02,856606,189204,476636,190766,856606
2023-04-15 07:03,856615,189213,476636,190766,856615
2023-04-15 07:04,856624,189220,476637,190767,856624
2023-04-15 07:05,856632,189226,476637,190769,856632
2023-04-15 07:06,856642,189230,476640,190772,856642
2023-04-15 07:07,856650,189236,476640,190774,856650
2023-04-15 07:08,856659,189243,476640,190776,856659
2023-04-15 07:09,856667,189250,476640,190777,856667
2023-04-15 07:10,856677,189254,476644,190779,856677
2023-04-15 07:11,856686,189263,476644,190779,856686
2023-04-15 07:12,856695,189270,476645,190780,856695
2023-04-15 07:13,856704,189278,476645,190781,856704
2023-04-15 07:14,856713,189283,476646,190784,856713
2023-04-15 07:15,856721,189289,476646,190786,856721
2023-04-15 07:16,856731,189296,476648,190787,856731
2023-04-15 07:17,856739,189300,476651,190788,856739
2023-04-15 07:18,856748,189307,476651,190790,856748
2023-04-15 07:19,856757,189314,476651,190792,856757
2023-04-15 07:20,856765,189321,476651,190793,856765
2023-04-15 07:21,856775,189329,476652,190794,856775
2023-04-15 07:22,856783,189335,476652,190796,856783
2023-04-15 07:23,856792,189343,476652,190797,856792
2023-04-15 07:24,856800,189349,476652,190799,856800
2023-04-15 07:25,856810,189356,476653,190801,856810
2023-04-15 07:26,856818,189363,476653,190802,856818
2023-04-15 07:28,856827,189371,476652,190804,856827
2023-04-15 07:29,856835,189378,476652,190805,856835
2023-04-15 07:30,856845,189379,476656,190810,856845
2023-04-15 07:31,856853,189386,476656,190811,856853
2023-04-15 07:32,856862,189392,476658,190812,856862
2023-04-15 07:33,856871,189396,476658,190817,856871
2023-04-15 07:34,856880,189399,476661,190820,856880
2023-04-15 07:35,856888,189403,476661,190824,856888
2023-04-15 07:36,856898,189412,476662,190824,856898
2023-04-15 07:37,856907,189421,476662,190824,856907
2023-04-15 07:38,856916,189424,476667,190825,856916
2023-04-15 07:39,856924,189431,476667,190826,856924
2023-04-15 07:40,856934,189440,476667,190827,856934
2023-04-15 07:41,856942,189448,476667,190827,856942
2023-04-15 07:42,856951,189451,476671,190829,856951
2023-04-15 07:43,856960,189458,476671,190831,856960
2023-04-15 07:44,856968,189465,476671,190832,856968
2023-04-15 07:45,856977,189473,476671,190833,856977
2023-04-15 07:46,856986,189478,476674,190834,856986
2023-04-15 07:47,856996,189488,476674,190834,856996
2023-04-15 07:48,857004,189490,476675,190839,857004
2023-04-15 07:49,857014,189499,476675,190840,857014
2023-04-15 07:50,857023,189502,476679,190842,857023
2023-04-15 07:51,857032,189509,476679,190844,857032
2023-04-15 07:52,857041,189515,476681,190845,857041
2023-04-15 07:53,857051,189524,476681,190846,857051
2023-04-15 07:54,857059,189527,476681,190851,857059
2023-04-15 07:55,857068,189533,476681,190854,857068
2023-04-15 07:56,857077,189540,476681,190856,857077
2023-04-15 07:57,857085,189542,476681,190862,857085
2023-04-15 07:58,857095,189550,476682,190863,857095
2023-04-15 07:59,857103,189558,476682,190863,857103
2023-04-15 08:00,857120,189571,476683,190866,857120
2023-04-15 08:01,857142,189590,476683,190869,857142
2023-04-15 08:02,857163,189606,476686,190871,857163
2023-04-15 08:03,857185,189627,476686,190872,857185
2023-04-15 08:04,857207,189646,476689,190872,857207
2023-04-15 08:05,857227,189664,476689,190874,857227
2023-04-15 08:06,857248,189682,476690,190876,857248
2023-04-15 08:07,857270,189702,476690,190878,857270
2023-04-15 08:08,857291,189718,476694,190879,857291
2023-04-15 08:09,857311,189738,476694,190879,857311
2023-04-15 08:10,857333,189755,476696,190882,857333
2023-04-15 08:11,857354,189773,476696,190885,857354
2023-04-15 08:12,857374,189791,476696,190887,857374
2023-04-15 08:13,857396,189811,476696,190889,857396
2023-04-15 08:15,857417,189827,476700,190890,857417
2023-04-15 08:16,857437,189845,476700,190892,857437
2023-04-15 08:17,857459,189863,476703,190893,857459
2023-04-15 08:18,857480,189883,476703,190894,857480
2023-04-15 08:19,857500,189899,476704,190897,857500
2023-04-15 08:20,857521,189913,476704,190904,857521
2023-04-15 08:21,857544,189930,476707,190907,857544
2023-04-15 08:22,857564,189950,476707,190907,857564
2023-04-15 08:23,857585,189962,476714,190909,857585
2023-04-15 08:24,857606,189981,476714,190911,857606
2023-04-15 08:25,857627,189998,476718,190911,857627
2023-04-15 08:26,857648,190015,476718,190915,857648
2023-04-15 08:27,857670,190029,476721,190920,857670
2023-04-15 08:28,857691,190048,476721,190922,857691
2023-04-15 08:29,857713,190064,476724,190925,857713
2023-04-15 08:30,857733,190084,476724,190925,857733
2023-04-15 08:31,857755,190101,476728,190926,857755
2023-04-15 08:32,857775,190118,476728,190929,857775
2023-04-15 08:33,857798,190139,476728,190931,857798
2023-04-15 08:34,857819,190158,476728,190933,857819
2023-04-15 08:35,857840,190173,476731,190936,857840
2023-04-15 08:36,857862,190193,476731,190938,857862
2023-04-15 08:37,857883,190209,476731,190943,857883
2023-04-15 08:38,857904,190229,476731,190944,857904
2023-04-15 08:39,857925,190246,476734,190945,857925
2023-04-15 08:40,857946,190262,476734,190950,857946
2023-04-15 08:41,857968,190281,476736,190951,857968
2023-04-15 08:42,857988,190296,476739,190953,857988
2023-04-15 08:43,858010,190316,476739,190955,858010
2023-04-15 08:44,858031,190331,476742,190958,858031
2023-04-15 08:45,858052,190348,476742,190962,858052
2023-04-15 08:46,858072,190362,476742,190968,858072
2023-04-15 08:47,858095,190376,476746,190973,858095
2023-04-15 08:48,858117,190394,476746,190977,858117
2023-04-15 08:49,858139,190410,476748,190981,858139
2023-04-15 08:50,858160,190429,476748,190983,858160
2023-04-15 08:51,858180,190443,476749,190988,858180
2023-04-15 08:52,858201,190462,476749,190990,858201
2023-04-15 08:53,858223,190477,476753,190993,858223
2023-04-15 08:54,858244,190496,476753,190995,858244
2023-04-15 08:55,858265,190510,476755,191000,858265
2023-04-15 08:56,858287,190530,476755,191002,858287
2023-04-15 08:57,858307,190544,476760,191003,858307
2023-04-15 08:58,858329,190564,476760,191005,858329
2023-04-15 08:59,858351,190578,476764,191009,858351
2023-04-15 09:00,858381,190605,476764,191012,858381
2023-04-15 09:02,858410,190626,476768,191016,858410
2023-04-15 09:03,858439,190655,476768,191016,858439
2023-04-15 09:04,858470,190680,476771,191019,858470
2023-04-15 09:05,858501,190708,476771,191022,858501
2023-04-15 09:06,858530,190726,476777,191027,858530
2023-04-15 09:07,858559,190755,476777,191027,858559
2023-04-15 09:08,858590,190782,476780,191028,858590
2023-04-15 09:09,858620,190808,476780,191032,858620
2023-04-15 09:10,858650,190829,476785,191036,858650
2023-04-15 09:11,858680,190857,476785,191038,858680
2023-04-15 09:12,858709,190873,476792,191044,858709
2023-04-15 09:13,858741,190904,476792,191045,858741
2023-04-15 09:14,858770,190931,476794,191045,858770
2023-04-15 09:15,858800,190958,476794,191048,858800
2023-04-15 09:16,858831,190983,476797,191051,858831
2023-04-15 09:17,858861,191010,476797,191054,858861
2023-04-15 09:18,858890,191037,476798,191055,858890
2023-04-15 09:19,858921,191064,476798,191059,858921
2023-04-15 09:20,858950,191084,476804,191062,858950
2023-04-15 09:21,858980,191113,476804,191063,858980
2023-04-15 09:22,859010,191136,476807,191067,859010
2023-04-15 09:23,859041,191161,476807,191073,859041
2023-04-15 09:24,859070,191187,476808,191075,859070
2023-04-15 09:25,859102,191219,476808,191075,859102
2023-04-15 09:26,859130,191244,476809,191077,859130
2023-04-15 09:27,859160,191269,476809,191082,859160
2023-04-15 09:28,859191,191295,476812,191084,859191
2023-04-15 09:29,859220,191323,476812,191085,859220
2023-04-15 09:30,859252,191349,476816,191087,859252
2023-04-15 09:31,859282,191377,476816,191089,859282
2023-04-15 09:32,859311,191400,476819,191092,859311
2023-04-15 09:33,859342,191425,476819,191098,859342
2023-04-15 09:34,859370,191447,476822,191101,859370
2023-04-15 09:35,859402,191477,476822,191103,859402
2023-04-15 09:36,859432,191501,476826,191105,859432
2023-04-15 09:37,859462,191525,476826,191111,859462
2023-04-15 09:38,859492,191553,476827,191112,859492
2023-04-15 09:39,859521,191577,476827,191117,859521
2023-04-15 09:40,859553,191603,476829,191121,859553
2023-04-15 09:41,859581,191625,476829,191127,859581
2023-04-15 09:42,859611,191651,476832,191128,859611
2023-04-15 09:43,859642,191678,476832,191132,859642
2023-04-15 09:44,859670,191700,476836,191134,859670
2023-04-15 09:45,859700,191727,476836,191137,859700
2023-04-15 09:46,859731,191751,476841,191139,859731
2023-04-15 09:47,859761,191775,476841,191145,859761
2023-04-15 09:48,859793,191796,476848,191149,859793
2023-04-15 09:50,859822,191819,476848,191155,859822
2023-04-15 09:51,859852,191836,476855,191161,859852
2023-04-15 09:52,859882,191863,476856,191163,859882
2023-04-15 09:53,859914,191890,476856,191168,859914
2023-04-15 09:54,859944,191916,476861,191167,859944
2023-04-15 09:55,859974,191942,476861,191171,859974
2023-04-15 09:56,860004,191962,476866,191176,860004
2023-04-15 09:57,860036,191990,476866,191180,860036
2023-04-15 09:58,860064,192010,476872,191182,860064
2023-04-15 09:59,860094,192037,476872,191185,860094
2023-04-15 10:00,860124,192058,476877,191189,860124
2023-04-15 10:01,860144,192078,476877,191189,860144
2023-04-15 10:02,860166,192094,476880,191192,860166
2023-04-15 10:03,860188,192115,476880,191193,860188
2023-04-15 10:04,860209,192129,476884,191196,860209
2023-04-15 10:05,860229,192144,476886,191199,860229
2023-04-15 10:06,860252,192164,476886,191202,860252
2023-04-15 10:07,860273,192176,476891,191206,860273
2023-04-15 10:08,860295,192196,476891,191208,860295
2023-04-15 10:09,860317,192216,476891,191210,860317
2023-04-15 10:10,860339,192227,476897,191215,860339
2023-04-15 10:11,860361,192244,476897,191220,860361
2023-04-15 10:12,860385,192256,476908,191221,860385
2023-04-15 10:13,860406,192272,476909,191225,860406
2023-04-15 10:14,860428,192287,476913,191228,860428
2023-04-15 10:15,860451,192303,476913,191235,860451
2023-04-15 10:16,860471,192321,476915,191235,860471
2023-04-15 10:17,860493,192337,476915,191241,860493
2023-04-15 10:18,860516,192353,476919,191244,860516
2023-04-15 10:19,860537,192374,476919,191244,860537
2023-04-15 10:20,860559,192393,476920,191246,860559
2023-04-15 10:21,860581,192407,476920,191254,860581
2023-04-15 10:22,860603,192423,476922,191258,860603
2023-04-15 10:23,860625,192441,476922,191262,860625
2023-04-15 10:24,860646,192451,476930,191265,860646
2023-04-15 10:25,860667,192463,476933,191271,860667
2023-04-15 10:26,860689,192476,476937,191276,860689
2023-04-15 10:27,860711,192496,476937,191278,860711
2023-04-15 10:28,860732,192512,476941,191279,860732
2023-04-15 10:29,860754,192531,476941,191282,860754
2023-04-15 10:30,860774,192544,476946,191284,860774
2023-04-15 10:31,860797,192564,476946,191287,860797
2023-04-15 10:32,860819,192581,476950,191288,860819
2023-04-15 10:33,860841,192600,476950,191291,860841
2023-04-15 10:34,860862,192614,476954,191294,860862
2023-04-15 10:35,860885,192635,476954,191296,860885
2023-04-15 10:37,860906,192646,476958,191302,860906
2023-04-15 10:38,860927,192662,476958,191307,860927
2023-04-15 10:39,860949,192672,476965,191312,860949
2023-04-15 10:40,860972,192690,476965,191317,860972
2023-04-15 10:41,860994,192707,476968,191319,860994
2023-04-15 10:42,861015,192726,476968,191321,861015
2023-04-15 10:43,861039,192743,476971,191325,861039
2023-04-15 10:44,861061,192761,476971,191329,861061
2023-04-15 10:45,861084,192780,476971,191333,861084
2023-04-15 10:46,861105,192799,476971,191335,861105
2023-04-15 10:47,861127,192808,476975,191344,861127
2023-04-15 10:48,861148,192823,476975,191350,861148
2023-04-15 10:49,861169,192836,476980,191353,861169
2023-04-15 10:50,861190,192852,476982,191356,861190
2023-04-15 10:51,861213,192871,476982,191360,861213
2023-04-15 10:52,861237,192886,476984,191367,861237
2023-04-15 10:53,861257,192902,476984,191371,861257
2023-04-15 10:54,861279,192908,476994,191377,861279
2023-04-15 10:55,861302,192927,476994,191381,861302
2023-04-15 10:56,861324,192945,476998,191381,861324
2023-04-15 10:57,861346,192963,476998,191385,861346
2023-04-15 10:58,861368,192978,477004,191386,861368
2023-04-15 10:59,861389,192991,477004,191394,861389
2023-04-15 11:00,861407,192994,477013,191400,861407
2023-04-15 11:01,861417,192996,477017,191404,861417
2023-04-15 11:02,861428,193001,477017,191410,861428
2023-04-15 11:03,861439,193003,477024,191412,861439
2023-04-15 11:04,861449,193010,477024,191415,861449
2023-04-15 11:05,861460,193007,477032,191421,861460
2023-04-15 11:06,861470,193008,477039,191423,861470
2023-04-15 11:07,861482,193015,477042,191425,861482
2023-04-15 11:08,861491,193019,477042,191430,861491
2023-04-15 11:09,861502,193016,477050,191436,861502
2023-04-15 11:10,861513,193024,477050,191439,861513
2023-04-15 11:11,861523,193025,477056,191442,861523
2023-04-15 11:12,861533,193029,477056,191448,861533
2023-04-15 11:13,861544,193028,477063,191453,861544
2023-04-15 11:14,861554,193033,477063,191458,861554
2023-04-15 11:15,861563,193032,477070,191461,861563
2023-04-15 11:16,861574,193039,477070,191465,861574
2023-04-15 11:17,861585,193044,477074,191467,861585
2023-04-15 11:18,861595,193049,477074,191472,861595
2023-04-15 11:19,861607,193054,477079,191474,861607
2023-04-15 11:20,861616,193055,477079,191482,861616
2023-04-15 11:21,861626,193055,477083,191488,861626
2023-04-15 11:22,861636,193056,477091,191489,861636
2023-04-15 11:24,861647,193063,477091,191493,861647
2023-04-15 11:25,861657,193063,477100,191494,861657
2023-04-15 11:26,861666,193068,477101,191497,861666
2023-04-15 11:27,861677,193075,477104,191498,861677
2023-04-15 11:28,861687,193082,477104,191501,861687
2023-04-15 11:29,861698,193087,477107,191504,861698
2023-04-15 11:30,861708,193095,477107,191506,861708
2023-04-15 11:31,861721,193100,477112,191509,861721
2023-04-15 11:32,861731,193105,477112,191514,861731
2023-04-15 11:33,861742,193072,477149,191521,861742
2023-04-15 11:34,861755,193052,477178,191525,861755
2023-04-15 11:35,861769,193061,477178,191530,861769
2023-04-15 11:36,861780,193048,477197,191535,861780
2023-04-15 11:37,861789,193051,477197,191541,861789
2023-04-15 11:39,861802,193034,477220,191548,861802
2023-04-15 11:40,861812,193037,477220,191555,861812
2023-04-15 11:41,861824,193025,477236,191563,861824
2023-04-15 11:42,861835,193031,477236,191568,861835
2023-04-15 11:43,861844,193015,477256,191573,861844
2023-04-15 11:44,861857,193024,477256,191577,861857
2023-04-15 11:45,861868,193014,477267,191587,861868
2023-04-15 11:46,861879,193015,477273,191591,861879
2023-04-15 11:47,861888,193021,477273,191594,861888
2023-04-15 11:48,861899,193030,477273,191596,861899
2023-04-15 11:49,861910,193036,477273,191601,861910
2023-04-15 11:50,861920,193044,477273,191603,861920
2023-04-15 11:51,861931,193052,477273,191606,861931
2023-04-15 11:52,861941,193058,477273,191610,861941
2023-04-15 11:53,861953,193006,477332,191615,861953
2023-04-15 11:54,861963,193009,477332,191622,861963
2023-04-15 11:55,861976,193006,477345,191625,861976
2023-04-15 11:56,861987,193013,477345,191629,861987
2023-04-15 11:57,861998,193008,477354,191636,861998
2023-04-15 11:58,862010,193019,477354,191637,862010
2023-04-15 11:59,862020,193011,477372,191637,862020
2023-04-15 12:00,862039,193023,477372,191644,862039
2023-04-15 12:01,862070,193039,477383,191648,862070
2023-04-15 12:03,862098,193061,477383,191654,862098
2023-04-15 12:04,862148,193099,477389,191660,862148
2023-04-15 12:06,862176,193105,477403,191668,862176
2023-04-15 12:08,862233,193141,477418,191674,862233
2023-04-15 12:09,862281,193184,477418,191679,862281
2023-04-15 12:10,862309,193202,477425,191682,862309
2023-04-15 12:11,862339,193230,477425,191684,862339
2023-04-15 12:12,862368,193235,477440,191693,862368
2023-04-15 12:14,862407,193269,477440,191698,862407
2023-04-15 12:16,862469,193305,477452,191712,862469
2023-04-15 12:18,862537,193365,477453,191719,862537
2023-04-15 12:19,862576,193391,477465,191720,862576
2023-04-15 12:20,862606,193411,477465,191730,862606
2023-04-15 12:21,862644,193435,477474,191735,862644
2023-04-15 12:22,862673,193444,477488,191741,862673
2023-04-15 12:23,862701,193469,477488,191744,862701
2023-04-15 12:24,862733,193483,477501,191749,862733
2023-04-15 12:25,862764,193510,477504,191750,862764
2023-04-15 12:26,862791,193532,477504,191755,862791
2023-04-15 12:27,862822,193553,477508,191761,862822
2023-04-15 12:28,862852,193572,477508,191772,862852
2023-04-15 12:29,862879,193582,477522,191775,862879
2023-04-15 12:30,862909,193598,477531,191780,862909
2023-04-15 12:31,862939,193623,477531,191785,862939
2023-04-15 12:33,862969,193638,477541,191790,862969
2023-04-15 12:34,862998,193657,477541,191800,862998
2023-04-15 12:35,863027,193669,477553,191805,863027
2023-04-15 12:36,863058,193693,477553,191812,863058
2023-04-15 12:37,863087,193712,477561,191814,863087
2023-04-15 12:38,863116,193736,477561,191819,863116
2023-04-15 12:39,863145,193752,477571,191822,863145
2023-04-15 12:40,863175,193769,477578,191828,863175
2023-04-15 12:41,863204,193790,477578,191836,863204
2023-04-15 12:42,863232,193800,477589,191843,863232
2023-04-15 12:43,863259,193818,477594,191847,863259
2023-04-15 12:44,863289,193841,477594,191854,863289
2023-04-15 12:45,863318,193856,477602,191860,863318
2023-04-15 12:46,863346,193875,477607,191864,863346
2023-04-15 12:47,863374,193897,477607,191870,863374
2023-04-15 12:48,863404,193913,477615,191876,863404
2023-04-15 12:49,863432,193933,477615,191884,863432
2023-04-15 12:50,863460,193947,477624,191889,863460
2023-04-15 12:51,863488,193972,477624,191892,863488
2023-04-15 12:52,863522,193990,477638,191894,863522
2023-04-15 12:53,863553,194003,477651,191899,863553
2023-04-15 12:54,863582,194028,477651,191903,863582
2023-04-15 12:55,863613,194044,477662,191907,863613
2023-04-15 12:56,863640,194064,477662,191914,863640
2023-04-15 12:57,863668,194084,477665,191919,863668
2023-04-15 12:58,863698,194106,477665,191927,863698
2023-04-15 12:59,863725,194122,477672,191931,863725
2023-04-15 13:00,863742,194134,477672,191936,863742
2023-04-15 13:01,863751,194133,477677,191941,863751
2023-04-15 13:02,863758,194138,477677,191943,863758
2023-04-15 13:03,863765,194139,477680,191946,863765
2023-04-15 13:04,863772,194143,477680,191949,863772
2023-04-15 13:05,863782,194142,477689,191951,863782
2023-04-15 13:06,863790,194142,477689,191959,863790
2023-04-15 13:07,863801,194138,477699,191964,863801
2023-04-15 13:08,863809,194140,477699,191970,863809
2023-04-15 13:09,863817,194139,477706,191972,863817
2023-04-15 13:10,863827,194145,477706,191976,863827
2023-04-15 13:11,863836,194144,477710,191982,863836
2023-04-15 13:12,863844,194148,477710,191986,863844
2023-04-15 13:13,863851,194144,477716,191991,863851
2023-04-15 13:14,863859,194147,477716,191996,863859
2023-04-15 13:15,863867,194151,477719,191997,863867
2023-04-15 13:16,863875,194155,477719,192001,863875
2023-04-15 13:17,863882,194155,477722,192005,863882
2023-04-15 13:18,863890,194160,477722,192008,863890
2023-04-15 13:20,863898,194148,477735,192015,863898
2023-04-15 13:21,863907,194152,477735,192020,863907
2023-04-15 13:22,863914,194152,477741,192021,863914
2023-04-15 13:23,863923,194157,477741,192025,863923
2023-04-15 13:24,863930,194151,477752,192027,863930
2023-04-15 13:25,863937,194150,477752,192035,863937
2023-04-15 13:26,863944,194142,477760,192042,863944
2023-04-15 13:27,863952,194141,477760,192051,863952
2023-04-15 13:28,863959,194137,477767,192055,863959
2023-04-15 13:29,863968,194141,477767,192060,863968
2023-04-15 13:30,863975,194145,477767,192063,863975
2023-04-15 13:31,863983,194148,477767,192068,863983
2023-04-15 13:32,863990,194152,477767,192071,863990
2023-04-15 13:33,863998,194147,477773,192078,863998
2023-04-15 13:34,864007,194151,477773,192083,864007
2023-04-15 13:35,864014,194146,477780,192088,864014
2023-04-15 13:36,864021,194145,477780,192096,864021
2023-04-15 13:37,864032,194142,477791,192099,864032
2023-04-15 13:38,864040,194147,477791,192102,864040
2023-04-15 13:39,864048,194146,477795,192107,864048
2023-04-15 13:40,864058,194151,477795,192112,864058
2023-04-15 13:41,864066,194149,477802,192115,864066
2023-04-15 13:42,864074,194156,477802,192116,864074
2023-04-15 13:43,864081,194153,477811,192117,864081
2023-04-15 13:44,864089,194152,477814,192123,864089
2023-04-15 13:45,864097,194155,477815,192127,864097
2023-04-15 13:46,864104,194156,477819,192129,864104
2023-04-15 13:47,864112,194162,477819,192131,864112
2023-04-15 13:48,864119,194155,477828,192136,864119
2023-04-15 13:49,864126,194157,477828,192141,864126
2023-04-15 13:50,864134,194150,477838,192146,864134
2023-04-15 13:51,864143,194153,477841,192149,864143
2023-04-15 13:52,864150,194154,477841,192155,864150
2023-04-15 13:53,864158,194153,477845,192160,864158
2023-04-15 13:54,864167,194157,477845,192165,864167
2023-04-15 13:55,864176,194159,477848,192169,864176
2023-04-15 13:56,864184,194155,477853,192176,864184
2023-04-15 13:57,864191,194158,477853,192180,864191
2023-04-15 13:58,864198,194148,477865,192185,864198
2023-04-15 13:59,864206,194150,477867,192189,864206
2023-04-15 14:00,864226,194167,477867,192192,864226
2023-04-15 14:01,864248,194171,477876,192201,864248
2023-04-15 14:02,864272,194190,477876,192206,864272
2023-04-15 14:03,864296,194205,477883,192208,864296
2023-04-15 14:04,864318,194226,477883,192209,864318
2023-04-15 14:05,864340,194240,477887,192213,864340
2023-04-15 14:06,864364,194260,477887,192217,864364
2023-04-15 14:08,864387,194275,477891,192221,864387
2023-04-15 14:09,864410,194294,477891,192225,864410
2023-04-15 14:10,864440,194312,477897,192231,864440
2023-04-15 14:12,864466,194321,477905,192240,864466
2023-04-15 14:13,864521,194372,477905,192244,864521
2023-04-15 14:14,864543,194393,477905,192245,864543
2023-04-15 14:15,864566,194402,477914,192250,864566
2023-04-15 14:16,864588,194417,477916,192255,864588
2023-04-15 14:17,864611,194436,477916,192259,864611
2023-04-15 14:18,864632,194453,477920,192259,864632
2023-04-15 14:19,864656,194468,477922,192266,864656
2023-04-15 14:20,864680,194487,477922,192271,864680
2023-04-15 14:22,864702,194499,477931,192272,864702
2023-04-15 14:23,864725,194513,477936,192276,864725
2023-04-15 14:24,864747,194533,477936,192278,864747
2023-04-15 14:25,864770,194542,477945,192283,864770
2023-04-15 14:26,864794,194561,477945,192288,864794
2023-04-15 14:27,864817,194580,477946,192291,864817
2023-04-15 14:28,864839,194598,477946,192295,864839
2023-04-15 14:29,864862,194608,477953,192301,864862
2023-04-15 14:30,864884,194629,477953,192302,864884
2023-04-15 14:31,864907,194645,477956,192306,864907
2023-04-15 14:32,864930,194665,477956,192309,864930
2023-04-15 14:33,864954,194676,477964,192314,864954
2023-04-15 14:34,864979,194698,477964,192317,864979
2023-04-15 14:35,865002,194714,477968,192320,865002
2023-04-15 14:36,865025,194726,477972,192327,865025
2023-04-15 14:37,865048,194734,477976,192338,865048
2023-04-15 14:38,865071,194755,477976,192340,865071
2023-04-15 14:39,865093,194767,477983,192343,865093
2023-04-15 14:40,865117,194789,477983,192345,865117
2023-04-15 14:41,865140,194803,477987,192350,865140
2023-04-15 14:42,865163,194825,477987,192351,865163
2023-04-15 14:43,865186,194840,477993,192353,865186
2023-04-15 14:44,865209,194861,477994,192354,865209
2023-04-15 14:45,865231,194870,478001,192360,865231
2023-04-15 14:46,865255,194888,478001,192366,865255
2023-04-15 14:47,865278,194907,478003,192368,865278
2023-04-15 14:48,865301,194927,478003,192371,865301
2023-04-15 14:49,865325,194940,478009,192376,865325
2023-04-15 14:50,865347,194960,478009,192378,865347
2023-04-15 14:51,865370,194967,478018,192385,865370
2023-04-15 14:52,865394,194986,478018,192390,865394
2023-04-15 14:53,865416,194998,478026,192392,865416
2023-04-15 14:54,865441,195020,478026,192395,865441
2023-04-15 14:55,865466,195033,478034,192399,865466
2023-04-15 14:56,865488,195050,478034,192404,865488
2023-04-15 14:57,865511,195062,478040,192409,865511
2023-04-15 14:58,865535,195081,478040,192414,865535
2023-04-15 14:59,865558,195089,478052,192417,865558
2023-04-15 15:00,865583,195113,478052,192418,865583
2023-04-15 15:01,865607,195127,478059,192421,865607
2023-04-15 15:02,865630,195138,478063,192429,865630
2023-04-15 15:03,865655,195158,478065,192432,865655
2023-04-15 15:04,865682,195181,478065,192436,865682
2023-04-15 15:05,865706,195196,478071,192439,865706
2023-04-15 15:06,865732,195216,478071,192445,865732
2023-04-15 15:07,865756,195230,478080,192446,865756
2023-04-15 15:09,865781,195253,478080,192448,865781
2023-04-15 15:10,865805,195268,478085,192452,865805
2023-04-15 15:11,865829,195288,478085,192456,865829
2023-04-15 15:12,865855,195300,478090,192465,865855
2023-04-15 15:13,865880,195321,478091,192468,865880
2023-04-15 15:14,865904,195339,478091,192474,865904
2023-04-15 15:15,865929,195350,478099,192480,865929
2023-04-15 15:16,865955,195373,478099,192483,865955
2023-04-15 15:17,865979,195384,478106,192489,865979
2023-04-15 15:18,866003,195406,478106,192491,866003
2023-04-15 15:19,866028,195427,478109,192492,866028
2023-04-15 15:20,866053,195450,478109,192494,866053
2023-04-15 15:21,866078,195469,478111,192498,866078
2023-04-15 15:22,866102,195480,478118,192504,866102
2023-04-15 15:23,866126,195505,478118,192503,866126
2023-04-15 15:24,866151,195517,478122,192512,866151
2023-04-15 15:25,866174,195535,478122,192517,866174
2023-04-15 15:26,866199,195546,478134,192519,866199
2023-04-15 15:27,866224,195571,478134,192519,866224
2023-04-15 15:28,866249,195587,478142,192520,866249
2023-04-15 15:29,866274,195610,478142,192522,866274
2023-04-15 15:30,866297,195621,478149,192527,866297
2023-04-15 15:31,866322,195634,478155,192533,866322
2023-04-15 15:32,866348,195655,478155,192538,866348
2023-04-15 15:33,866373,195672,478158,192543,866373
2023-04-15 15:34,866399,195692,478158,192549,866399
2023-04-15 15:35,866423,195705,478165,192553,866423
2023-04-15 15:36,866448,195730,478165,192553,866448
2023-04-15 15:37,866472,195742,478174,192556,866472
2023-04-15 15:38,866496,195764,478174,192558,866496
2023-04-15 15:39,866522,195780,478180,192562,866522
2023-04-15 15:40,866546,195798,478183,192565,866546
2023-04-15 15:41,866571,195816,478183,192572,866571
2023-04-15 15:42,866595,195829,478189,192577,866595
2023-04-15 15:43,866620,195850,478189,192581,866620
2023-04-15 15:44,866645,195864,478199,192582,866645
2023-04-15 15:45,866670,195881,478199,192590,866670
2023-04-15 15:46,866695,195885,478212,192598,866695
2023-04-15 15:47,866720,195907,478212,192601,866720
2023-04-15 15:48,866745,195920,478218,192607,866745
2023-04-15 15:49,866770,195939,478220,192611,866770
2023-04-15 15:50,866793,195947,478224,192622,866793
2023-04-15 15:51,866818,195965,478228,192625,866818
2023-04-15 15:52,866843,195984,478228,192631,866843
2023-04-15 15:53,866867,196003,478232,192632,866867
2023-04-15 15:54,866892,196027,478232,192633,866892
2023-04-15 15:55,866918,196044,478238,192636,866918
2023-04-15 15:57,866944,196064,478238,192642,866944
2023-04-15 15:58,866968,196072,478250,192646,866968
2023-04-15 15:59,866993,196093,478250,192650,866993
2023-04-15 16:00,867020,196111,478254,192655,867020
2023-04-15 16:01,867040,196125,478254,192661,867040
2023-04-15 16:02,867058,196130,478262,192666,867058
2023-04-15 16:03,867077,196144,478262,192671,867077
2023-04-15 16:04,867095,196157,478266,192672,867095
2023-04-15 16:05,867116,196172,478266,192678,867116
2023-04-15 16:06,867134,196179,478273,192682,867134
2023-04-15 16:07,867155,196200,478273,192682,867155
2023-04-15 16:08,867175,196210,478281,192684,867175
2023-04-15 16:09,867196,196223,478281,192692,867196
2023-04-15 16:10,867214,196235,478284,192695,867214
2023-04-15 16:11,867235,196255,478284,192696,867235
2023-04-15 16:12,867256,196262,478292,192702,867256
2023-04-15 16:13,867275,196277,478292,192706,867275
2023-04-15 16:14,867295,196288,478296,192711,867295
2023-04-15 16:15,867315,196305,478296,192714,867315
2023-04-15 16:16,867334,196313,478303,192718,867334
2023-04-15 16:17,867355,196327,478305,192723,867355
2023-04-15 16:18,867374,196342,478305,192727,867374
2023-04-15 16:19,867393,196354,478305,192734,867393
2023-04-15 16:20,867412,196369,478305,192738,867412
2023-04-15 16:21,867431,196383,478305,192743,867431
2023-04-15 16:22,867449,196396,478305,192748,867449
2023-04-15 16:23,867468,196413,478305,192750,867468
2023-04-15 16:24,867487,196429,478305,192753,867487
2023-04-15 16:25,867508,196448,478305,192755,867508
2023-04-15 16:26,867528,196464,478305,192759,867528
2023-04-15 16:27,867547,196444,478341,192762,867547
2023-04-15 16:28,867567,196464,478341,192762,867567
2023-04-15 16:29,867586,196467,478349,192770,867586
2023-04-15 16:30,867604,196482,478349,192773,867604
2023-04-15 16:31,867623,196491,478356,192776,867623
2023-04-15 16:32,867642,196505,478356,192781,867642
2023-04-15 16:33,867662,196515,478363,192784,867662
2023-04-15 16:34,867681,196532,478363,192786,867681
2023-04-15 16:35,867700,196541,478368,192791,867700
2023-04-15 16:36,867720,196557,478368,192795,867720
2023-04-15 16:37,867740,196567,478375,192798,867740
2023-04-15 16:38,867759,196581,478375,192803,867759
2023-04-15 16:39,867777,196585,478385,192807,867777
2023-04-15 16:40,867798,196602,478385,192811,867798
2023-04-15 16:41,867817,196616,478388,192813,867817
2023-04-15 16:42,867835,196626,478390,192819,867835
2023-04-15 16:43,867857,196646,478390,192821,867857
2023-04-15 16:45,867878,196658,478396,192824,867878
2023-04-15 16:46,867898,196669,478401,192828,867898
2023-04-15 16:47,867916,196680,478401,192835,867916
2023-04-15 16:48,867936,196688,478407,192841,867936
2023-04-15 16:49,867955,196701,478407,192847,867955
2023-04-15 16:50,867973,196706,478415,192852,867973
2023-04-15 16:51,867992,196720,478415,192857,867992
2023-04-15 16:52,868013,196729,478422,192862,868013
2023-04-15 16:53,868031,196744,478422,192865,868031
2023-04-15 16:54,868051,196753,478429,192869,868051
2023-04-15 16:55,868069,196765,478429,192875,868069
2023-04-15 16:56,868088,196773,478433,192882,868088
2023-04-15 16:57,868108,196784,478436,192888,868108
2023-04-15 16:58,868126,196789,478444,192893,868126
2023-04-15 16:59,868145,196806,478444,192895,868145
2023-04-15 17:00,868163,196815,478449,192899,868163
2023-04-15 17:01,868181,196824,478449,192908,868181
2023-04-15 17:02,868198,196824,478462,192912,868198
2023-04-15 17:03,868214,196836,478462,192916,868214
2023-04-15 17:04,868231,196843,478472,192916,868231
2023-04-15 17:05,868249,196857,478472,192920,868249
2023-04-15 17:06,868265,196861,478477,192927,868265
2023-04-15 17:07,868281,196873,478477,192931,868281
2023-04-15 17:08,868300,196877,478487,192936,868300
2023-04-15 17:09,868317,196892,478487,192938,868317
2023-04-15 17:10,868335,196894,478498,192943,868335
2023-04-15 17:11,868351,196908,478498,192945,868351
2023-04-15 17:12,868368,196908,478509,192951,868368
2023-04-15 17:13,868384,196915,478509,192960,868384
2023-04-15 17:14,868401,196921,478515,192965,868401
2023-04-15 17:15,868417,196933,478515,192969,868417
2023-04-15 17:16,868436,196941,478524,192971,868436
2023-04-15 17:17,868452,196951,478524,192977,868452
2023-04-15 17:18,868468,196962,478526,192980,868468
2023-04-15 17:19,868486,196972,478529,192985,868486
2023-04-15 17:20,868503,196984,478529,192990,868503
2023-04-15 17:21,868520,196987,478541,192992,868520
2023-04-15 17:22,868536,196998,478541,192997,868536
2023-04-15 17:23,868553,197006,478544,193003,868553
2023-04-15 17:24,868570,197017,478544,193009,868570
2023-04-15 17:25,868587,197021,478551,193015,868587
2023-04-15 17:26,868603,197033,478551,193019,868603
2023-04-15 17:27,868620,197043,478554,193023,868620
2023-04-15 17:28,868638,197057,478554,193027,868638
2023-04-15 17:29,868654,197067,478560,193027,868654
2023-04-15 17:30,868671,197081,478560,193030,868671
2023-04-15 17:32,868688,197087,478567,193034,868688
2023-04-15 17:33,868705,197100,478567,193038,868705
2023-04-15 17:34,868721,197114,478568,193039,868721
2023-04-15 17:35,868738,197127,478568,193043,868738
2023-04-15 17:36,868755,197136,478574,193045,868755
2023-04-15 17:37,868773,197139,478582,193052,868773
2023-04-15 17:38,868789,197152,478582,193055,868789
2023-04-15 17:39,868806,197160,478589,193057,868806
2023-04-15 17:40,868822,197169,478589,193064,868822
2023-04-15 17:41,868840,197175,478594,193071,868840
2023-04-15 17:42,868857,197188,478594,193075,868857
2023-04-15 17:43,868874,197191,478605,193078,868874
2023-04-15 17:44,868891,197204,478605,193082,868891
2023-04-15 17:45,868908,197212,478610,193086,868908
2023-04-15 17:46,868924,197223,478610,193091,868924
2023-04-15 17:47,868941,197230,478617,193094,868941
2023-04-15 17:48,868958,197242,478620,193096,868958
2023-04-15 17:49,868974,197255,478620,193099,868974
2023-04-15 17:50,868991,197263,478625,193103,868991
2023-04-15 17:51,869008,197275,478628,193105,869008
2023-04-15 17:52,869024,197277,478639,193108,869024
2023-04-15 17:53,869041,197290,478639,193112,869041
2023-04-15 17:54,869057,197294,478644,193119,869057
2023-04-15 17:55,869075,197305,478648,193122,869075
2023-04-15 17:56,869091,197317,478648,193126,869091
2023-04-15 17:57,869108,197324,478656,193128,869108
2023-04-15 17:58,869126,197337,478656,193133,869126
2023-04-15 17:59,869143,197349,478658,193136,869143
2023-04-15 18:00,869159,197357,478662,193140,869159
2023-04-15 18:01,869174,197363,478668,193143,869174
2023-04-15 18:02,869188,197367,478672,193149,869188
2023-04-15 18:03,869204,197376,478672,193156,869204
2023-04-15 18:04,869218,197371,478685,193162,869218
2023-04-15 18:05,869232,197380,478685,193167,869232
2023-04-15 18:06,869247,197376,478692,193179,869247
2023-04-15 18:07,869262,197388,478692,193182,869262
2023-04-15 18:08,869276,197389,478699,193188,869276
2023-04-15 18:09,869291,197390,478706,193195,869291
2023-04-15 18:10,869306,197398,478706,193202,869306
2023-04-15 18:11,869321,197397,478714,193210,869321
2023-04-15 18:12,869335,197406,478714,193215,869335
2023-04-15 18:13,869351,197413,478718,193220,869351
2023-04-15 18:14,869366,197423,478718,193225,869366
2023-04-15 18:15,869380,197424,478726,193230,869380
2023-04-15 18:16,869394,197436,478726,193232,869394
2023-04-15 18:17,869410,197444,478729,193237,869410
2023-04-15 18:19,869423,197450,478729,193244,869423
2023-04-15 18:20,869438,197458,478733,193247,869438
2023-04-15 18:21,869454,197470,478733,193251,869454
2023-04-15 18:22,869469,197478,478737,193254,869469
2023-04-15 18:23,869484,197484,478740,193260,869484
2023-04-15 18:24,869499,197494,478740,193265,869499
2023-04-15 18:25,869515,197492,478748,193275,869515
2023-04-15 18:26,869530,197504,478748,193278,869530
2023-04-15 18:27,869544,197507,478756,193281,869544
2023-04-15 18:28,869559,197520,478756,193283,869559
2023-04-15 18:29,869573,197521,478763,193289,869573
2023-04-15 18:30,869588,197530,478763,193295,869588
2023-04-15 18:31,869603,197534,478766,193303,869603
2023-04-15 18:32,869617,197544,478766,193307,869617
2023-04-15 18:33,869633,197558,478766,193309,869633
2023-04-15 18:34,869648,197572,478766,193310,869648
2023-04-15 18:35,869665,197574,478772,193319,869665
2023-04-15 18:36,869678,197578,478772,193328,869678
2023-04-15 18:37,869694,197580,478785,193329,869694
2023-04-15 18:38,869708,197585,478785,193338,869708
2023-04-15 18:39,869723,197587,478795,193341,869723
2023-04-15 18:40,869739,197601,478795,193343,869739
2023-04-15 18:41,869755,197604,478805,193346,869755
2023-04-15 18:42,869772,197616,478805,193351,869772
2023-04-15 18:43,869787,197620,478813,193354,869787
2023-04-15 18:44,869803,197629,478813,193361,869803
2023-04-15 18:45,869818,197630,478824,193364,869818
2023-04-15 18:46,869833,197643,478824,193366,869833
2023-04-15 18:47,869851,197642,478836,193373,869851
2023-04-15 18:48,869865,197654,478836,193375,869865
2023-04-15 18:49,869881,197660,478844,193377,869881
2023-04-15 18:50,869895,197664,478845,193386,869895
2023-04-15 18:51,869913,197674,478851,193388,869913
2023-04-15 18:52,869929,197686,478851,193392,869929
2023-04-15 18:53,869943,197692,478856,193395,869943
2023-04-15 18:54,869959,197690,478869,193400,869959
2023-04-15 18:55,869975,197701,478869,193405,869975
2023-04-15 18:56,869989,197702,478879,193408,869989
2023-04-15 18:57,870003,197710,478880,193413,870003
2023-04-15 18:58,870018,197720,478880,193418,870018
2023-04-15 18:59,870033,197722,478889,193422,870033
2023-04-15 19:00,870056,197740,478889,193427,870056
2023-04-15 19:01,870082,197758,478892,193432,870082
2023-04-15 19:02,870108,197780,478894,193434,870108
2023-04-15 19:03,870137,197802,478899,193436,870137
2023-04-15 19:04,870161,197820,478899,193442,870161
2023-04-15 19:06,870188,197830,478908,193450,870188
2023-04-15 19:07,870215,197849,478908,193458,870215
2023-04-15 19:08,870242,197862,478917,193463,870242
2023-04-15 19:09,870267,197885,478917,193465,870267
2023-04-15 19:10,870295,197900,478927,193468,870295
2023-04-15 19:11,870321,197918,478930,193473,870321
2023-04-15 19:12,870347,197939,478930,193478,870347
2023-04-15 19:13,870373,197958,478934,193481,870373
2023-04-15 19:14,870399,197972,478941,193486,870399
2023-04-15 19:15,870424,197985,478948,193491,870424
2023-04-15 19:16,870448,198005,478949,193494,870448
2023-04-15 19:17,870473,198027,478949,193497,870473
2023-04-15 19:18,870499,198035,478956,193508,870499
2023-04-15 19:19,870527,198058,478956,193513,870527
2023-04-15 19:20,870553,198076,478963,193514,870553
2023-04-15 19:21,870579,198088,478971,193520,870579
2023-04-15 19:22,870603,198092,478983,193528,870603
2023-04-15 19:23,870630,198111,478985,193534,870630
2023-04-15 19:24,870656,198124,478992,193540,870656
2023-04-15 19:25,870682,198146,478994,193542,870682
2023-04-15 19:26,870711,198171,478994,193546,870711
2023-04-15 19:27,870735,198176,479008,193551,870735
2023-04-15 19:28,870762,198202,479008,193552,870762
2023-04-15 19:29,870788,198224,479009,193555,870788
2023-04-15 19:30,870814,198246,479009,193559,870814
2023-04-15 19:31,870841,198264,479018,193559,870841
2023-04-15 19:32,870866,198281,479024,193561,870866
2023-04-15 19:33,870893,198303,479027,193563,870893
2023-04-15 19:34,870919,198326,479027,193566,870919
2023-04-15 19:35,870944,198339,479032,193573,870944
2023-04-15 19:36,870969,198361,479032,193576,870969
2023-04-15 19:37,870996,198380,479032,193584,870996
2023-04-15 19:38,871021,198396,479038,193587,871021
2023-04-15 19:39,871046,198411,479041,193594,871046
2023-04-15 19:40,871070,198428,479046,193596,871070
2023-04-15 19:41,871098,198451,479046,193601,871098
2023-04-15 19:42,871122,198459,479057,193606,871122
2023-04-15 19:43,871148,198474,479057,193617,871148
2023-04-15 19:44,871175,198489,479061,193625,871175
2023-04-15 19:45,871202,198511,479062,193629,871202
2023-04-15 19:46,871227,198534,479062,193631,871227
2023-04-15 19:47,871252,198546,479069,193637,871252
2023-04-15 19:48,871278,198570,479069,193639,871278
2023-04-15 19:49,871305,198584,479079,193642,871305
2023-04-15 19:50,871329,198598,479083,193648,871329
2023-04-15 19:51,871354,198618,479083,193653,871354
2023-04-15 19:53,871379,198631,479090,193658,871379
2023-04-15 19:54,871404,198646,479094,193664,871404
2023-04-15 19:55,871429,198661,479100,193668,871429
2023-04-15 19:56,871455,198685,479100,193670,871455
2023-04-15 19:57,871481,198697,479107,193677,871481
2023-04-15 19:58,871505,198718,479107,193680,871505
2023-04-15 19:59,871532,198734,479115,193683,871532
2023-04-15 20:00,871558,198753,479117,193688,871558
2023-04-15 20:01,871590,198780,479117,193693,871590
2023-04-15 20:02,871622,198810,479118,193694,871622
2023-04-15 20:03,871654,198838,479118,193698,871654
2023-04-15 20:04,871683,198855,479128,193700,871683
2023-04-15 20:05,871716,198885,479128,193703,871716
2023-04-15 20:06,871747,198912,479131,193704,871747
2023-04-15 20:07,871776,198940,479131,193705,871776
2023-04-15 20:08,871806,198955,479139,193712,871806
2023-04-15 20:09,871839,198982,479139,193718,871839
2023-04-15 20:10,871871,199004,479144,193723,871871
2023-04-15 20:11,871901,199032,479144,193725,871901
2023-04-15 20:12,871933,199047,479155,193731,871933
2023-04-15 20:13,871962,199074,479155,193733,871962
2023-04-15 20:14,871994,199100,479161,193733,871994
2023-04-15 20:15,872024,199125,479163,193736,872024
2023-04-15 20:16,872056,199152,479163,193741,872056
2023-04-15 20:17,872087,199173,479168,193746,872087
2023-04-15 20:18,872118,199197,479172,193749,872118
2023-04-15 20:19,872149,199223,479174,193752,872149
2023-04-15 20:20,872181,199250,479176,193755,872181
2023-04-15 20:21,872212,199272,479176,193764,872212
2023-04-15 20:22,872243,199295,479179,193769,872243
2023-04-15 20:23,872273,199323,479179,193771,872273
2023-04-15 20:24,872305,199345,479182,193778,872305
2023-04-15 20:25,872334,199372,479182,193780,872334
2023-04-15 20:26,872365,199388,479187,193790,872365
2023-04-15 20:27,872395,199415,479187,193793,872395
2023-04-15 20:28,872428,199442,479193,193793,872428
2023-04-15 20:29,872459,199469,479196,193794,872459
2023-04-15 20:30,872491,199496,479198,193797,872491
2023-04-15 20:31,872521,199523,479198,193800,872521
2023-04-15 20:32,872551,199545,479204,193802,872551
2023-04-15 20:33,872582,199573,479204,193805,872582
2023-04-15 20:34,872613,199597,479211,193805,872613
2023-04-15 20:35,872643,199622,479211,193810,872643
2023-04-15 20:36,872674,199647,479214,193813,872674
2023-04-15 20:37,872706,199673,479214,193819,872706
2023-04-15 20:38,872735,199691,479221,193823,872735
2023-04-15 20:39,872767,199719,479221,193827,872767
2023-04-15 20:41,872800,199741,479226,193833,872800
2023-04-15 20:42,872831,199770,479226,193835,872831
2023-04-15 20:43,872861,199784,479235,193842,872861
2023-04-15 20:44,872892,199811,479236,193845,872892
2023-04-15 20:45,872924,199832,479243,193849,872924
2023-04-15 20:46,872955,199862,479243,193850,872955
2023-04-15 20:47,872985,199884,479243,193858,872985
2023-04-15 20:48,873015,199901,479251,193863,873015
2023-04-15 20:49,873047,199928,479254,193865,873047
2023-04-15 20:50,873080,199960,479254,193866,873080
2023-04-15 20:51,873112,199983,479261,193868,873112
2023-04-15 20:52,873141,200010,479261,193870,873141
2023-04-15 20:53,873173,200032,479267,193874,873173
2023-04-15 20:54,873204,200058,479267,193879,873204
2023-04-15 20:55,873237,200086,479272,193879,873237
2023-04-15 20:56,873266,200108,479272,193886,873266
2023-04-15 20:57,873298,200136,479275,193887,873298
2023-04-15 20:58,873331,200166,479275,193890,873331
2023-04-15 20:59,873362,200184,479282,193896,873362
2023-04-15 21:00,873389,200206,479282,193901,873389
2023-04-15 21:01,873410,200213,479290,193907,873410
2023-04-15 21:02,873430,200226,479290,193914,873430
2023-04-15 21:03,873450,200231,479296,193923,873450
2023-04-15 21:04,873472,200246,479296,193930,873472
2023-04-15 21:05,873490,200254,479302,193934,873490
2023-04-15 21:06,873512,200271,479302,193939,873512
2023-04-15 21:07,873532,200281,479308,193943,873532
2023-04-15 21:08,873553,200292,479316,193945,873553
2023-04-15 21:09,873573,200306,479318,193949,873573
2023-04-15 21:10,873594,200324,479318,193952,873594
2023-04-15 21:11,873614,200335,479323,193956,873614
2023-04-15 21:12,873633,200347,479323,193963,873633
2023-04-15 21:13,873654,200353,479331,193970,873654
2023-04-15 21:14,873676,200371,479331,193974,873676
2023-04-15 21:15,873695,200379,479340,193976,873695
2023-04-15 21:16,873716,200397,479340,193979,873716
2023-04-15 21:17,873735,200408,479346,193981,873735
2023-04-15 21:18,873755,200419,479347,193989,873755
2023-04-15 21:19,873777,200435,479347,193995,873777
2023-04-15 21:20,873801,200440,479359,194002,873801
2023-04-15 21:21,873820,200452,479364,194004,873820
2023-04-15 21:22,873840,200469,479364,194007,873840
2023-04-15 21:23,873860,200479,479370,194011,873860
2023-04-15 21:24,873883,200500,479370,194013,873883
2023-04-15 21:25,873904,200508,479379,194017,873904
2023-04-15 21:27,873924,200524,479379,194021,873924
2023-04-15 21:28,873944,200529,479385,194030,873944
2023-04-15 21:29,873963,200546,479385,194032,873963
2023-04-15 21:30,873984,200554,479393,194037,873984
2023-04-15 21:31,874005,200570,479393,194042,874005
2023-04-15 21:32,874025,200579,479400,194046,874025
2023-04-15 21:33,874046,200593,479400,194053,874046
2023-04-15 21:34,874066,200610,479402,194054,874066
2023-04-15 21:35,874087,200628,479402,194057,874087
2023-04-15 21:36,874109,200639,479407,194063,874109
2023-04-15 21:37,874129,200659,479407,194063,874129
2023-04-15 21:38,874152,200669,479414,194069,874152
2023-04-15 21:39,874173,200684,479417,194072,874173
2023-04-15 21:40,874198,200703,479417,194078,874198
2023-04-15 21:41,874218,200711,479424,194083,874218
2023-04-15 21:42,874243,200730,479424,194089,874243
2023-04-15 21:43,874264,200747,479427,194090,874264
2023-04-15 21:44,874287,200758,479430,194099,874287
2023-04-15 21:45,874308,200770,479430,194108,874308
2023-04-15 21:46,874329,200782,479437,194110,874329
2023-04-15 21:47,874350,200797,479437,194116,874350
2023-04-15 21:48,874368,200803,479445,194120,874368
2023-04-15 21:49,874389,200821,479447,194121,874389
2023-04-15 21:50,874410,200837,479447,194126,874410
2023-04-15 21:51,874430,200853,479449,194128,874430
2023-04-15 21:52,874450,200869,479449,194132,874450
2023-04-15 21:53,874471,200875,479457,194139,874471
2023-04-15 21:54,874491,200894,479457,194140,874491
2023-04-15 21:55,874512,200909,479459,194144,874512
2023-04-15 21:56,874532,200925,479459,194148,874532
2023-04-15 21:57,874553,200931,479467,194155,874553
2023-04-15 21:58,874571,200943,479467,194161,874571
2023-04-15 21:59,874592,200952,479475,194165,874592
2023-04-15 22:00,874605,200962,479475,194168,874605
2023-04-15 22:01,874613,200958,479484,194171,874613
2023-04-15 22:02,874621,200963,479485,194173,874621
2023-04-15 22:03,874629,200966,479488,194175,874629
2023-04-15 22:04,874636,200967,479493,194176,874636
2023-04-15 22:05,874643,200958,479501,194184,874643
2023-04-15 22:06,874651,200955,479506,194190,874651
2023-04-15 22:07,874661,200961,479506,194194,874661
2023-04-15 22:08,874668,200958,479514,194196,874668
2023-04-15 22:09,874675,200961,479517,194197,874675
2023-04-15 22:10,874683,200956,479525,194202,874683
2023-04-15 22:11,874691,200960,479525,194206,874691
2023-04-15 22:13,874699,200952,479533,194214,874699
2023-04-15 22:14,874706,200953,479536,194217,874706
2023-04-15 22:15,874714,200956,479536,194222,874714
2023-04-15 22:16,874722,200956,479541,194225,874722
2023-04-15 22:17,874732,200952,479548,194232,874732
2023-04-15 22:18,874740,200960,479548,194232,874740
2023-04-15 22:19,874747,200953,479555,194239,874747
2023-04-15 22:20,874756,200954,479555,194247,874756
2023-04-15 22:21,874767,200955,479561,194251,874767
2023-04-15 22:22,874774,200961,479561,194252,874774
2023-04-15 22:23,874781,200955,479571,194255,874781
2023-04-15 22:24,874789,200958,479571,194260,874789
2023-04-15 22:25,874798,200957,479577,194264,874798
2023-04-15 22:26,874806,200961,479578,194267,874806
2023-04-15 22:27,874814,200958,479584,194272,874814
2023-04-15 22:28,874824,200962,479584,194278,874824
2023-04-15 22:29,874833,200964,479588,194281,874833
2023-04-15 22:30,874842,200969,479588,194285,874842
2023-04-15 22:31,874850,200965,479596,194289,874850
2023-04-15 22:32,874860,200966,479601,194293,874860
2023-04-15 22:33,874867,200968,479603,194296,874867
2023-04-15 22:34,874878,200977,479603,194298,874878
2023-04-15 22:35,874887,200971,479612,194304,874887
2023-04-15 22:36,874895,200973,479612,194310,874895
2023-04-15 22:37,874903,200972,479618,194313,874903
2023-04-15 22:38,874911,200976,479618,194317,874911
2023-04-15 22:39,874918,200974,479623,194321,874918
2023-04-15 22:40,874927,200976,479623,194328,874927
2023-04-15 22:41,874934,200965,479633,194336,874934
2023-04-15 22:42,874943,200971,479633,194339,874943
2023-04-15 22:43,874950,200967,479642,194341,874950
2023-04-15 22:44,874959,200972,479642,194345,874959
2023-04-15 22:45,874967,200966,479652,194349,874967
2023-04-15 22:46,874974,200971,479652,194351,874974
2023-04-15 22:47,874982,200965,479661,194356,874982
2023-04-15 22:48,874991,200966,479663,194362,874991
2023-04-15 22:49,875000,200967,479666,194367,875000
2023-04-15 22:50,875007,200965,479669,194373,875007
2023-04-15 22:51,875016,200971,479669,194376,875016
2023-04-15 22:52,875023,200965,479677,194381,875023
2023-04-15 22:53,875031,200966,479679,194386,875031
2023-04-15 22:54,875038,200961,479679,194398,875038
2023-04-15 22:55,875045,200954,479688,194403,875045
2023-04-15 22:56,875053,200954,479688,194411,875053
2023-04-15 22:57,875060,200958,479688,194414,875060
2023-04-15 22:58,875068,200962,479688,194418,875068
2023-04-15 23:00,875075,200953,479696,194426,875075
2023-04-15 23:01,875094,200969,479696,194429,875094
2023-04-15 23:02,875117,200986,479701,194430,875117
2023-04-15 23:03,875136,201000,479701,194435,875136
2023-04-15 23:04,875154,201007,479709,194438,875154
2023-04-15 23:05,875173,201022,479711,194440,875173
2023-04-15 23:06,875193,201036,479711,194446,875193
2023-04-15 23:07,875211,201047,479717,194447,875211
2023-04-15 23:08,875231,201066,479717,194448,875231
2023-04-15 23:09,875249,201071,479725,194453,875249
2023-04-15 23:10,875269,201089,479725,194455,875269
2023-04-15 23:11,875287,201098,479728,194461,875287
2023-04-15 23:12,875308,201112,479729,194467,875308
2023-04-15 23:13,875328,201125,479729,194474,875328
2023-04-15 23:14,875346,201135,479735,194476,875346
2023-04-15 23:15,875366,201150,479735,194481,875366
2023-04-15 23:16,875384,201157,479741,194486,875384
2023-04-15 23:17,875402,201171,479743,194488,875402
2023-04-15 23:18,875423,201181,479749,194493,875423
2023-04-15 23:19,875443,201195,479749,194499,875443
2023-04-15 23:20,875464,201204,479757,194503,875464
2023-04-15 23:21,875484,201219,479757,194508,875484
2023-04-15 23:22,875503,201229,479762,194512,875503
2023-04-15 23:23,875522,201243,479762,194517,875522
2023-04-15 23:24,875541,201252,479769,194520,875541
2023-04-15 23:25,875560,201266,479769,194525,875560
2023-04-15 23:26,875580,201273,479776,194531,875580
2023-04-15 23:27,875599,201286,479776,194537,875599
2023-04-15 23:28,875617,201297,479779,194541,875617
2023-04-15 23:29,875636,201311,479779,194546,875636
2023-04-15 23:30,875654,201323,479784,194547,875654
2023-04-15 23:31,875674,201336,479784,194554,875674
2023-04-15 23:32,875692,201344,479788,194560,875692
2023-04-15 23:33,875712,201356,479793,194563,875712
2023-04-15 23:34,875731,201373,479793,194565,875731
2023-04-15 23:35,875751,201386,479798,194567,875751
2023-04-15 23:36,875770,201403,479798,194569,875770
2023-04-15 23:37,875788,201407,479807,194574,875788
2023-04-15 23:38,875808,201424,479807,194577,875808
2023-04-15 23:39,875831,201435,479813,194583,875831
2023-04-15 23:40,875849,201453,479813,194583,875849
2023-04-15 23:41,875867,201462,479817,194588,875867
2023-04-15 23:42,875886,201477,479817,194592,875886
2023-04-15 23:43,875905,201491,479820,194594,875905
2023-04-15 23:44,875925,201509,479820,194596,875925
2023-04-15 23:45,875944,201517,479828,194599,875944
2023-04-15 23:46,875963,201531,479828,194604,875963
2023-04-15 23:48,875985,201543,479833,194609,875985
2023-04-15 23:49,876006,201560,479833,194613,876006
2023-04-15 23:50,876024,201567,479840,194617,876024
2023-04-15 23:51,876044,201581,479840,194623,876044
2023-04-15 23:52,876064,201593,479847,194624,876064
2023-04-15 23:53,876083,201606,479847,194630,876083
2023-04-15 23:54,876102,201619,479850,194633,876102
2023-04-15 23:55,876120,201634,479850,194636,876120
2023-04-15 23:56,876140,201652,479852,194636,876140
2023-04-15 23:57,876160,201669,479852,194639,876160
2023-04-15 23:58,876179,201677,479860,194642,876179
2023-04-15 23:59,876198,201693,479862,194643,876198
2023-04-16 00:00,876219,201707,479862,194650,876219
2023-04-16 00:01,876240,201722,479868,194650,876240
2023-04-16 00:02,876258,201736,479868,194654,876258
2023-04-16 00:03,876277,201744,479876,194657,876277
2023-04-16 00:04,876299,201759,479876,194664,876299
2023-04-16 00:05,876318,201769,479881,194668,876318
2023-04-16 00:06,876338,201785,479884,194669,876338
2023-04-16 00:07,876357,201801,479884,194672,876357
2023-04-16 00:08,876378,201812,479889,194677,876378
2023-04-16 00:09,876397,201827,479891,194679,876397
2023-04-16 00:10,876417,201838,479896,194683,876417
2023-04-16 00:11,876436,201855,479896,194685,876436
2023-04-16 00:12,876456,201865,479904,194687,876456
2023-04-16 00:13,876475,201877,479904,194694,876475
2023-04-16 00:14,876494,201888,479909,194697,876494
2023-04-16 00:15,876514,201904,479909,194701,876514
2023-04-16 00:16,876533,201915,479913,194705,876533
2023-04-16 00:17,876553,201929,479913,194711,876553
2023-04-16 00:18,876571,201941,479917,194713,876571
2023-04-16 00:19,876591,201953,479920,194718,876591
2023-04-16 00:20,876611,201967,479920,194724,876611
2023-04-16 00:21,876631,201974,479928,194729,876631
2023-04-16 00:22,876650,201991,479928,194731,876650
2023-04-16 00:23,876670,201997,479936,194737,876670
2023-04-16 00:24,876691,202012,479936,194743,876691
2023-04-16 00:25,876711,202029,479938,194744,876711
2023-04-16 00:26,876730,202044,479938,194748,876730
2023-04-16 00:27,876751,202055,479942,194754,876751
2023-04-16 00:28,876770,202074,479942,194754,876770
2023-04-16 00:29,876790,202091,479943,194756,876790
2023-04-16 00:30,876809,202105,479943,194761,876809
2023-04-16 00:31,876830,202121,479945,194764,876830
2023-04-16 00:32,876851,202137,479949,194765,876851
2023-04-16 00:33,876872,202152,479949,194771,876872
2023-04-16 00:35,876891,202161,479953,194777,876891
2023-04-16 00:36,876909,202174,479953,194782,876909
2023-04-16 00:37,876930,202187,479958,194785,876930
2023-04-16 00:38,876949,202205,479958,194786,876949
2023-04-16 00:39,876970,202221,479962,194787,876970
2023-04-16 00:40,876989,202232,479962,194795,876989
2023-04-16 00:41,877009,202244,479966,194799,877009
2023-04-16 00:42,877028,202259,479966,194803,877028
2023-04-16 00:43,877049,202269,479972,194808,877049
2023-04-16 00:44,877067,202280,479972,194815,877067
2023-04-16 00:45,877087,202294,479975,194818,877087
2023-04-16 00:46,877107,202312,479975,194820,877107
2023-04-16 00:47,877126,202328,479976,194822,877126
2023-04-16 00:48,877146,202345,479976,194825,877146
2023-04-16 00:49,877165,202358,479979,194828,877165
2023-04-16 00:50,877185,202377,479979,194829,877185
2023-04-16 00:51,877204,202388,479982,194834,877204
2023-04-16 00:52,877226,202409,479982,194835,877226
2023-04-16 00:53,877244,202421,479985,194838,877244
2023-04-16 00:54,877264,202438,479985,194841,877264
2023-04-16 00:55,877285,202454,479987,194844,877285
2023-04-16 00:56,877304,202469,479990,194845,877304
2023-04-16 00:57,877323,202485,479990,194848,877323
2023-04-16 00:58,877343,202499,479993,194851,877343
2023-04-16 00:59,877363,202520,479993,194850,877363
2023-04-16 01:00,877384,202539,479993,194852,877384
2023-04-16 01:01,877407,202557,479993,194857,877407
2023-04-16 01:02,877430,202570,479999,194861,877430
2023-04-16 01:03,877454,202590,479999,194865,877454
2023-04-16 01:04,877477,202599,480007,194871,877477
2023-04-16 01:05,877502,202622,480007,194873,877502
2023-04-16 01:06,877525,202638,480011,194876,877525
2023-04-16 01:07,877547,202657,480011,194879,877547
2023-04-16 01:08,877570,202676,480012,194882,877570
2023-04-16 01:09,877594,202695,480012,194887,877594
2023-04-16 01:10,877616,202714,480015,194887,877616
2023-04-16 01:11,877638,202731,480015,194892,877638
2023-04-16 01:12,877662,202746,480022,194894,877662
2023-04-16 01:13,877685,202768,480022,194895,877685
2023-04-16 01:14,877707,202785,480025,194897,877707
2023-04-16 01:15,877730,202807,480025,194898,877730
2023-04-16 01:16,877752,202826,480028,194898,877752
2023-04-16 01:17,877776,202843,480032,194901,877776
2023-04-16 01:18,877798,202862,480032,194904,877798
2023-04-16 01:19,877822,202876,480037,194909,877822
2023-04-16 01:20,877844,202894,480037,194913,877844
2023-04-16 01:22,877867,202916,480038,194913,877867
2023-04-16 01:23,877889,202930,480038,194921,877889
2023-04-16 01:24,877913,202944,480044,194925,877913
2023-04-16 01:25,877937,202963,480044,194930,877937
2023-04-16 01:26,877960,202977,480049,194934,877960
2023-04-16 01:27,877984,202998,480049,194937,877984
2023-04-16 01:28,878007,203018,480050,194939,878007
2023-04-16 01:29,878029,203038,480050,194941,878029
2023-04-16 01:30,878051,203057,480052,194942,878051
2023-04-16 01:31,878074,203077,480052,194945,878074
2023-04-16 01:32,878097,203093,480056,194948,878097
2023-04-16 01:33,878121,203115,480056,194950,878121
2023-04-16 01:34,878143,203133,480058,194952,878143
2023-04-16 01:35,878166,203156,480058,194952,878166
2023-04-16 01:36,878188,203176,480058,194954,878188
2023-04-16 01:37,878212,203199,480058,194955,878212
2023-04-16 01:38,878235,203217,480062,194956,878235
2023-04-16 01:39,878259,203239,480062,194958,878259
2023-04-16 01:40,878283,203257,480065,194961,878283
2023-04-16 01:41,878306,203279,480065,194962,878306
2023-04-16 01:42,878330,203297,480070,194963,878330
2023-04-16 01:43,878352,203316,480070,194966,878352
2023-04-16 01:44,878376,203333,480075,194968,878376
2023-04-16 01:45,878398,203351,480078,194969,878398
2023-04-16 01:46,878421,203369,480078,194974,878421
2023-04-16 01:47,878446,203391,480079,194976,878446
2023-04-16 01:48,878469,203412,480079,194978,878469
2023-04-16 01:49,878492,203430,480082,194980,878492
2023-04-16 01:50,878514,203451,480082,194981,878514
2023-04-16 01:51,878536,203465,480086,194985,878536
2023-04-16 01:52,878561,203488,480088,194985,878561
2023-04-16 01:53,878584,203510,480088,194986,878584
2023-04-16 01:54,878607,203527,480091,194989,878607
2023-04-16 01:55,878630,203549,480091,194990,878630
2023-04-16 01:56,878655,203571,480092,194992,878655
2023-04-16 01:57,878678,203594,480092,194992,878678
2023-04-16 01:58,878700,203613,480094,194993,878700
2023-04-16 01:59,878723,203635,480094,194994,878723
2023-04-16 02:00,878738,203640,480100,194998,878738
2023-04-16 02:01,878747,203648,480100,194999,878747
2023-04-16 02:02,878758,203656,480102,195000,878758
2023-04-16 02:03,878769,203666,480102,195001,878769
2023-04-16 02:04,878780,203674,480105,195001,878780
2023-04-16 02:05,878791,203683,480105,195003,878791
2023-04-16 02:06,878801,203690,480106,195005,878801
2023-04-16 02:07,878814,203703,480106,195005,878814
2023-04-16 02:09,878824,203706,480108,195010,878824
2023-04-16 02:10,878834,203715,480108,195011,878834
2023-04-16 02:11,878845,203720,480112,195013,878845
2023-04-16 02:12,878856,203726,480112,195018,878856
2023-04-16 02:13,878866,203730,480115,195021,878866
2023-04-16 02:14,878877,203740,480115,195022,878877
2023-04-16 02:15,878887,203740,480121,195026,878887
2023-04-16 02:16,878897,203749,480121,195027,878897
2023-04-16 02:17,878908,203755,480126,195027,878908
2023-04-16 02:18,878919,203762,480126,195031,878919
2023-04-16 02:19,878929,203763,480129,195037,878929
2023-04-16 02:20,878941,203772,480129,195040,878941
2023-04-16 02:21,878951,203777,480133,195041,878951
2023-04-16 02:22,878961,203786,480133,195042,878961
2023-04-16 02:23,878972,203794,480134,195044,878972
2023-04-16 02:24,878983,203802,480134,195047,878983
2023-04-16 02:25,878993,203808,480135,195050,878993
2023-04-16 02:26,879004,203815,480135,195054,879004
2023-04-16 02:27,879015,203820,480140,195055,879015
2023-04-16 02:28,879026,203830,480140,195056,879026
2023-04-16 02:29,879036,203836,480142,195058,879036
2023-04-16 02:30,879046,203845,480142,195059,879046
2023-04-16 02:31,879058,203851,480147,195060,879058
2023-04-16 02:32,879068,203857,480147,195064,879068
2023-04-16 02:33,879079,203863,480149,195067,879079
2023-04-16 02:34,879089,203872,480149,195068,879089
2023-04-16 02:35,879100,203880,480150,195070,879100
2023-04-16 02:36,879111,203889,480150,195072,879111
2023-04-16 02:37,879121,203892,480154,195075,879121
2023-04-16 02:38,879132,203902,480154,195076,879132
2023-04-16 02:39,879143,203910,480155,195078,879143
2023-04-16 02:40,879154,203919,480155,195080,879154
2023-04-16 02:41,879164,203927,480157,195080,879164
2023-04-16 02:42,879174,203936,480157,195081,879174
2023-04-16 02:43,879185,203942,480158,195085,879185
2023-04-16 02:44,879195,203952,480158,195085,879195
2023-04-16 02:45,879205,203960,480158,195087,879205
2023-04-16 02:46,879218,203972,480158,195088,879218
2023-04-16 02:47,879228,203977,480163,195088,879228
2023-04-16 02:48,879238,203985,480163,195090,879238
2023-04-16 02:49,879249,203992,480167,195090,879249
2023-04-16 02:50,879259,203998,480167,195094,879259
2023-04-16 02:51,879270,204006,480168,195096,879270
2023-04-16 02:52,879280,204015,480168,195097,879280
2023-04-16 02:53,879291,204022,480172,195097,879291
2023-04-16 02:54,879302,204032,480172,195098,879302
2023-04-16 02:56,879313,204035,480178,195100,879313
2023-04-16 02:57,879323,204043,480178,195102,879323
2023-04-16 02:58,879333,204049,480181,195103,879333
2023-04-16 02:59,879344,204058,480181,195105,879344
2023-04-16 03:00,879355,204067,480182,195106,879355
2023-04-16 03:01,879382,204094,480182,195106,879382
2023-04-16 03:02,879410,204120,480183,195107,879410
2023-04-16 03:03,879437,204147,480183,195107,879437
2023-04-16 03:04,879465,204173,480185,195107,879465
2023-04-16 03:05,879491,204199,480185,195107,879491
2023-04-16 03:06,879519,204225,480186,195108,879519
2023-04-16 03:07,879547,204252,480186,195109,879547
2023-04-16 03:08,879574,204276,480188,195110,879574
2023-04-16 03:09,879603,204305,480188,195110,879603
2023-04-16 03:10,879630,204328,480190,195112,879630
2023-04-16 03:11,879657,204355,480190,195112,879657
2023-04-16 03:12,879684,204381,480192,195111,879684
2023-04-16 03:13,879710,204405,480192,195113,879710
2023-04-16 03:14,879739,204432,480193,195114,879739
2023-04-16 03:15,879768,204460,480193,195115,879768
2023-04-16 03:16,879793,204484,480194,195115,879793
2023-04-16 03:17,879821,204511,480194,195116,879821
2023-04-16 03:18,879849,204536,480197,195116,879849
2023-04-16 03:19,879876,204563,480197,195116,879876
2023-04-16 03:20,879905,204589,480198,195118,879905
2023-04-16 03:21,879931,204612,480198,195121,879931
2023-04-16 03:22,879959,204640,480198,195121,879959
2023-04-16 03:23,879986,204665,480198,195123,879986
2023-04-16 03:24,880013,204692,480198,195123,880013
2023-04-16 03:25,880040,204719,480198,195123,880040
2023-04-16 03:26,880068,204744,480200,195124,880068
2023-04-16 03:27,880095,204771,480200,195124,880095
2023-04-16 03:28,880124,204800,480200,195124,880124
2023-04-16 03:29,880152,204827,480200,195125,880152
2023-04-16 03:30,880179,204853,480200,195126,880179
2023-04-16 03:31,880205,204879,480200,195126,880205
2023-04-16 03:32,880232,204904,480202,195126,880232
2023-04-16 03:33,880260,204931,480202,195127,880260
2023-04-16 03:34,880289,204957,480203,195129,880289
2023-04-16 03:35,880316,204981,480203,195132,880316
2023-04-16 03:36,880345,205006,480205,195134,880345
2023-04-16 03:37,880372,205033,480205,195134,880372
2023-04-16 03:38,880399,205058,480207,195134,880399
2023-04-16 03:39,880425,205082,480207,195136,880425
2023-04-16 03:40,880452,205105,480211,195136,880452
2023-04-16 03:41,880481,205134,480211,195136,880481
2023-04-16 03:43,880509,205161,480212,195136,880509
2023-04-16 03:44,880535,205186,480212,195137,880535
2023-04-16 03:45,880562,205208,480217,195137,880562
2023-04-16 03:46,880590,205236,480217,195137,880590
2023-04-16 03:47,880618,205263,480217,195138,880618
2023-04-16 03:48,880646,205291,480217,195138,880646
2023-04-16 03:49,880673,205315,480220,195138,880673
2023-04-16 03:50,880701,205342,480220,195139,880701
2023-04-16 03:51,880728,205365,480223,195140,880728
2023-04-16 03:52,880755,205391,480223,195141,880755
2023-04-16 03:53,880782,205417,480224,195141,880782
2023-04-16 03:54,880809,205443,480224,195142,880809
2023-04-16 03:55,880837,205469,480224,195144,880837
2023-04-16 03:56,880864,205495,480224,195145,880864
2023-04-16 03:57,880892,205518,480226,195148,880892
2023-04-16 03:58,880919,205544,480226,195149,880919
2023-04-16 03:59,880946,205569,480228,195149,880946
2023-04-16 04:00,880971,205594,480228,195149,880971
2023-04-16 04:01,880994,205617,480228,195149,880994
2023-04-16 04:02,881014,205637,480228,195149,881014
2023-04-16 04:03,881036,205657,480229,195150,881036
2023-04-16 04:04,881058,205677,480229,195152,881058
2023-04-16 04:05,881078,205696,480230,195152,881078
2023-04-16 04:06,881100,205718,480230,195152,881100
2023-04-16 04:07,881121,205737,480232,195152,881121
2023-04-16 04:08,881142,205756,480234,195152,881142
2023-04-16 04:09,881165,205779,480234,195152,881165
2023-04-16 04:10,881187,205801,480234,195152,881187
2023-04-16 04:11,881208,205820,480234,195154,881208
2023-04-16 04:12,881228,205839,480234,195155,881228
2023-04-16 04:13,881251,205861,480234,195156,881251
2023-04-16 04:14,881272,205881,480235,195156,881272
2023-04-16 04:15,881293,205902,480235,195156,881293
2023-04-16 04:16,881314,205922,480236,195156,881314
2023-04-16 04:17,881336,205943,480236,195157,881336
2023-04-16 04:18,881357,205963,480237,195157,881357
2023-04-16 04:19,881379,205985,480237,195157,881379
2023-04-16 04:20,881400,206004,480238,195158,881400
2023-04-16 04:21,881422,206026,480238,195158,881422
2023-04-16 04:22,881443,206046,480238,195159,881443
2023-04-16 04:23,881465,206068,480238,195159,881465
2023-04-16 04:24,881486,206088,480239,195159,881486
2023-04-16 04:25,881508,206110,480239,195159,881508
2023-04-16 04:26,881528,206128,480240,195160,881528
2023-04-16 04:27,881549,206148,480240,195161,881549
2023-04-16 04:28,881572,206170,480241,195161,881572
2023-04-16 04:30,881593,206188,480241,195164,881593
2023-04-16 04:31,881614,206209,480241,195164,881614
2023-04-16 04:32,881635,206229,480241,195165,881635
2023-04-16 04:33,881658,206252,480241,195165,881658
2023-04-16 04:34,881678,206272,480241,195165,881678
2023-04-16 04:35,881699,206292,480242,195165,881699
2023-04-16 04:36,881720,206313,480242,195165,881720
2023-04-16 04:37,881743,206336,480242,195165,881743
2023-04-16 04:38,881764,206357,480242,195165,881764
2023-04-16 04:39,881786,206378,480242,195166,881786
2023-04-16 04:40,881806,206398,480242,195166,881806
2023-04-16 04:41,881828,206417,480243,195168,881828
2023-04-16 04:42,881849,206436,480243,195170,881849
2023-04-16 04:43,881870,206455,480244,195171,881870
2023-04-16 04:44,881892,206476,480244,195172,881892
2023-04-16 04:45,881912,206494,480245,195173,881912
2023-04-16 04:46,881935,206515,480245,195175,881935
2023-04-16 04:47,881956,206535,480246,195175,881956
2023-04-16 04:48,881977,206555,480246,195176,881977
2023-04-16 04:49,881998,206574,480248,195176,881998
2023-04-16 04:50,882022,206598,480248,195176,882022
2023-04-16 04:51,882043,206619,480248,195176,882043
2023-04-16 04:52,882064,206640,480248,195176,882064
2023-04-16 04:53,882085,206659,480250,195176,882085
2023-04-16 04:54,882106,206680,480250,195176,882106
2023-04-16 04:55,882128,206701,480251,195176,882128
2023-04-16 04:56,882151,206724,480251,195176,882151
2023-04-16 04:57,882172,206745,480251,195176,882172
2023-04-16 04:58,882192,206765,480251,195176,882192
2023-04-16 04:59,882214,206786,480252,195176,882214
2023-04-16 05:00,882236,206808,480252,195176,882236
2023-04-16 05:01,882257,206828,480252,195177,882257
2023-04-16 05:02,882279,206850,480252,195177,882279
2023-04-16 05:03,882300,206871,480252,195177,882300
2023-04-16 05:04,882321,206892,480252,195177,882321
2023-04-16 05:05,882343,206914,480252,195177,882343
2023-04-16 05:06,882366,206936,480252,195178,882366
2023-04-16 05:07,882387,206957,480252,195178,882387
2023-04-16 05:08,882408,206977,480252,195179,882408
2023-04-16 05:09,882430,206998,480253,195179,882430
2023-04-16 05:10,882453,207020,480253,195180,882453
2023-04-16 05:11,882474,207039,480254,195181,882474
2023-04-16 05:12,882494,207059,480254,195181,882494
2023-04-16 05:13,882518,207081,480254,195183,882518
2023-04-16 05:14,882539,207102,480254,195183,882539
2023-04-16 05:16,882560,207122,480254,195184,882560
2023-04-16 05:17,882582,207143,480254,195185,882582
2023-04-16 05:18,882603,207162,480255,195186,882603
2023-04-16 05:19,882626,207184,480255,195187,882626
2023-04-16 05:20,882646,207202,480257,195187,882646
2023-04-16 05:21,882668,207222,480257,195189,882668
2023-04-16 05:22,882689,207242,480258,195189,882689
2023-04-16 05:23,882712,207264,480258,195190,882712
2023-04-16 05:24,882733,207284,480258,195191,882733
2023-04-16 05:25,882754,207304,480258,195192,882754
2023-04-16 05:26,882777,207327,480258,195192,882777
2023-04-16 05:27,882798,207346,480258,195194,882798
2023-04-16 05:28,882820,207368,480257,195195,882820
2023-04-16 05:29,882842,207389,480257,195196,882842
2023-04-16 05:30,882863,207408,480259,195196,882863
2023-04-16 05:31,882884,207429,480259,195196,882884
2023-04-16 05:32,882907,207451,480260,195196,882907
2023-04-16 05:33,882928,207472,480260,195196,882928
2023-04-16 05:34,882950,207492,480260,195198,882950
2023-04-16 05:35,882971,207513,480260,195198,882971
2023-04-16 05:36,882992,207533,480261,195198,882992
2023-04-16 05:37,883015,207556,480261,195198,883015
2023-04-16 05:38,883038,207579,480261,195198,883038
2023-04-16 05:39,883059,207598,480261,195200,883059
2023-04-16 05:40,883082,207620,480261,195201,883082
2023-04-16 05:41,883104,207642,480261,195201,883104
2023-04-16 05:42,883125,207663,480261,195201,883125
2023-04-16 05:43,883146,207684,480261,195201,883146
2023-04-16 05:44,883169,207706,480261,195202,883169
2023-04-16 05:45,883189,207726,480261,195202,883189
2023-04-16 05:46,883211,207748,480261,195202,883211
2023-04-16 05:47,883232,207769,480261,195202,883232
2023-04-16 05:48,883254,207790,480262,195202,883254
2023-04-16 05:49,883277,207812,480262,195203,883277
2023-04-16 05:50,883298,207833,480262,195203,883298
2023-04-16 05:51,883318,207853,480262,195203,883318
2023-04-16 05:52,883342,207875,480264,195203,883342
2023-04-16 05:53,883363,207895,480264,195204,883363
2023-04-16 05:54,883384,207915,480265,195204,883384
2023-04-16 05:55,883405,207936,480265,195204,883405
2023-04-16 05:56,883427,207956,480266,195205,883427
2023-04-16 05:57,883450,207979,480266,195205,883450
2023-04-16 05:58,883470,207998,480266,195206,883470
2023-04-16 05:59,883493,208021,480266,195206,883493
2023-04-16 06:00,883519,208045,480268,195206,883519
2023-04-16 06:02,883549,208074,480269,195206,883549
2023-04-16 06:03,883576,208101,480269,195206,883576
2023-04-16 06:04,883604,208129,480269,195206,883604
2023-04-16 06:05,883634,208159,480269,195206,883634
2023-04-16 06:06,883662,208187,480269,195206,883662
2023-04-16 06:07,883690,208214,480269,195207,883690
2023-04-16 06:08,883719,208241,480269,195209,883719
2023-04-16 06:09,883747,208268,480269,195210,883747
2023-04-16 06:10,883774,208293,480271,195210,883774
2023-04-16 06:11,883804,208322,480271,195211,883804
2023-04-16 06:12,883831,208348,480271,195212,883831
2023-04-16 06:13,883861,208378,480271,195212,883861
2023-04-16 06:14,883889,208404,480272,195213,883889
2023-04-16 06:15,883916,208430,480272,195214,883916
2023-04-16 06:16,883945,208456,480273,195216,883945
2023-04-16 06:17,883973,208482,480273,195218,883973
2023-04-16 06:18,884002,208511,480272,195219,884002
2023-04-16 06:19,884030,208540,480272,195218,884030
2023-04-16 06:20,884058,208567,480272,195219,884058
2023-04-16 06:21,884086,208595,480272,195219,884086
2023-04-16 06:22,884115,208623,480273,195219,884115
2023-04-16 06:23,884143,208649,480273,195221,884143
2023-04-16 06:24,884172,208678,480273,195221,884172
2023-04-16 06:25,884201,208706,480274,195221,884201
2023-04-16 06:26,884230,208732,480274,195224,884230
2023-04-16 06:27,884257,208756,480277,195224,884257
2023-04-16 06:28,884286,208785,480277,195224,884286
2023-04-16 06:29,884315,208814,480277,195224,884315
2023-04-16 06:30,884343,208842,480277,195224,884343
2023-04-16 06:31,884372,208870,480277,195225,884372
2023-04-16 06:32,884402,208899,480277,195226,884402
2023-04-16 06:33,884430,208921,480278,195231,884430
2023-04-16 06:34,884457,208947,480278,195232,884457
2023-04-16 06:35,884485,208970,480281,195234,884485
2023-04-16 06:36,884515,209000,480281,195234,884515
2023-04-16 06:37,884544,209028,480282,195234,884544
2023-04-16 06:38,884573,209057,480282,195234,884573
2023-04-16 06:39,884603,209086,480282,195235,884603
2023-04-16 06:40,884630,209111,480282,195237,884630
2023-04-16 06:41,884658,209133,480287,195238,884658
2023-04-16 06:42,884686,209160,480287,195239,884686
2023-04-16 06:43,884716,209183,480290,195243,884716
2023-04-16 06:44,884744,209209,480290,195245,884744
2023-04-16 06:45,884772,209236,480291,195245,884772
2023-04-16 06:46,884800,209263,480291,195246,884800
2023-04-16 06:47,884829,209291,480291,195247,884829
2023-04-16 06:49,884857,209318,480291,195248,884857
2023-04-16 06:50,884885,209344,480293,195248,884885
2023-04-16 06:51,884912,209368,480293,195251,884912
2023-04-16 06:52,884942,209396,480294,195252,884942
2023-04-16 06:53,884969,209422,480294,195253,884969
2023-04-16 06:54,884997,209445,480298,195254,884997
2023-04-16 06:55,885026,209473,480298,195255,885026
2023-04-16 06:56,885054,209497,480301,195256,885054
2023-04-16 06:57,885082,209523,480301,195258,885082
2023-04-16 06:58,885111,209549,480303,195259,885111
2023-04-16 06:59,885139,209577,480303,195259,885139
2023-04-16 07:00,885163,209599,480304,195260,885163
2023-04-16 07:01,885170,209606,480304,195260,885170
2023-04-16 07:02,885177,209610,480306,195261,885177
2023-04-16 07:03,885183,209614,480306,195263,885183
2023-04-16 07:04,885190,209619,480307,195264,885190
2023-04-16 07:05,885197,209625,480307,195265,885197
2023-04-16 07:06,885203,209626,480309,195268,885203
2023-04-16 07:07,885211,209633,480309,195269,885211
2023-04-16 07:08,885217,209637,480310,195270,885217
2023-04-16 07:09,885224,209643,480310,195271,885224
2023-04-16 07:10,885231,209646,480312,195273,885231
2023-04-16 07:11,885238,209651,480312,195275,885238
2023-04-16 07:12,885244,209652,480316,195276,885244
2023-04-16 07:13,885251,209658,480316,195277,885251
2023-04-16 07:14,885260,209666,480317,195277,885260
2023-04-16 07:15,885267,209672,480317,195278,885267
2023-04-16 07:16,885274,209673,480320,195281,885274
2023-04-16 07:17,885281,209677,480320,195284,885281
2023-04-16 07:18,885287,209681,480321,195285,885287
2023-04-16 07:19,885294,209686,480321,195287,885294
2023-04-16 07:20,885301,209688,480323,195290,885301
2023-04-16 07:21,885307,209694,480323,195290,885307
2023-04-16 07:22,885314,209698,480324,195292,885314
2023-04-16 07:23,885321,209702,480324,195295,885321
2023-04-16 07:24,885328,209704,480326,195298,885328
2023-04-16 07:25,885335,209710,480326,195299,885335
2023-04-16 07:26,885343,209716,480326,195301,885343
2023-04-16 07:27,885350,209722,480326,195302,885350
2023-04-16 07:28,885357,209724,480330,195303,885357
2023-04-16 07:29,885365,209730,480330,195305,885365
2023-04-16 07:30,885371,209729,480332,195310,885371
2023-04-16 07:31,885378,209736,480332,195310,885378
2023-04-16 07:32,885385,209739,480335,195311,885385
2023-04-16 07:33,885392,209740,480335,195317,885392
2023-04-16 07:34,885399,209743,480338,195318,885399
2023-04-16 07:36,885406,209747,480339,195320,885406
2023-04-16 07:37,885412,209750,480339,195323,885412
2023-04-16 07:38,885419,209751,480344,195324,885419
2023-04-16 07:39,885426,209758,480344,195324,885426
2023-04-16 07:40,885433,209760,480348,195325,885433
2023-04-16 07:41,885439,209766,480348,195325,885439
2023-04-16 07:42,885447,209770,480352,195325,885447
2023-04-16 07:43,885454,209774,480352,195328,885454
2023-04-16 07:44,885462,209777,480354,195331,885462
2023-04-16 07:45,885469,209783,480354,195332,885469
2023-04-16 07:46,885477,209785,480359,195333,885477
2023-04-16 07:47,885484,209787,480359,195338,885484
2023-04-16 07:48,885491,209792,480359,195340,885491
2023-04-16 07:49,885498,209797,480359,195342,885498
2023-04-16 07:50,885505,209798,480363,195344,885505
2023-04-16 07:51,885512,209803,480363,195346,885512
2023-04-16 07:52,885520,209810,480362,195348,885520
2023-04-16 07:53,885528,209817,480362,195349,885528
2023-04-16 07:54,885535,209817,480368,195350,885535
2023-04-16 07:55,885542,209821,480368,195353,885542
2023-04-16 07:56,885548,209825,480368,195355,885548
2023-04-16 07:57,885555,209832,480368,195355,885555
2023-04-16 07:58,885563,209838,480369,195356,885563
2023-04-16 07:59,885570,209844,480369,195357,885570
2023-04-16 08:00,885585,209853,480371,195361,885585
2023-04-16 08:01,885612,209875,480371,195366,885612
2023-04-16 08:02,885637,209896,480373,195368,885637
2023-04-16 08:03,885663,209918,480373,195372,885663
2023-04-16 08:04,885688,209940,480375,195373,885688
2023-04-16 08:05,885715,209962,480376,195377,885715
2023-04-16 08:06,885741,209987,480376,195378,885741
2023-04-16 08:07,885767,210005,480383,195379,885767
2023-04-16 08:08,885793,210029,480383,195381,885793
2023-04-16 08:09,885818,210051,480386,195381,885818
2023-04-16 08:10,885844,210075,480386,195383,885844
2023-04-16 08:11,885870,210098,480386,195386,885870
2023-04-16 08:12,885897,210124,480386,195387,885897
2023-04-16 08:13,885922,210140,480392,195390,885922
2023-04-16 08:14,885949,210166,480392,195391,885949
2023-04-16 08:15,885975,210188,480395,195392,885975
2023-04-16 08:16,886002,210213,480395,195394,886002
2023-04-16 08:17,886028,210231,480401,195396,886028
2023-04-16 08:18,886056,210256,480401,195399,886056
2023-04-16 08:19,886082,210279,480402,195401,886082
2023-04-16 08:20,886108,210301,480402,195405,886108
2023-04-16 08:21,886134,210318,480408,195408,886134
2023-04-16 08:22,886164,210346,480408,195410,886164
2023-04-16 08:24,886188,210363,480409,195416,886188
2023-04-16 08:25,886214,210387,480409,195418,886214
2023-04-16 08:26,886240,210408,480410,195422,886240
2023-04-16 08:27,886266,210433,480410,195423,886266
2023-04-16 08:28,886292,210454,480414,195424,886292
2023-04-16 08:29,886318,210480,480414,195424,886318
2023-04-16 08:30,886346,210502,480419,195425,886346
2023-04-16 08:31,886372,210527,480419,195426,886372
2023-04-16 08:32,886398,210548,480422,195428,886398
2023-04-16 08:33,886425,210571,480424,195430,886425
2023-04-16 08:34,886450,210593,480424,195433,886450
2023-04-16 08:35,886479,210618,480427,195434,886479
2023-04-16 08:36,886504,210639,480427,195438,886504
2023-04-16 08:37,886532,210663,480430,195439,886532
2023-04-16 08:38,886556,210686,480430,195440,886556
2023-04-16 08:39,886584,210710,480434,195440,886584
2023-04-16 08:40,886608,210730,480436,195442,886608
2023-04-16 08:41,886635,210755,480436,195444,886635
2023-04-16 08:42,886662,210776,480440,195446,886662
2023-04-16 08:43,886688,210800,480440,195448,886688
2023-04-16 08:44,886714,210820,480443,195451,886714
2023-04-16 08:45,886739,210843,480443,195453,886739
2023-04-16 08:46,886765,210864,480446,195455,886765
2023-04-16 08:47,886791,210887,480446,195458,886791
2023-04-16 08:48,886816,210906,480451,195459,886816
2023-04-16 08:49,886843,210929,480451,195463,886843
2023-04-16 08:50,886871,210950,480454,195467,886871
2023-04-16 08:51,886898,210973,480454,195471,886898
2023-04-16 08:52,886923,210996,480455,195472,886923
2023-04-16 08:53,886949,211021,480455,195473,886949
2023-04-16 08:54,886976,211046,480457,195473,886976
2023-04-16 08:55,887002,211070,480457,195475,887002
2023-04-16 08:56,887027,211087,480463,195477,887027
2023-04-16 08:57,887055,211110,480463,195482,887055
2023-04-16 08:58,887080,211127,480466,195487,887080
2023-04-16 08:59,887105,211149,480466,195490,887105
2023-04-16 09:00,887119,211155,480471,195493,887119
2023-04-16 09:01,887126,211159,480471,195496,887126
2023-04-16 09:02,887132,211161,480475,195496,887132
2023-04-16 09:03,887139,211167,480475,195497,887139
2023-04-16 09:04,887146,211166,480479,195501,887146
2023-04-16 09:05,887153,211172,480479,195502,887153
2023-04-16 09:06,887162,211174,480485,195503,887162
2023-04-16 09:07,887169,211179,480485,195505,887169
2023-04-16 09:08,887176,211180,480490,195506,887176
2023-04-16 09:09,887182,211183,480490,195509,887182
2023-04-16 09:11,887189,211182,480493,195514,887189
2023-04-16 09:12,887195,211185,480493,195517,887195
2023-04-16 09:13,887202,211188,480496,195518,887202
2023-04-16 09:14,887209,211192,480496,195521,887209
2023-04-16 09:15,887216,211196,480498,195522,887216
2023-04-16 09:16,887223,211200,480498,195525,887223
2023-04-16 09:17,887230,211201,480501,195528,887230
2023-04-16 09:18,887237,211206,480501,195530,887237
2023-04-16 09:19,887244,211207,480504,195533,887244
2023-04-16 09:20,887250,211210,480504,195536,887250
2023-04-16 09:21,887260,211219,480504,195537,887260
2023-04-16 09:22,887268,211226,480504,195538,887268
2023-04-16 09:23,887274,211224,480510,195540,887274
2023-04-16 09:24,887280,211228,480510,195542,887280
2023-04-16 09:25,887287,211228,480515,195544,887287
2023-04-16 09:26,887295,211234,480515,195546,887295
2023-04-16 09:27,887302,211235,480519,195548,887302
2023-04-16 09:28,887311,211243,480519,195549,887311
2023-04-16 09:29,887317,211245,480521,195551,887317
2023-04-16 09:30,887324,211247,480524,195553,887324
2023-04-16 09:31,887331,211251,480524,195556,887331
2023-04-16 09:32,887338,211254,480527,195557,887338
2023-04-16 09:33,887344,211258,480527,195559,887344
2023-04-16 09:34,887351,211260,480531,195560,887351
2023-04-16 09:35,887359,211261,480531,195567,887359
2023-04-16 09:36,887365,211259,480537,195569,887365
2023-04-16 09:37,887371,211263,480537,195571,887371
2023-04-16 09:38,887378,211263,480542,195573,887378
2023-04-16 09:39,887385,211267,480542,195576,887385
2023-04-16 09:40,887391,211271,480542,195578,887391
2023-04-16 09:41,887399,211274,480542,195583,887399
2023-04-16 09:42,887405,211269,480552,195584,887405
2023-04-16 09:43,887414,211274,480554,195586,887414
2023-04-16 09:44,887420,211270,480554,195596,887420
2023-04-16 09:45,887427,211267,480558,195602,887427
2023-04-16 09:46,887434,211274,480558,195602,887434
2023-04-16 09:47,887441,211272,480564,195605,887441
2023-04-16 09:48,887447,211277,480564,195606,887447
2023-04-16 09:49,887454,211277,480569,195608,887454
2023-04-16 09:50,887462,211285,480569,195608,887462
2023-04-16 09:51,887469,211287,480571,195611,887469
2023-04-16 09:52,887477,211291,480573,195613,887477
2023-04-16 09:53,887483,211295,480573,195615,887483
2023-04-16 09:54,887492,211295,480577,195620,887492
2023-04-16 09:55,887498,211298,480577,195623,887498
2023-04-16 09:56,887506,211305,480579,195622,887506
2023-04-16 09:57,887512,211309,480579,195624,887512
2023-04-16 09:59,887519,211308,480582,195629,887519
2023-04-16 10:00,887525,211312,480582,195631,887525
2023-04-16 10:01,887548,211328,480585,195635,887548
2023-04-16 10:02,887571,211347,480585,195639,887571
2023-04-16 10:03,887593,211358,480593,195642,887593
2023-04-16 10:04,887617,211380,480593,195644,887617
2023-04-16 10:05,887639,211393,480598,195648,887639
2023-04-16 10:06,887661,211412,480598,195651,887661
2023-04-16 10:07,887684,211432,480598,195654,887684
2023-04-16 10:08,887706,211453,480598,195655,887706
2023-04-16 10:09,887728,211471,480598,195659,887728
2023-04-16 10:10,887752,211483,480607,195662,887752
2023-04-16 10:11,887775,211502,480607,195666,887775
2023-04-16 10:12,887797,211519,480611,195667,887797
2023-04-16 10:13,887819,211540,480611,195668,887819
2023-04-16 10:14,887843,211554,480615,195674,887843
2023-04-16 10:15,887865,211570,480619,195676,887865
2023-04-16 10:16,887887,211588,480619,195680,887887
2023-04-16 10:17,887909,211602,480624,195683,887909
2023-04-16 10:18,887932,211622,480624,195686,887932
2023-04-16 10:19,887955,211640,480627,195688,887955
2023-04-16 10:20,887978,211659,480627,195692,887978
2023-04-16 10:21,888001,211675,480630,195696,888001
2023-04-16 10:22,888024,211697,480630,195697,888024
2023-04-16 10:23,888047,211710,480635,195702,888047
2023-04-16 10:24,888069,211730,480635,195704,888069
2023-04-16 10:25,888092,211745,480640,195707,888092
2023-04-16 10:26,888116,211763,480640,195713,888116
2023-04-16 10:27,888137,211774,480646,195717,888137
2023-04-16 10:28,888159,211793,480646,195720,888159
2023-04-16 10:29,888182,211812,480648,195722,888182
2023-04-16 10:30,888205,211832,480648,195725,888205
2023-04-16 10:31,888228,211847,480653,195728,888228
2023-04-16 10:32,888252,211867,480653,195732,888252
2023-04-16 10:33,888274,211883,480658,195733,888274
2023-04-16 10:34,888296,211905,480658,195733,888296
2023-04-16 10:35,888318,211917,480663,195738,888318
2023-04-16 10:36,888343,211940,480662,195741,888343
2023-04-16 10:37,888366,211960,480662,195744,888366
2023-04-16 10:38,888389,211973,480669,195747,888389
2023-04-16 10:39,888412,211989,480671,195752,888412
2023-04-16 10:40,888434,212006,480671,195757,888434
2023-04-16 10:41,888456,212013,480681,195762,888456
2023-04-16 10:42,888480,212034,480681,195765,888480
2023-04-16 10:43,888504,212048,480687,195769,888504
2023-04-16 10:44,888526,212068,480687,195771,888526
2023-04-16 10:46,888549,212083,480692,195774,888549
2023-04-16 10:47,888572,212102,480694,195776,888572
2023-04-16 10:48,888596,212123,480694,195779,888596
2023-04-16 10:49,888618,212136,480699,195783,888618
2023-04-16 10:50,888640,212157,480699,195784,888640
2023-04-16 10:51,888663,212171,480706,195786,888663
2023-04-16 10:52,888685,212191,480708,195786,888685
2023-04-16 10:53,888709,212205,480711,195793,888709
2023-04-16 10:54,888733,212228,480711,195794,888733
2023-04-16 10:55,888756,212246,480713,195797,888756
2023-04-16 10:56,888778,212266,480713,195799,888778
2023-04-16 10:57,888801,212277,480722,195802,888801
2023-04-16 10:58,888824,212298,480722,195804,888824
2023-04-16 10:59,888847,212314,480723,195810,888847
2023-04-16 11:00,888867,212332,480723,195812,888867
2023-04-16 11:01,888884,212339,480728,195817,888884
2023-04-16 11:02,888902,212354,480728,195820,888902
2023-04-16 11:03,888919,212362,480735,195822,888919
2023-04-16 11:04,888937,212377,480736,195824,888937
2023-04-16 11:05,888954,212393,480736,195825,888954
2023-04-16 11:06,888971,212399,480740,195832,888971
2023-04-16 11:07,888988,212415,480740,195833,888988
2023-04-16 11:08,889005,212427,480742,195836,889005
2023-04-16 11:09,889023,212437,480742,195844,889023
2023-04-16 11:10,889040,212446,480748,195846,889040
2023-04-16 11:11,889057,212459,480748,195850,889057
2023-04-16 11:12,889076,212470,480751,195855,889076
2023-04-16 11:13,889093,212481,480753,195859,889093
2023-04-16 11:14,889113,212497,480753,195863,889113
2023-04-16 11:15,889130,212506,480759,195865,889130
2023-04-16 11:16,889148,212514,480766,195868,889148
2023-04-16 11:17,889167,212524,480771,195872,889167
2023-04-16 11:18,889183,212536,480771,195876,889183
2023-04-16 11:19,889202,212546,480777,195879,889202
2023-04-16 11:20,889220,212561,480777,195882,889220
2023-04-16 11:21,889237,212567,480785,195885,889237
2023-04-16 11:22,889255,212581,480788,195886,889255
2023-04-16 11:23,889272,212593,480788,195891,889272
2023-04-16 11:24,889288,212599,480794,195895,889288
2023-04-16 11:25,889305,212614,480794,195897,889305
2023-04-16 11:26,889322,212620,480801,195901,889322
2023-04-16 11:27,889339,212627,480804,195908,889339
2023-04-16 11:28,889356,212641,480804,195911,889356
2023-04-16 11:29,889375,212656,480806,195913,889375
2023-04-16 11:30,889393,212670,480806,195917,889393
2023-04-16 11:32,889408,212675,480812,195921,889408
2023-04-16 11:33,889426,212688,480812,195926,889426
2023-04-16 11:34,889442,212693,480817,195932,889442
2023-04-16 11:35,889460,212708,480817,195935,889460
2023-04-16 11:36,889477,212710,480827,195940,889477
2023-04-16 11:37,889493,212721,480827,195945,889493
2023-04-16 11:38,889510,212733,480828,195949,889510
2023-04-16 11:39,889528,212746,480832,195950,889528
2023-04-16 11:40,889548,212759,480835,195954,889548
2023-04-16 11:41,889564,212774,480835,195955,889564
2023-04-16 11:42,889581,212782,480840,195959,889581
2023-04-16 11:43,889598,212785,480850,195963,889598
2023-04-16 11:44,889615,212799,480850,195966,889615
2023-04-16 11:45,889632,212802,480860,195970,889632
2023-04-16 11:46,889648,212813,480863,195972,889648
2023-04-16 11:47,889666,212829,480863,195974,889666
2023-04-16 11:48,889683,212830,480868,195985,889683
2023-04-16 11:49,889701,212841,480868,195992,889701
2023-04-16 11:50,889717,212850,480870,195997,889717
2023-04-16 11:51,889735,212867,480870,195998,889735
2023-04-16 11:52,889755,212875,480876,196004,889755
2023-04-16 11:53,889771,212887,480876,196008,889771
2023-04-16 11:54,889788,212895,480881,196012,889788
2023-04-16 11:55,889807,212912,480881,196014,889807
2023-04-16 11:56,889823,212919,480885,196019,889823
2023-04-16 11:57,889840,212935,480885,196020,889840
2023-04-16 11:58,889856,212941,480890,196025,889856
2023-04-16 11:59,889873,212952,480890,196031,889873
2023-04-16 12:00,889887,212954,480897,196036,889887
2023-04-16 12:01,889899,212959,480899,196041,889899
2023-04-16 12:02,889911,212968,480899,196044,889911
2023-04-16 12:03,889921,212965,480909,196047,889921
2023-04-16 12:04,889932,212974,480909,196049,889932
2023-04-16 12:05,889942,212966,480923,196053,889942
2023-04-16 12:06,889954,212970,480923,196061,889954
2023-04-16 12:07,889967,212977,480926,196064,889967
2023-04-16 12:08,889978,212980,480929,196069,889978
2023-04-16 12:09,889989,212987,480929,196073,889989
2023-04-16 12:10,890000,212989,480932,196079,890000
2023-04-16 12:11,890012,212998,480932,196082,890012
2023-04-16 12:12,890022,212999,480939,196084,890022
2023-04-16 12:13,890033,213001,480939,196093,890033
2023-04-16 12:14,890044,213007,480941,196096,890044
2023-04-16 12:15,890054,213010,480943,196101,890054
2023-04-16 12:16,890065,213018,480943,196104,890065
2023-04-16 12:17,890077,213020,480951,196106,890077
2023-04-16 12:19,890088,213029,480951,196108,890088
2023-04-16 12:20,890098,213032,480957,196109,890098
2023-04-16 12:21,890109,213035,480961,196113,890109
2023-04-16 12:22,890120,213044,480961,196115,890120
2023-04-16 12:23,890131,213048,480965,196118,890131
2023-04-16 12:24,890141,213054,480965,196122,890141
2023-04-16 12:25,890152,213056,480970,196126,890152
2023-04-16 12:26,890163,213060,480970,196133,890163
2023-04-16 12:27,890173,213059,480977,196137,890173
2023-04-16 12:28,890185,213062,480983,196140,890185
2023-04-16 12:29,890198,213073,480983,196142,890198
2023-04-16 12:30,890208,213068,480992,196148,890208
2023-04-16 12:31,890219,213076,480993,196150,890219
2023-04-16 12:32,890229,213082,480993,196154,890229
2023-04-16 12:33,890240,213077,481002,196161,890240
2023-04-16 12:34,890250,213077,481002,196171,890250
2023-04-16 12:35,890262,213076,481009,196177,890262
2023-04-16 12:36,890274,213086,481009,196179,890274
2023-04-16 12:37,890284,213089,481014,196181,890284
2023-04-16 12:38,890295,213099,481014,196182,890295
2023-04-16 12:39,890305,213100,481018,196187,890305
2023-04-16 12:40,890316,213105,481021,196190,890316
2023-04-16 12:41,890326,213113,481021,196192,890326
2023-04-16 12:42,890338,213114,481029,196195,890338
2023-04-16 12:43,890349,213124,481029,196196,890349
2023-04-16 12:44,890360,213127,481034,196199,890360
2023-04-16 12:45,890372,213136,481034,196202,890372
2023-04-16 12:46,890383,213133,481043,196207,890383
2023-04-16 12:47,890394,213139,481043,196212,890394
2023-04-16 12:48,890404,213138,481050,196216,890404
2023-04-16 12:49,890416,213148,481050,196218,890416
2023-04-16 12:50,890426,213145,481058,196223,890426
2023-04-16 12:51,890438,213148,481061,196229,890438
2023-04-16 12:52,890449,213157,481061,196231,890449
2023-04-16 12:53,890459,213161,481066,196232,890459
2023-04-16 12:54,890472,213173,481066,196233,890472
2023-04-16 12:55,890482,213174,481073,196235,890482
2023-04-16 12:56,890493,213182,481073,196238,890493
2023-04-16 12:57,890504,213183,481077,196244,890504
2023-04-16 12:58,890515,213184,481080,196251,890515
2023-04-16 12:59,890526,213187,481080,196259,890526
2023-04-16 13:00,890537,213190,481087,196260,890537
2023-04-16 13:01,890550,213199,481087,196264,890550
2023-04-16 13:02,890562,213198,481092,196272,890562
2023-04-16 13:03,890573,213207,481092,196274,890573
2023-04-16 13:04,890585,213210,481098,196277,890585
2023-04-16 13:06,890598,213221,481098,196279,890598
2023-04-16 13:07,890609,213222,481103,196284,890609
2023-04-16 13:08,890622,213233,481103,196286,890622
2023-04-16 13:09,890634,213232,481113,196289,890634
2023-04-16 13:10,890646,213239,481113,196294,890646
2023-04-16 13:11,890659,213242,481121,196296,890659
2023-04-16 13:12,890671,213252,481121,196298,890671
2023-04-16 13:13,890684,213258,481125,196301,890684
2023-04-16 13:14,890696,213266,481125,196305,890696
2023-04-16 13:15,890708,213268,481133,196307,890708
2023-04-16 13:16,890720,213271,481138,196311,890720
2023-04-16 13:17,890734,213282,481138,196314,890734
2023-04-16 13:18,890745,213281,481147,196317,890745
2023-04-16 13:19,890757,213292,481147,196318,890757
2023-04-16 13:20,890769,213301,481149,196319,890769
2023-04-16 13:21,890782,213307,481149,196326,890782
2023-04-16 13:22,890794,213304,481156,196334,890794
2023-04-16 13:23,890806,213314,481156,196336,890806
2023-04-16 13:24,890818,213321,481158,196339,890818
2023-04-16 13:25,890830,213332,481158,196340,890830
2023-04-16 13:26,890841,213337,481162,196342,890841
2023-04-16 13:27,890854,213350,481162,196342,890854
2023-04-16 13:28,890867,213352,481168,196347,890867
2023-04-16 13:29,890881,213366,481168,196347,890881
2023-04-16 13:30,890893,213374,481171,196348,890893
2023-04-16 13:31,890904,213380,481171,196353,890904
2023-04-16 13:32,890916,213382,481175,196359,890916
2023-04-16 13:33,890929,213391,481177,196361,890929
2023-04-16 13:34,890941,213395,481183,196363,890941
2023-04-16 13:35,890953,213405,481183,196365,890953
2023-04-16 13:36,890965,213412,481185,196368,890965
2023-04-16 13:37,890978,213422,481185,196371,890978
2023-04-16 13:38,890990,213430,481189,196371,890990
2023-04-16 13:39,891003,213440,481189,196374,891003
2023-04-16 13:40,891016,213447,481194,196375,891016
2023-04-16 13:41,891028,213456,481194,196378,891028
2023-04-16 13:42,891039,213459,481200,196380,891039
2023-04-16 13:43,891051,213468,481200,196383,891051
2023-04-16 13:44,891063,213467,481208,196388,891063
2023-04-16 13:45,891075,213474,481208,196393,891075
2023-04-16 13:46,891087,213483,481209,196395,891087
2023-04-16 13:47,891100,213492,481209,196399,891100
2023-04-16 13:48,891112,213501,481212,196399,891112
2023-04-16 13:49,891124,213502,481216,196406,891124
2023-04-16 13:50,891137,213514,481216,196407,891137
2023-04-16 13:51,891149,213515,481221,196413,891149
2023-04-16 13:53,891161,213523,481221,196417,891161
2023-04-16 13:54,891173,213530,481224,196419,891173
2023-04-16 13:55,891185,213538,481228,196419,891185
2023-04-16 13:56,891197,213544,481231,196422,891197
2023-04-16 13:57,891210,213554,481231,196425,891210
2023-04-16 13:58,891222,213559,481234,196429,891222
2023-04-16 13:59,891234,213568,481234,196432,891234
2023-04-16 14:00,891246,213571,481240,196435,891246
2023-04-16 14:01,891266,213584,481240,196442,891266
2023-04-16 14:02,891285,213592,481246,196447,891285
2023-04-16 14:03,891304,213603,481249,196452,891304
2023-04-16 14:04,891323,213616,481251,196456,891323
2023-04-16 14:05,891344,213634,481251,196459,891344
2023-04-16 14:06,891362,213636,481261,196465,891362
2023-04-16 14:07,891381,213652,481261,196468,891381
2023-04-16 14:08,891399,213659,481266,196474,891399
2023-04-16 14:09,891419,213677,481267,196475,891419
2023-04-16 14:10,891438,213687,481272,196479,891438
2023-04-16 14:11,891457,213704,481272,196481,891457
2023-04-16 14:12,891477,213717,481275,196485,891477
2023-04-16 14:13,891496,213731,481275,196490,891496
2023-04-16 14:14,891515,213744,481279,196492,891515
2023-04-16 14:15,891533,213759,481279,196495,891533
2023-04-16 14:16,891553,213773,481283,196497,891553
2023-04-16 14:17,891571,213787,481285,196499,891571
2023-04-16 14:18,891590,213800,481285,196505,891590
2023-04-16 14:19,891610,213811,481288,196511,891610
2023-04-16 14:20,891630,213827,481288,196515,891630
2023-04-16 14:21,891650,213842,481290,196518,891650
2023-04-16 14:22,891669,213858,481290,196521,891669
2023-04-16 14:23,891687,213867,481291,196529,891687
2023-04-16 14:24,891706,213881,481291,196534,891706
2023-04-16 14:25,891725,213898,481292,196535,891725
2023-04-16 14:26,891745,213911,481292,196542,891745
2023-04-16 14:27,891766,213927,481296,196543,891766
2023-04-16 14:28,891787,213944,481296,196547,891787
2023-04-16 14:29,891806,213951,481305,196550,891806
2023-04-16 14:30,891824,213965,481305,196554,891824
2023-04-16 14:31,891843,213975,481309,196559,891843
2023-04-16 14:32,891862,213982,481317,196563,891862
2023-04-16 14:33,891882,213997,481317,196568,891882
2023-04-16 14:34,891902,214009,481323,196570,891902
2023-04-16 14:35,891922,214026,481323,196573,891922
2023-04-16 14:36,891941,214036,481327,196578,891941
2023-04-16 14:37,891960,214051,481327,196582,891960
2023-04-16 14:38,891979,214060,481332,196587,891979
2023-04-16 14:40,891999,214075,481332,196592,891999
2023-04-16 14:41,892019,214093,481334,196592,892019
2023-04-16 14:42,892037,214105,481334,196598,892037
2023-04-16 14:43,892057,214116,481338,196603,892057
2023-04-16 14:44,892078,214134,481338,196606,892078
2023-04-16 14:45,892097,214145,481342,196610,892097
2023-04-16 14:46,892116,214163,481342,196611,892116
2023-04-16 14:47,892136,214170,481352,196614,892136
2023-04-16 14:48,892155,214186,481352,196617,892155
2023-04-16 14:49,892175,214192,481362,196621,892175
2023-04-16 14:50,892194,214209,481362,196623,892194
2023-04-16 14:51,892213,214219,481368,196626,892213
2023-04-16 14:52,892231,214235,481368,196628,892231
2023-04-16 14:53,892251,214252,481368,196631,892251
2023-04-16 14:54,892270,214269,481368,196633,892270
2023-04-16 14:55,892288,214278,481368,196642,892288
2023-04-16 14:56,892308,214294,481368,196646,892308
2023-04-16 14:57,892327,214309,481368,196650,892327
2023-04-16 14:58,892346,214312,481381,196653,892346
2023-04-16 14:59,892364,214325,481381,196658,892364
2023-04-16 15:00,892381,214334,481386,196661,892381
2023-04-16 15:01,892392,214341,481386,196665,892392
2023-04-16 15:02,892401,214348,481386,196667,892401
2023-04-16 15:03,892411,214355,481386,196670,892411
2023-04-16 15:04,892421,214362,481387,196672,892421
2023-04-16 15:05,892430,214366,481387,196677,892430
2023-04-16 15:06,892440,214368,481393,196679,892440
2023-04-16 15:07,892451,214376,481393,196682,892451
2023-04-16 15:08,892461,214376,481399,196686,892461
2023-04-16 15:09,892470,214381,481402,196687,892470
2023-04-16 15:10,892480,214389,481402,196689,892480
2023-04-16 15:11,892490,214390,481408,196692,892490
2023-04-16 15:12,892499,214397,481408,196694,892499
2023-04-16 15:13,892509,214399,481414,196696,892509
2023-04-16 15:14,892519,214407,481414,196698,892519
2023-04-16 15:15,892529,214410,481420,196699,892529
2023-04-16 15:16,892539,214418,481420,196701,892539
2023-04-16 15:17,892550,214421,481424,196705,892550
2023-04-16 15:18,892559,214428,481426,196705,892559
2023-04-16 15:19,892569,214438,481426,196705,892569
2023-04-16 15:20,892579,214442,481429,196708,892579
2023-04-16 15:21,892588,214445,481431,196712,892588
2023-04-16 15:22,892598,214453,481431,196714,892598
2023-04-16 15:23,892608,214451,481437,196720,892608
2023-04-16 15:24,892618,214457,481437,196724,892618
2023-04-16 15:25,892629,214457,481442,196730,892629
2023-04-16 15:27,892639,214462,481442,196735,892639
2023-04-16 15:28,892650,214463,481446,196741,892650
2023-04-16 15:29,892660,214471,481446,196743,892660
2023-04-16 15:30,892669,214476,481447,196746,892669
2023-04-16 15:31,892679,214486,481447,196746,892679
2023-04-16 15:32,892688,214486,481453,196749,892688
2023-04-16 15:33,892698,214492,481453,196753,892698
2023-04-16 15:34,892707,214495,481453,196759,892707
2023-04-16 15:35,892717,214501,481453,196763,892717
2023-04-16 15:36,892728,214510,481453,196765,892728
2023-04-16 15:37,892737,214519,481453,196765,892737
2023-04-16 15:38,892747,214527,481453,196767,892747
2023-04-16 15:39,892757,214536,481453,196768,892757
2023-04-16 15:40,892766,214544,481453,196769,892766
2023-04-16 15:41,892777,214554,481453,196770,892777
2023-04-16 15:42,892787,214541,481473,196773,892787
2023-04-16 15:43,892796,214546,481473,196777,892796
2023-04-16 15:44,892806,214549,481477,196780,892806
2023-04-16 15:45,892819,214558,481477,196784,892819
2023-04-16 15:46,892828,214561,481482,196785,892828
2023-04-16 15:47,892838,214567,481482,196789,892838
2023-04-16 15:48,892848,214571,481482,196795,892848
2023-04-16 15:49,892857,214576,481482,196799,892857
2023-04-16 15:50,892866,214572,481494,196800,892866
2023-04-16 15:51,892877,214581,481494,196802,892877
2023-04-16 15:52,892888,214583,481499,196806,892888
2023-04-16 15:53,892899,214592,481499,196808,892899
2023-04-16 15:54,892909,214593,481505,196811,892909
2023-04-16 15:55,892920,214602,481505,196813,892920
2023-04-16 15:56,892929,214600,481511,196818,892929
2023-04-16 15:57,892939,214608,481511,196820,892939
2023-04-16 15:58,892949,214610,481513,196826,892949
2023-04-16 15:59,892960,214616,481513,196831,892960
2023-04-16 16:00,892982,214632,481517,196833,892982
2023-04-16 16:01,893014,214662,481517,196835,893014
2023-04-16 16:02,893044,214685,481522,196837,893044
2023-04-16 16:03,893074,214713,481522,196839,893074
2023-04-16 16:04,893105,214734,481531,196840,893105
2023-04-16 16:05,893135,214761,481531,196843,893135
2023-04-16 16:06,893164,214782,481535,196847,893164
2023-04-16 16:07,893196,214809,481535,196852,893196
2023-04-16 16:08,893225,214829,481540,196856,893225
2023-04-16 16:09,893259,214856,481540,196863,893259
2023-04-16 16:10,893287,214878,481545,196864,893287
2023-04-16 16:11,893319,214907,481548,196864,893319
2023-04-16 16:12,893348,214933,481548,196867,893348
2023-04-16 16:14,893380,214958,481552,196870,893380
2023-04-16 16:15,893410,214987,481552,196871,893410
2023-04-16 16:16,893441,215011,481556,196874,893441
2023-04-16 16:17,893471,215036,481559,196876,893471
2023-04-16 16:18,893501,215062,481559,196880,893501
2023-04-16 16:19,893532,215088,481561,196883,893532
2023-04-16 16:20,893562,215117,481561,196884,893562
2023-04-16 16:21,893592,215138,481566,196888,893592
2023-04-16 16:22,893621,215165,481566,196890,893621
2023-04-16 16:23,893653,215186,481577,196890,893653
2023-04-16 16:24,893682,215212,481577,196893,893682
2023-04-16 16:25,893713,215237,481581,196895,893713
2023-04-16 16:26,893743,215264,481581,196898,893743
2023-04-16 16:27,893775,215287,481588,196900,893775
2023-04-16 16:28,893803,215313,481588,196902,893803
2023-04-16 16:29,893833,215336,481593,196904,893833
2023-04-16 16:30,893865,215365,481595,196905,893865
2023-04-16 16:31,893896,215390,481600,196906,893896
2023-04-16 16:32,893925,215415,481600,196910,893925
2023-04-16 16:33,893958,215447,481600,196911,893958
2023-04-16 16:34,893988,215473,481602,196913,893988
2023-04-16 16:35,894020,215500,481602,196918,894020
2023-04-16 16:36,894051,215525,481607,196919,894051
2023-04-16 16:37,894081,215553,481607,196921,894081
2023-04-16 16:38,894115,215584,481607,196924,894115
2023-04-16 16:39,894145,215611,481607,196927,894145
2023-04-16 16:40,894175,215638,481607,196930,894175
2023-04-16 16:41,894205,215664,481607,196934,894205
2023-04-16 16:42,894236,215691,481607,196938,894236
2023-04-16 16:43,894268,215720,481607,196941,894268
2023-04-16 16:44,894299,215748,481607,196944,894299
2023-04-16 16:45,894328,215748,481632,196948,894328
2023-04-16 16:46,894359,215773,481632,196954,894359
2023-04-16 16:47,894388,215801,481632,196955,894388
2023-04-16 16:48,894420,215832,481632,196956,894420
2023-04-16 16:49,894449,215857,481632,196960,894449
2023-04-16 16:50,894481,215887,481632,196962,894481
2023-04-16 16:51,894511,215913,481632,196966,894511
2023-04-16 16:52,894541,215939,481632,196970,894541
2023-04-16 16:53,894572,215952,481648,196972,894572
2023-04-16 16:54,894603,215979,481648,196976,894603
2023-04-16 16:55,894631,216004,481650,196977,894631
2023-04-16 16:56,894663,216033,481650,196980,894663
2023-04-16 16:57,894692,216050,481660,196982,894692
2023-04-16 16:58,894724,216080,481660,196984,894724
2023-04-16 16:59,894755,216103,481667,196985,894755
2023-04-16 17:01,894777,216121,481667,196989,894777
2023-04-16 17:02,894798,216131,481672,196995,894798
2023-04-16 17:03,894817,216145,481672,197000,894817
2023-04-16 17:04,894841,216166,481674,197001,894841
2023-04-16 17:05,894862,216186,481674,197002,894862
2023-04-16 17:06,894882,216199,481677,197006,894882
2023-04-16 17:07,894901,216216,481677,197008,894901
2023-04-16 17:08,894921,216227,481683,197011,894921
2023-04-16 17:09,894942,216242,481683,197017,894942
2023-04-16 17:10,894963,216262,481684,197017,894963
2023-04-16 17:11,894981,216277,481684,197020,894981
2023-04-16 17:12,895002,216289,481690,197023,895002
2023-04-16 17:13,895022,216307,481690,197025,895022
2023-04-16 17:14,895042,216319,481696,197027,895042
2023-04-16 17:15,895062,216336,481696,197030,895062
2023-04-16 17:16,895082,216350,481698,197034,895082
2023-04-16 17:17,895102,216368,481698,197036,895102
2023-04-16 17:18,895122,216384,481699,197039,895122
2023-04-16 17:19,895142,216400,481702,197040,895142
2023-04-16 17:20,895163,216418,481702,197043,895163
2023-04-16 17:21,895183,216428,481710,197045,895183
2023-04-16 17:22,895203,216440,481710,197053,895203
2023-04-16 17:23,895222,216456,481710,197056,895222
2023-04-16 17:24,895243,216475,481710,197058,895243
2023-04-16 17:25,895264,216484,481719,197061,895264
2023-04-16 17:26,895283,216496,481721,197066,895283
2023-04-16 17:27,895303,216509,481727,197067,895303
2023-04-16 17:28,895323,216528,481727,197068,895323
2023-04-16 17:29,895344,216543,481731,197070,895344
2023-04-16 17:30,895364,216561,481731,197072,895364
2023-04-16 17:31,895385,216576,481735,197074,895385
2023-04-16 17:32,895405,216594,481735,197076,895405
2023-04-16 17:33,895425,216608,481740,197077,895425
2023-04-16 17:34,895445,216628,481740,197077,895445
2023-04-16 17:35,895465,216641,481744,197080,895465
2023-04-16 17:36,895485,216657,481746,197082,895485
2023-04-16 17:37,895506,216674,481748,197084,895506
2023-04-16 17:38,895526,216694,481748,197084,895526
2023-04-16 17:39,895545,216707,481753,197085,895545
2023-04-16 17:40,895567,216724,481753,197090,895567
2023-04-16 17:41,895588,216738,481757,197093,895588
2023-04-16 17:42,895608,216757,481757,197094,895608
2023-04-16 17:43,895627,216770,481759,197098,895627
2023-04-16 17:44,895649,216787,481759,197103,895649
2023-04-16 17:45,895670,216804,481763,197103,895670
2023-04-16 17:46,895689,216822,481763,197104,895689
2023-04-16 17:48,895709,216832,481768,197109,895709
2023-04-16 17:49,895729,216851,481768,197110,895729
2023-04-16 17:50,895750,216861,481774,197115,895750
2023-04-16 17:51,895770,216877,481774,197119,895770
2023-04-16 17:52,895791,216896,481774,197121,895791
2023-04-16 17:53,895811,216912,481774,197125,895811
2023-04-16 17:54,895831,216922,481776,197133,895831
2023-04-16 17:55,895851,216937,481776,197138,895851
2023-04-16 17:56,895871,216952,481780,197139,895871
2023-04-16 17:57,895890,216970,481780,197140,895890
2023-04-16 17:58,895912,216980,481787,197145,895912
2023-04-16 17:59,895931,216998,481787,197146,895931
2023-04-16 18:00,895950,217010,481792,197148,895950
2023-04-16 18:01,895958,217016,481792,197150,895958
2023-04-16 18:02,895966,217018,481796,197152,895966
2023-04-16 18:03,895973,217019,481798,197156,895973
2023-04-16 18:04,895981,217026,481798,197157,895981
2023-04-16 18:05,895989,217025,481802,197162,895989
2023-04-16 18:06,895996,217030,481802,197164,895996
2023-04-16 18:07,896004,217028,481811,197165,896004
2023-04-16 18:08,896011,217033,481811,197167,896011
2023-04-16 18:09,896019,217032,481817,197170,896019
2023-04-16 18:10,896028,217038,481817,197173,896028
2023-04-16 18:11,896036,217036,481824,197176,896036
2023-04-16 18:12,896043,217039,481824,197180,896043
2023-04-16 18:13,896051,217035,481833,197183,896051
2023-04-16 18:14,896059,217043,481833,197183,896059
2023-04-16 18:15,896066,217047,481836,197183,896066
2023-04-16 18:16,896075,217055,481836,197184,896075
2023-04-16 18:17,896083,217057,481841,197185,896083
2023-04-16 18:18,896092,217062,481841,197189,896092
2023-04-16 18:19,896099,217063,481844,197192,896099
2023-04-16 18:20,896108,217072,481844,197192,896108
2023-04-16 18:21,896117,217071,481849,197197,896117
2023-04-16 18:22,896124,217077,481849,197198,896124
2023-04-16 18:23,896132,217076,481855,197201,896132
2023-04-16 18:24,896141,217084,481855,197202,896141
2023-04-16 18:25,896148,217082,481860,197206,896148
2023-04-16 18:26,896156,217088,481860,197208,896156
2023-04-16 18:27,896164,217091,481864,197209,896164
2023-04-16 18:28,896172,217095,481864,197213,896172
2023-04-16 18:29,896179,217094,481871,197214,896179
2023-04-16 18:30,896187,217099,481871,197217,896187
2023-04-16 18:31,896195,217098,481877,197220,896195
2023-04-16 18:32,896203,217105,481877,197221,896203
2023-04-16 18:33,896211,217107,481879,197225,896211
2023-04-16 18:35,896219,217115,481879,197225,896219
2023-04-16 18:36,896227,217111,481888,197228,896227
2023-04-16 18:37,896234,217113,481888,197233,896234
2023-04-16 18:38,896242,217112,481893,197237,896242
2023-04-16 18:39,896249,217113,481899,197237,896249
2023-04-16 18:40,896258,217119,481899,197240,896258
2023-04-16 18:41,896267,217122,481904,197241,896267
2023-04-16 18:42,896275,217129,481904,197242,896275
2023-04-16 18:43,896282,217127,481909,197246,896282
2023-04-16 18:44,896290,217129,481909,197252,896290
2023-04-16 18:45,896298,217134,481912,197252,896298
2023-04-16 18:46,896305,217139,481912,197254,896305
2023-04-16 18:47,896313,217141,481915,197257,896313
2023-04-16 18:48,896321,217147,481915,197259,896321
2023-04-16 18:49,896328,217150,481916,197262,896328
2023-04-16 18:50,896337,217156,481916,197265,896337
2023-04-16 18:51,896346,217157,481918,197271,896346
2023-04-16 18:52,896354,217162,481918,197274,896354
2023-04-16 18:53,896362,217163,481920,197279,896362
2023-04-16 18:54,896371,217168,481920,197283,896371
2023-04-16 18:55,896379,217172,481924,197283,896379
2023-04-16 18:56,896387,217179,481924,197284,896387
2023-04-16 18:57,896395,217179,481928,197288,896395
2023-04-16 18:58,896404,217187,481928,197289,896404
2023-04-16 18:59,896411,217184,481936,197291,896411
2023-04-16 19:00,896426,217193,481936,197297,896426
2023-04-16 19:01,896448,217211,481937,197300,896448
2023-04-16 19:02,896470,217231,481937,197302,896470
2023-04-16 19:03,896492,217247,481941,197304,896492
2023-04-16 19:04,896514,217266,481942,197306,896514
2023-04-16 19:05,896535,217284,481942,197309,896535
2023-04-16 19:06,896557,217297,481949,197311,896557
2023-04-16 19:07,896578,217317,481949,197312,896578
2023-04-16 19:08,896601,217340,481949,197312,896601
2023-04-16 19:09,896623,217361,481949,197313,896623
2023-04-16 19:10,896647,217383,481949,197315,896647
2023-04-16 19:11,896670,217405,481949,197316,896670
2023-04-16 19:12,896691,217424,481949,197318,896691
2023-04-16 19:13,896713,217443,481949,197321,896713
2023-04-16 19:14,896734,217449,481962,197323,896734
2023-04-16 19:15,896755,217469,481962,197324,896755
2023-04-16 19:16,896777,217485,481966,197326,896777
2023-04-16 19:17,896800,217507,481966,197327,896800
2023-04-16 19:18,896822,217523,481968,197331,896822
2023-04-16 19:19,896844,217542,481968,197334,896844
2023-04-16 19:20,896866,217554,481974,197338,896866
2023-04-16 19:21,896887,217571,481974,197342,896887
2023-04-16 19:23,896910,217587,481976,197347,896910
2023-04-16 19:24,896932,217607,481976,197349,896932
2023-04-16 19:25,896954,217623,481980,197351,896954
2023-04-16 19:26,896975,217635,481982,197358,896975
2023-04-16 19:27,896997,217655,481982,197360,896997
2023-04-16 19:28,897019,217677,481982,197360,897019
2023-04-16 19:29,897041,217698,481982,197361,897041
2023-04-16 19:30,897062,217718,481982,197362,897062
2023-04-16 19:31,897083,217736,481982,197365,897083
2023-04-16 19:32,897106,217757,481982,197367,897106
2023-04-16 19:33,897127,217759,481998,197370,897127
2023-04-16 19:34,897150,217782,481998,197370,897150
2023-04-16 19:35,897170,217797,482000,197373,897170
2023-04-16 19:36,897194,217818,482002,197374,897194
2023-04-16 19:37,897216,217838,482002,197376,897216
2023-04-16 19:38,897239,217852,482010,197377,897239
2023-04-16 19:39,897261,217870,482010,197381,897261
2023-04-16 19:40,897284,217888,482012,197384,897284
2023-04-16 19:41,897306,217910,482012,197384,897306
2023-04-16 19:42,897329,217929,482015,197385,897329
2023-04-16 19:43,897351,217942,482023,197386,897351
2023-04-16 19:44,897373,217963,482023,197387,897373
2023-04-16 19:45,897394,217978,482023,197393,897394
2023-04-16 19:46,897416,217998,482023,197395,897416
2023-04-16 19:47,897438,218015,482026,197397,897438
2023-04-16 19:48,897460,218031,482029,197400,897460
2023-04-16 19:49,897482,218050,482029,197403,897482
2023-04-16 19:50,897503,218066,482031,197406,897503
2023-04-16 19:51,897526,218089,482031,197406,897526
2023-04-16 19:52,897547,218104,482035,197408,897547
2023-04-16 19:53,897569,218123,482037,197409,897569
2023-04-16 19:54,897591,218144,482037,197410,897591
2023-04-16 19:55,897614,218158,482042,197414,897614
2023-04-16 19:56,897635,218177,482042,197416,897635
2023-04-16 19:57,897656,218190,482047,197419,897656
2023-04-16 19:58,897679,218210,482047,197422,897679
2023-04-16 19:59,897701,218230,482047,197424,897701
2023-04-16 20:00,897711,218237,482049,197425,897711
2023-04-16 20:01,897719,218242,482049,197428,897719
2023-04-16 20:02,897725,218245,482052,197428,897725
2023-04-16 20:03,897732,218248,482052,197432,897732
2023-04-16 20:04,897740,218252,482054,197434,897740
2023-04-16 20:05,897746,218257,482054,197435,897746
2023-04-16 20:06,897753,218255,482059,197439,897753
2023-04-16 20:07,897759,218258,482059,197442,897759
2023-04-16 20:08,897766,218260,482064,197442,897766
2023-04-16 20:10,897772,218261,482066,197445,897772
2023-04-16 20:11,897779,218268,482066,197445,897779
2023-04-16 20:12,897786,218274,482067,197445,897786
2023-04-16 20:13,897792,218279,482067,197446,897792
2023-04-16 20:14,897799,218281,482071,197447,897799
2023-04-16 20:15,897807,218288,482071,197448,897807
2023-04-16 20:16,897814,218290,482075,197449,897814
2023-04-16 20:17,897821,218296,482075,197450,897821
2023-04-16 20:18,897828,218287,482083,197458,897828
2023-04-16 20:19,897834,218292,482083,197459,897834
2023-04-16 20:20,897841,218293,482087,197461,897841
2023-04-16 20:21,897849,218299,482087,197463,897849
2023-04-16 20:22,897856,218302,482090,197464,897856
2023-04-16 20:23,897864,218307,482090,197467,897864
2023-04-16 20:24,897870,218307,482095,197468,897870
2023-04-16 20:25,897876,218311,482095,197470,897876
2023-04-16 20:26,897883,218314,482096,197473,897883
2023-04-16 20:27,897890,218319,482096,197475,897890
2023-04-16 20:28,897896,218324,482096,197476,897896
2023-04-16 20:29,897904,218330,482096,197478,897904
2023-04-16 20:30,897911,218337,482096,197478,897911
2023-04-16 20:31,897918,218343,482096,197479,897918
2023-04-16 20:32,897926,218349,482096,197481,897926
2023-04-16 20:33,897932,218351,482096,197485,897932
2023-04-16 20:34,897938,218350,482096,197492,897938
2023-04-16 20:35,897945,218357,482096,197492,897945
2023-04-16 20:36,897952,218341,482117,197494,897952
2023-04-16 20:37,897960,218346,482117,197497,897960
2023-04-16 20:38,897967,218351,482117,197499,897967
2023-04-16 20:39,897973,218355,482117,197501,897973
2023-04-16 20:40,897980,218361,482117,197502,897980
2023-04-16 20:41,897986,218364,482117,197505,897986
2023-04-16 20:42,897995,218369,482117,197509,897995
2023-04-16 20:43,898002,218377,482117,197508,898002
2023-04-16 20:44,898010,218384,482117,197509,898010
2023-04-16 20:45,898017,218391,482117,197509,898017
2023-04-16 20:46,898024,218375,482138,197511,898024
2023-04-16 20:47,898031,218380,482138,197513,898031
2023-04-16 20:48,898038,218380,482145,197513,898038
2023-04-16 20:49,898047,218384,482145,197518,898047
2023-04-16 20:50,898054,218378,482152,197524,898054
2023-04-16 20:51,898061,218384,482152,197525,898061
2023-04-16 20:52,898067,218380,482159,197528,898067
2023-04-16 20:53,898074,218386,482159,197529,898074
2023-04-16 20:54,898081,218383,482163,197535,898081
2023-04-16 20:55,898087,218386,482163,197538,898087
2023-04-16 20:56,898094,218387,482168,197539,898094
2023-04-16 20:58,898102,218393,482168,197541,898102
2023-04-16 20:59,898109,218397,482169,197543,898109
2023-04-16 21:00,898116,218402,482169,197545,898116
2023-04-16 21:01,898143,218420,482175,197548,898143
2023-04-16 21:02,898170,218443,482175,197552,898170
2023-04-16 21:03,898198,218467,482177,197554,898198
2023-04-16 21:04,898228,218494,482177,197557,898228
2023-04-16 21:05,898254,218515,482180,197559,898254
2023-04-16 21:06,898282,218540,482180,197562,898282
2023-04-16 21:07,898311,218567,482181,197563,898311
2023-04-16 21:08,898339,218593,482181,197565,898339
2023-04-16 21:09,898368,218611,482190,197567,898368
2023-04-16 21:10,898395,218633,482190,197572,898395
2023-04-16 21:11,898422,218654,482194,197574,898422
2023-04-16 21:12,898451,218679,482194,197578,898451
2023-04-16 21:13,898479,218701,482198,197580,898479
2023-04-16 21:14,898506,218727,482199,197580,898506
2023-04-16 21:15,898535,218751,482199,197585,898535
2023-04-16 21:16,898563,218773,482200,197590,898563
2023-04-16 21:17,898591,218801,482200,197590,898591
2023-04-16 21:18,898621,218828,482200,197593,898621
2023-04-16 21:19,898650,218855,482200,197595,898650
2023-04-16 21:20,898677,218878,482200,197599,898677
2023-04-16 21:21,898705,218898,482207,197600,898705
2023-04-16 21:22,898733,218924,482207,197602,898733
2023-04-16 21:23,898763,218946,482213,197604,898763
2023-04-16 21:24,898793,218971,482213,197609,898793
2023-04-16 21:25,898820,218987,482222,197611,898820
2023-04-16 21:26,898849,219015,482222,197612,898849
2023-04-16 21:27,898879,219039,482228,197612,898879
2023-04-16 21:28,898906,219065,482228,197613,898906
2023-04-16 21:29,898934,219082,482234,197618,898934
2023-04-16 21:30,898963,219110,482234,197619,898963
2023-04-16 21:31,898989,219131,482238,197620,898989
2023-04-16 21:32,899017,219157,482238,197622,899017
2023-04-16 21:33,899045,219178,482243,197624,899045
2023-04-16 21:34,899074,219206,482243,197625,899074
2023-04-16 21:35,899103,219227,482249,197627,899103
2023-04-16 21:36,899132,219253,482249,197630,899132
2023-04-16 21:37,899158,219271,482253,197634,899158
2023-04-16 21:38,899187,219299,482253,197635,899187
2023-04-16 21:39,899216,219318,482261,197637,899216
2023-04-16 21:40,899244,219343,482261,197640,899244
2023-04-16 21:41,899271,219361,482268,197642,899271
2023-04-16 21:42,899298,219386,482268,197644,899298
2023-04-16 21:43,899329,219410,482274,197645,899329
2023-04-16 21:45,899356,219435,482274,197647,899356
2023-04-16 21:46,899383,219456,482279,197648,899383
2023-04-16 21:47,899412,219479,482282,197651,899412
2023-04-16 21:48,899439,219504,482282,197653,899439
2023-04-16 21:49,899466,219522,482286,197658,899466
2023-04-16 21:50,899494,219550,482286,197658,899494
2023-04-16 21:51,899523,219574,482288,197661,899523
2023-04-16 21:52,899551,219597,482288,197666,899551
2023-04-16 21:53,899580,219625,482290,197665,899580
2023-04-16 21:54,899609,219653,482290,197666,899609
2023-04-16 21:55,899637,219677,482293,197667,899637
2023-04-16 21:56,899663,219701,482293,197669,899663
2023-04-16 21:57,899692,219721,482299,197672,899692
2023-04-16 21:58,899720,219747,482299,197674,899720
2023-04-16 21:59,899748,219770,482303,197675,899748
2023-04-16 22:00,899777,219797,482303,197677,899777
2023-04-16 22:01,899807,219812,482314,197681,899807
2023-04-16 22:02,899835,219838,482314,197683,899835
2023-04-16 22:03,899865,219862,482317,197686,899865
2023-04-16 22:04,899897,219893,482317,197687,899897
2023-04-16 22:05,899927,219914,482322,197691,899927
2023-04-16 22:06,899957,219941,482322,197694,899957
2023-04-16 22:07,899986,219966,482324,197696,899986
2023-04-16 22:08,900017,219995,482324,197698,900017
2023-04-16 22:09,900046,220019,482326,197701,900046
2023-04-16 22:10,900076,220046,482326,197704,900076
2023-04-16 22:11,900109,220067,482333,197709,900109
2023-04-16 22:12,900138,220092,482335,197711,900138
2023-04-16 22:13,900167,220118,482335,197714,900167
2023-04-16 22:14,900196,220138,482340,197718,900196
2023-04-16 22:15,900229,220168,482340,197721,900229
2023-04-16 22:16,900259,220190,482345,197724,900259
2023-04-16 22:17,900289,220218,482345,197726,900289
2023-04-16 22:18,900320,220239,482348,197733,900320
2023-04-16 22:19,900351,220268,482348,197735,900351
2023-04-16 22:20,900381,220294,482351,197736,900381
2023-04-16 22:21,900411,220318,482353,197740,900411
2023-04-16 22:22,900441,220346,482353,197742,900441
2023-04-16 22:23,900474,220375,482357,197742,900474
2023-04-16 22:24,900502,220400,482357,197745,900502
2023-04-16 22:25,900532,220423,482360,197749,900532
2023-04-16 22:26,900563,220454,482360,197749,900563
2023-04-16 22:27,900594,220480,482362,197752,900594
2023-04-16 22:28,900622,220504,482362,197756,900622
2023-04-16 22:29,900653,220527,482369,197757,900653
2023-04-16 22:30,900685,220558,482369,197758,900685
2023-04-16 22:31,900714,220580,482372,197762,900714
2023-04-16 22:33,900745,220607,482372,197766,900745
2023-04-16 22:34,900775,220630,482378,197767,900775
2023-04-16 22:35,900804,220656,482378,197770,900804
2023-04-16 22:36,900834,220682,482381,197771,900834
2023-04-16 22:37,900864,220710,482381,197773,900864
2023-04-16 22:38,900894,220734,482384,197776,900894
2023-04-16 22:39,900925,220762,482384,197779,900925
2023-04-16 22:40,900954,220787,482386,197781,900954
2023-04-16 22:41,900984,220812,482386,197786,900984
2023-04-16 22:42,901015,220836,482388,197791,901015
2023-04-16 22:43,901045,220866,482388,197791,901045
2023-04-16 22:44,901076,220883,482397,197796,901076
2023-04-16 22:45,901108,220911,482397,197800,901108
2023-04-16 22:46,901138,220931,482402,197805,901138
2023-04-16 22:47,901167,220956,482402,197809,901167
2023-04-16 22:48,901197,220970,482416,197811,901197
2023-04-16 22:49,901227,221000,482416,197811,901227
2023-04-16 22:50,901257,221026,482418,197813,901257
2023-04-16 22:51,901286,221046,482425,197815,901286
2023-04-16 22:52,901317,221076,482425,197816,901317
2023-04-16 22:53,901347,221097,482432,197818,901347
2023-04-16 22:54,901376,221126,482432,197818,901376
2023-04-16 22:55,901406,221147,482436,197823,901406
2023-04-16 22:56,901438,221174,482436,197828,901438
2023-04-16 22:57,901469,221196,482440,197833,901469
2023-04-16 22:58,901499,221222,482440,197837,901499
2023-04-16 22:59,901529,221242,482444,197843,901529
2023-04-16 23:00,901552,221260,482444,197848,901552
2023-04-16 23:01,901570,221269,482449,197852,901570
2023-04-16 23:02,901589,221284,482453,197852,901589
2023-04-16 23:03,901608,221298,482454,197856,901608
2023-04-16 23:04,901625,221313,482455,197857,901625
2023-04-16 23:05,901644,221330,482455,197859,901644
2023-04-16 23:06,901663,221343,482457,197863,901663
2023-04-16 23:07,901682,221358,482457,197867,901682
2023-04-16 23:08,901700,221364,482463,197873,901700
2023-04-16 23:09,901719,221379,482464,197876,901719
2023-04-16 23:10,901737,221391,482464,197882,901737
2023-04-16 23:11,901755,221404,482468,197883,901755
2023-04-16 23:12,901774,221422,482468,197884,901774
2023-04-16 23:13,901793,221435,482473,197885,901793
2023-04-16 23:14,901812,221451,482473,197888,901812
2023-04-16 23:15,901829,221461,482475,197893,901829
2023-04-16 23:16,901847,221475,482478,197894,901847
2023-04-16 23:17,901868,221493,482478,197897,901868
2023-04-16 23:19,901886,221503,482484,197899,901886
2023-04-16 23:20,901905,221522,482484,197899,901905
2023-04-16 23:21,901923,221536,482487,197900,901923
2023-04-16 23:22,901941,221547,482494,197900,901941
2023-04-16 23:23,901959,221565,482494,197900,901959
2023-04-16 23:24,901977,221573,482501,197903,901977
2023-04-16 23:25,901996,221592,482501,197903,901996
2023-04-16 23:26,902013,221604,482504,197905,902013
2023-04-16 23:27,902032,221620,482504,197908,902032
2023-04-16 23:28,902050,221633,482508,197909,902050
2023-04-16 23:29,902069,221649,482508,197912,902069
2023-04-16 23:30,902087,221661,482511,197915,902087
2023-04-16 23:31,902105,221678,482511,197916,902105
2023-04-16 23:32,902124,221693,482514,197917,902124
2023-04-16 23:33,902143,221711,482514,197918,902143
2023-04-16 23:34,902162,221722,482519,197921,902162
2023-04-16 23:35,902179,221738,482519,197922,902179
2023-04-16 23:36,902198,221749,482525,197924,902198
2023-04-16 23:37,902217,221765,482525,197927,902217
2023-04-16 23:38,902236,221775,482532,197929,902236
2023-04-16 23:39,902254,221787,482532,197935,902254
2023-04-16 23:40,902275,221805,482532,197938,902275
2023-04-16 23:41,902293,221822,482532,197939,902293
2023-04-16 23:42,902311,221836,482532,197943,902311
2023-04-16 23:43,902328,221853,482532,197943,902328
2023-04-16 23:44,902348,221870,482532,197946,902348
2023-04-16 23:45,902367,221888,482532,197947,902367
2023-04-16 23:46,902385,221900,482532,197953,902385
2023-04-16 23:47,902404,221902,482542,197960,902404
2023-04-16 23:48,902423,221917,482542,197964,902423
2023-04-16 23:49,902441,221929,482543,197969,902441
2023-04-16 23:50,902458,221941,482546,197971,902458
2023-04-16 23:51,902478,221954,482551,197973,902478
2023-04-16 23:52,902497,221971,482551,197975,902497
2023-04-16 23:53,902515,221982,482555,197978,902515
2023-04-16 23:54,902533,221998,482555,197980,902533
2023-04-16 23:55,902552,222011,482559,197982,902552
2023-04-16 23:56,902570,222028,482559,197983,902570
2023-04-16 23:57,902589,222045,482560,197984,902589
2023-04-16 23:58,902609,222060,482560,197989,902609
2023-04-16 23:59,902627,222066,482569,197992,902627
2023-04-17 00:00,902644,222079,482571,197994,902644
2023-04-17 00:01,902662,222095,482571,197996,902662
2023-04-17 00:02,902680,222109,482573,197998,902680
2023-04-17 00:03,902696,222125,482573,197998,902696
2023-04-17 00:04,902713,222137,482578,197998,902713
2023-04-17 00:06,902730,222153,482578,197999,902730
2023-04-17 00:07,902746,222160,482585,198001,902746
2023-04-17 00:08,902763,222175,482585,198003,902763
2023-04-17 00:09,902780,222187,482587,198006,902780
2023-04-17 00:10,902797,222204,482587,198006,902797
2023-04-17 00:11,902813,222215,482589,198009,902813
2023-04-17 00:12,902830,222229,482589,198012,902830
2023-04-17 00:13,902846,222238,482593,198015,902846
2023-04-17 00:14,902865,222253,482593,198019,902865
2023-04-17 00:15,902881,222267,482594,198020,902881
2023-04-17 00:16,902898,222281,482594,198023,902898
2023-04-17 00:17,902915,222294,482597,198024,902915
2023-04-17 00:18,902931,222309,482597,198025,902931
2023-04-17 00:19,902948,222321,482601,198026,902948
2023-04-17 00:20,902965,222336,482601,198028,902965
2023-04-17 00:21,902983,222346,482605,198032,902983
2023-04-17 00:22,902999,222354,482611,198034,902999
2023-04-17 00:23,903017,222371,482611,198035,903017
2023-04-17 00:24,903034,222384,482612,198038,903034
2023-04-17 00:25,903052,222401,482612,198039,903052
2023-04-17 00:26,903068,222412,482615,198041,903068
2023-04-17 00:27,903085,222427,482615,198043,903085
2023-04-17 00:28,903101,222440,482616,198045,903101
2023-04-17 00:29,903118,222455,482616,198047,903118
2023-04-17 00:30,903135,222463,482621,198051,903135
2023-04-17 00:31,903152,222479,482621,198052,903152
2023-04-17 00:32,903168,222490,482624,198054,903168
2023-04-17 00:33,903185,222505,482624,198056,903185
2023-04-17 00:34,903201,222516,482625,198060,903201
2023-04-17 00:35,903219,222532,482625,198062,903219
2023-04-17 00:36,903236,222546,482627,198063,903236
2023-04-17 00:37,903254,222562,482627,198065,903254
2023-04-17 00:38,903272,222573,482633,198066,903272
2023-04-17 00:39,903289,222588,482633,198068,903289
2023-04-17 00:40,903308,222602,482637,198069,903308
2023-04-17 00:41,903325,222617,482637,198071,903325
2023-04-17 00:42,903341,222627,482641,198073,903341
2023-04-17 00:43,903360,222644,482641,198075,903360
2023-04-17 00:44,903376,222650,482647,198079,903376
2023-04-17 00:45,903394,222667,482647,198080,903394
2023-04-17 00:46,903412,222682,482648,198082,903412
2023-04-17 00:47,903429,222696,482649,198084,903429
2023-04-17 00:48,903445,222710,482649,198086,903445
2023-04-17 00:49,903464,222728,482650,198086,903464
2023-04-17 00:50,903480,222743,482650,198087,903480
2023-04-17 00:51,903498,222754,482655,198089,903498
2023-04-17 00:52,903515,222770,482655,198090,903515
2023-04-17 00:54,903532,222782,482658,198092,903532
2023-04-17 00:55,903548,222796,482658,198094,903548
2023-04-17 00:56,903565,222810,482659,198096,903565
2023-04-17 00:57,903582,222828,482659,198095,903582
2023-04-17 00:58,903599,222839,482662,198098,903599
2023-04-17 00:59,903616,222856,482662,198098,903616
2023-04-17 01:00,903634,222869,482666,198099,903634
2023-04-17 01:01,903651,222886,482666,198099,903651
2023-04-17 01:02,903669,222897,482670,198102,903669
2023-04-17 01:03,903686,222910,482670,198106,903686
2023-04-17 01:04,903705,222926,482673,198106,903705
2023-04-17 01:05,903722,222941,482673,198108,903722
2023-04-17 01:06,903739,222953,482676,198110,903739
2023-04-17 01:07,903758,222970,482676,198112,903758
2023-04-17 01:08,903775,222978,482682,198115,903775
2023-04-17 01:09,903793,222995,482682,198116,903793
2023-04-17 01:10,903811,223011,482684,198116,903811
2023-04-17 01:11,903828,223028,482684,198116,903828
2023-04-17 01:12,903845,223040,482688,198117,903845
2023-04-17 01:13,903863,223058,482688,198117,903863
2023-04-17 01:14,903880,223072,482691,198117,903880
2023-04-17 01:15,903897,223086,482691,198120,903897
2023-04-17 01:16,903915,223101,482693,198121,903915
2023-04-17 01:17,903934,223116,482693,198125,903934
2023-04-17 01:18,903951,223129,482695,198127,903951
2023-04-17 01:19,903969,223143,482695,198131,903969
2023-04-17 01:20,903986,223157,482698,198131,903986
2023-04-17 01:21,904004,223173,482698,198133,904004
2023-04-17 01:22,904021,223185,482703,198133,904021
2023-04-17 01:23,904040,223204,482703,198133,904040
2023-04-17 01:24,904057,223216,482706,198135,904057
2023-04-17 01:25,904074,223229,482706,198139,904074
2023-04-17 01:26,904091,223245,482707,198139,904091
2023-04-17 01:27,904109,223263,482707,198139,904109
2023-04-17 01:28,904127,223281,482707,198139,904127
2023-04-17 01:29,904144,223296,482707,198141,904144
2023-04-17 01:30,904161,223312,482707,198142,904161
2023-04-17 01:31,904178,223329,482707,198142,904178
2023-04-17 01:32,904196,223346,482707,198143,904196
2023-04-17 01:33,904213,223360,482707,198146,904213
2023-04-17 01:34,904232,223378,482707,198147,904232
2023-04-17 01:35,904248,223394,482707,198147,904248
2023-04-17 01:36,904267,223398,482721,198148,904267
2023-04-17 01:37,904283,223414,482721,198148,904283
2023-04-17 01:38,904303,223430,482722,198151,904303
2023-04-17 01:40,904320,223447,482722,198151,904320
2023-04-17 01:41,904337,223462,482724,198151,904337
2023-04-17 01:42,904356,223478,482725,198153,904356
2023-04-17 01:43,904374,223496,482725,198153,904374
2023-04-17 01:44,904391,223509,482728,198154,904391
2023-04-17 01:45,904408,223526,482728,198154,904408
2023-04-17 01:46,904425,223542,482729,198154,904425
2023-04-17 01:47,904443,223559,482729,198155,904443
2023-04-17 01:48,904460,223575,482729,198156,904460
2023-04-17 01:49,904477,223589,482729,198159,904477
2023-04-17 01:50,904494,223603,482730,198161,904494
2023-04-17 01:51,904512,223621,482730,198161,904512
2023-04-17 01:52,904531,223638,482731,198162,904531
2023-04-17 01:53,904549,223656,482731,198162,904549
2023-04-17 01:54,904566,223670,482733,198163,904566
2023-04-17 01:55,904584,223688,482733,198163,904584
2023-04-17 01:56,904602,223703,482736,198163,904602
2023-04-17 01:57,904618,223718,482736,198164,904618
2023-04-17 01:58,904637,223735,482738,198164,904637
2023-04-17 01:59,904655,223752,482738,198165,904655
2023-04-17 02:00,904672,223765,482741,198166,904672
2023-04-17 02:01,904686,223778,482741,198167,904686
2023-04-17 02:02,904699,223786,482746,198167,904699
2023-04-17 02:03,904713,223799,482746,198168,904713
2023-04-17 02:04,904728,223810,482748,198170,904728
2023-04-17 02:05,904741,223822,482748,198171,904741
2023-04-17 02:06,904756,223836,482749,198171,904756
2023-04-17 02:07,904769,223847,482749,198173,904769
2023-04-17 02:08,904784,223858,482753,198173,904784
2023-04-17 02:09,904797,223870,482753,198174,904797
2023-04-17 02:10,904810,223880,482755,198175,904810
2023-04-17 02:11,904824,223894,482755,198175,904824
2023-04-17 02:12,904838,223908,482755,198175,904838
2023-04-17 02:13,904852,223921,482755,198176,904852
2023-04-17 02:14,904865,223932,482757,198176,904865
2023-04-17 02:15,904879,223945,482757,198177,904879
2023-04-17 02:16,904893,223955,482761,198177,904893
2023-04-17 02:17,904907,223969,482761,198177,904907
2023-04-17 02:18,904921,223979,482763,198179,904921
2023-04-17 02:19,904935,223993,482763,198179,904935
2023-04-17 02:20,904948,224000,482768,198180,904948
2023-04-17 02:21,904963,224015,482768,198180,904963
2023-04-17 02:22,904976,224026,482769,198181,904976
2023-04-17 02:23,904990,224038,482769,198183,904990
2023-04-17 02:24,905004,224051,482770,198183,905004
2023-04-17 02:25,905018,224064,482770,198184,905018
2023-04-17 02:27,905033,224078,482771,198184,905033
2023-04-17 02:28,905046,224090,482771,198185,905046
2023-04-17 02:29,905060,224102,482773,198185,905060
2023-04-17 02:30,905073,224113,482773,198187,905073
2023-04-17 02:31,905088,224125,482775,198188,905088
2023-04-17 02:32,905102,224138,482775,198189,905102
2023-04-17 02:33,905116,224149,482777,198190,905116
2023-04-17 02:34,905129,224161,482777,198191,905129
2023-04-17 02:35,905143,224173,482778,198192,905143
2023-04-17 02:36,905157,224185,482778,198194,905157
2023-04-17 02:37,905171,224198,482779,198194,905171
2023-04-17 02:38,905184,224211,482779,198194,905184
2023-04-17 02:39,905198,224223,482780,198195,905198
2023-04-17 02:40,905211,224236,482780,198195,905211
2023-04-17 02:41,905226,224251,482780,198195,905226
2023-04-17 02:42,905240,224265,482780,198195,905240
2023-04-17 02:43,905253,224278,482780,198195,905253
2023-04-17 02:44,905267,224292,482780,198195,905267
2023-04-17 02:45,905281,224306,482779,198196,905281
2023-04-17 02:46,905294,224319,482779,198196,905294
2023-04-17 02:47,905308,224330,482782,198196,905308
2023-04-17 02:48,905322,224344,482782,198196,905322
2023-04-17 02:49,905336,224356,482784,198196,905336
2023-04-17 02:50,905350,224370,482784,198196,905350
2023-04-17 02:51,905363,224382,482785,198196,905363
2023-04-17 02:52,905377,224396,482785,198196,905377
2023-04-17 02:53,905392,224410,482786,198196,905392
2023-04-17 02:54,905404,224422,482786,198196,905404
2023-04-17 02:55,905419,224435,482787,198197,905419
2023-04-17 02:56,905433,224449,482787,198197,905433
2023-04-17 02:57,905447,224462,482788,198197,905447
2023-04-17 02:58,905460,224475,482788,198197,905460
2023-04-17 02:59,905474,224486,482790,198198,905474
2023-04-17 03:00,905497,224509,482790,198198,905497
2023-04-17 03:01,905523,224535,482790,198198,905523
2023-04-17 03:02,905548,224560,482790,198198,905548
2023-04-17 03:03,905574,224583,482792,198199,905574
2023-04-17 03:04,905600,224609,482792,198199,905600
2023-04-17 03:05,905627,224636,482791,198200,905627
2023-04-17 03:06,905653,224660,482791,198202,905653
2023-04-17 03:07,905678,224683,482793,198202,905678
2023-04-17 03:08,905704,224708,482793,198203,905704
2023-04-17 03:09,905729,224732,482794,198203,905729
2023-04-17 03:10,905756,224759,482794,198203,905756
2023-04-17 03:11,905782,224784,482795,198203,905782
2023-04-17 03:13,905808,224810,482795,198203,905808
2023-04-17 03:14,905833,224832,482796,198205,905833
2023-04-17 03:15,905859,224857,482796,198206,905859
2023-04-17 03:16,905887,224883,482797,198207,905887
2023-04-17 03:17,905912,224908,482797,198207,905912
2023-04-17 03:18,905937,224933,482797,198207,905937
2023-04-17 03:19,905965,224961,482797,198207,905965
2023-04-17 03:20,905991,224983,482801,198207,905991
2023-04-17 03:21,906017,225009,482801,198207,906017
2023-04-17 03:22,906042,225033,482802,198207,906042
2023-04-17 03:23,906069,225059,482802,198208,906069
2023-04-17 03:24,906095,225085,482802,198208,906095
2023-04-17 03:25,906120,225110,482802,198208,906120
2023-04-17 03:26,906146,225136,482802,198208,906146
2023-04-17 03:27,906171,225161,482802,198208,906171
2023-04-17 03:28,906199,225187,482804,198208,906199
2023-04-17 03:29,906224,225211,482804,198209,906224
2023-04-17 03:30,906250,225236,482805,198209,906250
2023-04-17 03:31,906277,225263,482805,198209,906277
2023-04-17 03:32,906301,225287,482805,198209,906301
2023-04-17 03:33,906328,225314,482805,198209,906328
2023-04-17 03:34,906354,225339,482806,198209,906354
2023-04-17 03:35,906380,225365,482806,198209,906380
2023-04-17 03:36,906407,225390,482807,198210,906407
2023-04-17 03:37,906432,225414,482807,198211,906432
2023-04-17 03:38,906458,225440,482807,198211,906458
2023-04-17 03:39,906484,225466,482807,198211,906484
2023-04-17 03:40,906510,225492,482807,198211,906510
2023-04-17 03:41,906537,225518,482807,198212,906537
2023-04-17 03:42,906563,225543,482807,198213,906563
2023-04-17 03:43,906589,225569,482807,198213,906589
2023-04-17 03:44,906614,225594,482807,198213,906614
2023-04-17 03:45,906639,225618,482807,198214,906639
2023-04-17 03:46,906667,225644,482807,198216,906667
2023-04-17 03:47,906693,225670,482807,198216,906693
2023-04-17 03:48,906718,225694,482807,198217,906718
2023-04-17 03:49,906745,225720,482807,198218,906745
2023-04-17 03:50,906771,225746,482807,198218,906771
2023-04-17 03:51,906797,225772,482807,198218,906797
2023-04-17 03:52,906822,225797,482807,198218,906822
2023-04-17 03:53,906847,225822,482807,198218,906847
2023-04-17 03:54,906873,225848,482807,198218,906873
2023-04-17 03:55,906901,225876,482807,198218,906901
2023-04-17 03:56,906925,225899,482808,198218,906925
2023-04-17 03:57,906952,225926,482808,198218,906952
2023-04-17 03:58,906977,225951,482808,198218,906977
2023-04-17 04:00,907004,225978,482808,198218,907004
2023-04-17 04:01,907016,225989,482808,198219,907016
2023-04-17 04:02,907025,225998,482808,198219,907025
2023-04-17 04:03,907036,226007,482809,198220,907036
2023-04-17 04:04,907045,226016,482809,198220,907045
2023-04-17 04:05,907055,226026,482809,198220,907055
2023-04-17 04:06,907065,226035,482809,198221,907065
2023-04-17 04:07,907076,226044,482811,198221,907076
2023-04-17 04:08,907086,226054,482811,198221,907086
2023-04-17 04:09,907096,226064,482811,198221,907096
2023-04-17 04:10,907106,226074,482811,198221,907106
2023-04-17 04:11,907116,226082,482811,198223,907116
2023-04-17 04:12,907126,226091,482811,198224,907126
2023-04-17 04:13,907136,226100,482812,198224,907136
2023-04-17 04:14,907147,226111,482812,198224,907147
2023-04-17 04:15,907157,226121,482812,198224,907157
2023-04-17 04:16,907167,226131,482812,198224,907167
2023-04-17 04:17,907177,226140,482813,198224,907177
2023-04-17 04:18,907187,226150,482813,198224,907187
2023-04-17 04:19,907196,226158,482813,198225,907196
2023-04-17 04:20,907206,226168,482813,198225,907206
2023-04-17 04:21,907216,226178,482813,198225,907216
2023-04-17 04:22,907227,226189,482813,198225,907227
2023-04-17 04:23,907237,226199,482813,198225,907237
2023-04-17 04:24,907247,226209,482813,198225,907247
2023-04-17 04:25,907257,226219,482813,198225,907257
2023-04-17 04:26,907267,226229,482813,198225,907267
2023-04-17 04:27,907277,226239,482813,198225,907277
2023-04-17 04:28,907287,226249,482813,198225,907287
2023-04-17 04:29,907298,226258,482815,198225,907298
2023-04-17 04:30,907308,226267,482815,198226,907308
2023-04-17 04:31,907318,226277,482815,198226,907318
2023-04-17 04:32,907328,226287,482815,198226,907328
2023-04-17 04:33,907338,226296,482816,198226,907338
2023-04-17 04:34,907348,226304,482816,198228,907348
2023-04-17 04:35,907358,226314,482816,198228,907358
2023-04-17 04:36,907368,226324,482816,198228,907368
2023-04-17 04:37,907379,226335,482816,198228,907379
2023-04-17 04:38,907389,226345,482816,198228,907389
2023-04-17 04:39,907399,226355,482816,198228,907399
2023-04-17 04:40,907409,226364,482816,198229,907409
2023-04-17 04:41,907420,226375,482816,198229,907420
2023-04-17 04:42,907430,226385,482816,198229,907430
2023-04-17 04:43,907440,226394,482817,198229,907440
2023-04-17 04:44,907450,226404,482817,198229,907450
2023-04-17 04:46,907460,226414,482817,198229,907460
2023-04-17 04:47,907470,226423,482817,198230,907470
2023-04-17 04:48,907480,226433,482817,198230,907480
2023-04-17 04:49,907490,226443,482817,198230,907490
2023-04-17 04:50,907501,226455,482816,198230,907501
2023-04-17 04:51,907510,226464,482816,198230,907510
2023-04-17 04:52,907521,226475,482816,198230,907521
2023-04-17 04:53,907531,226485,482816,198230,907531
2023-04-17 04:54,907540,226493,482816,198231,907540
2023-04-17 04:55,907550,226503,482816,198231,907550
2023-04-17 04:56,907560,226513,482816,198231,907560
2023-04-17 04:57,907571,226524,482816,198231,907571
2023-04-17 04:58,907581,226531,482819,198231,907581
2023-04-17 04:59,907591,226541,482819,198231,907591
2023-04-17 05:00,907605,226555,482819,198231,907605
2023-04-17 05:01,907625,226575,482819,198231,907625
2023-04-17 05:02,907645,226594,482819,198232,907645
2023-04-17 05:03,907666,226614,482819,198233,907666
2023-04-17 05:04,907687,226635,482819,198233,907687
2023-04-17 05:05,907708,226656,482819,198233,907708
2023-04-17 05:06,907729,226677,482819,198233,907729
2023-04-17 05:07,907750,226698,482819,198233,907750
2023-04-17 05:08,907770,226717,482819,198234,907770
2023-04-17 05:09,907791,226738,482819,198234,907791
2023-04-17 05:10,907812,226758,482820,198234,907812
2023-04-17 05:11,907833,226778,482820,198235,907833
2023-04-17 05:12,907854,226799,482820,198235,907854
2023-04-17 05:13,907875,226820,482820,198235,907875
2023-04-17 05:14,907895,226840,482820,198235,907895
2023-04-17 05:15,907917,226862,482820,198235,907917
2023-04-17 05:16,907937,226882,482820,198235,907937
2023-04-17 05:17,907958,226903,482820,198235,907958
2023-04-17 05:18,907978,226923,482820,198235,907978
2023-04-17 05:19,908000,226945,482820,198235,908000
2023-04-17 05:20,908021,226965,482820,198236,908021
2023-04-17 05:21,908041,226984,482820,198237,908041
2023-04-17 05:22,908062,227004,482821,198237,908062
2023-04-17 05:23,908083,227026,482821,198236,908083
2023-04-17 05:24,908104,227046,482822,198236,908104
2023-04-17 05:25,908125,227066,482822,198237,908125
2023-04-17 05:26,908146,227087,482822,198237,908146
2023-04-17 05:27,908168,227109,482822,198237,908168
2023-04-17 05:28,908188,227129,482822,198237,908188
2023-04-17 05:29,908208,227147,482822,198239,908208
2023-04-17 05:30,908229,227168,482822,198239,908229
2023-04-17 05:32,908251,227190,482822,198239,908251
2023-04-17 05:33,908271,227209,482823,198239,908271
2023-04-17 05:34,908292,227229,482823,198240,908292
2023-04-17 05:35,908313,227250,482823,198240,908313
2023-04-17 05:36,908333,227270,482823,198240,908333
2023-04-17 05:37,908355,227291,482824,198240,908355
2023-04-17 05:38,908374,227310,482824,198240,908374
2023-04-17 05:39,908396,227331,482825,198240,908396
2023-04-17 05:40,908416,227351,482825,198240,908416
2023-04-17 05:41,908437,227372,482825,198240,908437
2023-04-17 05:42,908458,227393,482825,198240,908458
2023-04-17 05:43,908479,227414,482825,198240,908479
2023-04-17 05:44,908500,227435,482825,198240,908500
2023-04-17 05:45,908521,227456,482825,198240,908521
2023-04-17 05:46,908541,227476,482825,198240,908541
2023-04-17 05:47,908563,227497,482826,198240,908563
2023-04-17 05:48,908584,227518,482826,198240,908584
2023-04-17 05:49,908606,227539,482827,198240,908606
2023-04-17 05:50,908626,227559,482827,198240,908626
2023-04-17 05:51,908647,227580,482827,198240,908647
2023-04-17 05:52,908667,227600,482827,198240,908667
2023-04-17 05:53,908689,227621,482828,198240,908689
2023-04-17 05:54,908710,227640,482828,198242,908710
2023-04-17 05:55,908730,227660,482828,198242,908730
2023-04-17 05:56,908751,227681,482828,198242,908751
2023-04-17 05:57,908771,227701,482828,198242,908771
2023-04-17 05:58,908793,227723,482828,198242,908793
2023-04-17 05:59,908813,227743,482828,198242,908813
2023-04-17 06:00,908828,227758,482828,198242,908828
2023-04-17 06:01,908837,227766,482829,198242,908837
2023-04-17 06:02,908847,227776,482829,198242,908847
2023-04-17 06:03,908856,227784,482829,198243,908856
2023-04-17 06:04,908865,227794,482829,198242,908865
2023-04-17 06:05,908874,227803,482829,198242,908874
2023-04-17 06:06,908884,227813,482829,198242,908884
2023-04-17 06:07,908893,227821,482830,198242,908893
2023-04-17 06:08,908902,227830,482830,198242,908902
2023-04-17 06:09,908912,227841,482829,198242,908912
2023-04-17 06:10,908921,227850,482829,198242,908921
2023-04-17 06:11,908931,227858,482831,198242,908931
2023-04-17 06:12,908940,227867,482831,198242,908940
2023-04-17 06:13,908949,227875,482831,198243,908949
2023-04-17 06:14,908959,227885,482831,198243,908959
2023-04-17 06:15,908968,227891,482833,198244,908968
2023-04-17 06:16,908978,227898,482833,198247,908978
2023-04-17 06:18,908987,227904,482836,198247,908987
2023-04-17 06:19,908996,227913,482836,198247,908996
2023-04-17 06:20,909005,227921,482836,198248,909005
2023-04-17 06:21,909014,227927,482836,198251,909014
2023-04-17 06:22,909024,227936,482836,198252,909024
2023-04-17 06:23,909035,227947,482836,198252,909035
2023-04-17 06:24,909044,227954,482838,198252,909044
2023-04-17 06:25,909053,227963,482838,198252,909053
2023-04-17 06:26,909063,227973,482837,198253,909063
2023-04-17 06:27,909072,227982,482837,198253,909072
2023-04-17 06:28,909081,227990,482838,198253,909081
2023-04-17 06:29,909090,227999,482838,198253,909090
2023-04-17 06:30,909099,228007,482839,198253,909099
2023-04-17 06:31,909109,228017,482839,198253,909109
2023-04-17 06:32,909118,228023,482840,198255,909118
2023-04-17 06:33,909128,228032,482840,198256,909128
2023-04-17 06:34,909137,228040,482841,198256,909137
2023-04-17 06:35,909147,228049,482841,198257,909147
2023-04-17 06:36,909156,228058,482841,198257,909156
2023-04-17 06:37,909165,228067,482841,198257,909165
2023-04-17 06:38,909175,228076,482842,198257,909175
2023-04-17 06:39,909184,228083,482842,198259,909184
2023-04-17 06:40,909194,228090,482844,198260,909194
2023-04-17 06:41,909203,228099,482844,198260,909203
2023-04-17 06:42,909212,228107,482845,198260,909212
2023-04-17 06:43,909221,228117,482845,198259,909221
2023-04-17 06:44,909231,228125,482846,198260,909231
2023-04-17 06:45,909240,228133,482846,198261,909240
2023-04-17 06:46,909250,228141,482846,198263,909250
2023-04-17 06:47,909259,228149,482846,198264,909259
2023-04-17 06:48,909268,228158,482846,198264,909268
2023-04-17 06:49,909277,228167,482846,198264,909277
2023-04-17 06:50,909287,228177,482846,198264,909287
2023-04-17 06:51,909296,228186,482846,198264,909296
2023-04-17 06:52,909305,228192,482848,198265,909305
2023-04-17 06:53,909315,228202,482848,198265,909315
2023-04-17 06:54,909324,228211,482848,198265,909324
2023-04-17 06:55,909334,228221,482848,198265,909334
2023-04-17 06:56,909343,228229,482848,198266,909343
2023-04-17 06:57,909354,228239,482848,198267,909354
2023-04-17 06:58,909363,228246,482849,198268,909363
2023-04-17 06:59,909372,228254,482849,198269,909372
2023-04-17 07:00,909384,228262,482851,198271,909384
2023-04-17 07:01,909396,228274,482851,198271,909396
2023-04-17 07:02,909408,228285,482852,198271,909408
2023-04-17 07:03,909421,228297,482852,198272,909421
2023-04-17 07:04,909434,228309,482853,198272,909434
2023-04-17 07:06,909446,228321,482853,198272,909446
2023-04-17 07:07,909459,228333,482854,198272,909459
2023-04-17 07:08,909471,228343,482854,198274,909471
2023-04-17 07:09,909483,228351,482857,198275,909483
2023-04-17 07:10,909496,228362,482857,198277,909496
2023-04-17 07:11,909508,228372,482859,198277,909508
2023-04-17 07:12,909520,228384,482859,198277,909520
2023-04-17 07:13,909534,228396,482861,198277,909534
2023-04-17 07:14,909546,228406,482861,198279,909546
2023-04-17 07:15,909558,228417,482862,198279,909558
2023-04-17 07:16,909571,228429,482862,198280,909571
2023-04-17 07:17,909584,228442,482862,198280,909584
2023-04-17 07:18,909596,228451,482862,198283,909596
2023-04-17 07:19,909608,228464,482862,198282,909608
2023-04-17 07:20,909621,228477,482862,198282,909621
2023-04-17 07:21,909633,228488,482863,198282,909633
2023-04-17 07:22,909646,228500,482863,198283,909646
2023-04-17 07:23,909658,228510,482863,198285,909658
2023-04-17 07:24,909671,228518,482867,198286,909671
2023-04-17 07:25,909683,228530,482867,198286,909683
2023-04-17 07:26,909695,228541,482868,198286,909695
2023-04-17 07:27,909708,228554,482868,198286,909708
2023-04-17 07:28,909720,228566,482868,198286,909720
2023-04-17 07:29,909732,228578,482868,198286,909732
2023-04-17 07:30,909746,228590,482869,198287,909746
2023-04-17 07:31,909759,228602,482869,198288,909759
2023-04-17 07:32,909772,228613,482870,198289,909772
2023-04-17 07:33,909784,228625,482870,198289,909784
2023-04-17 07:34,909796,228634,482872,198290,909796
2023-04-17 07:35,909810,228647,482872,198291,909810
2023-04-17 07:36,909823,228659,482873,198291,909823
2023-04-17 07:37,909834,228669,482873,198292,909834
2023-04-17 07:38,909847,228681,482874,198292,909847
2023-04-17 07:39,909859,228692,482874,198293,909859
2023-04-17 07:40,909871,228705,482873,198293,909871
2023-04-17 07:41,909884,228718,482873,198293,909884
2023-04-17 07:42,909898,228732,482873,198293,909898
2023-04-17 07:43,909910,228743,482873,198294,909910
2023-04-17 07:44,909924,228757,482873,198294,909924
2023-04-17 07:45,909936,228766,482873,198297,909936
2023-04-17 07:46,909948,228774,482874,198300,909948
2023-04-17 07:47,909960,228784,482874,198302,909960
2023-04-17 07:48,909974,228794,482878,198302,909974
2023-04-17 07:49,909986,228806,482878,198302,909986
2023-04-17 07:50,909999,228817,482879,198303,909999
2023-04-17 07:51,910012,228829,482879,198304,910012
2023-04-17 07:53,910024,228839,482880,198305,910024
2023-04-17 07:54,910037,228851,482880,198306,910037
2023-04-17 07:55,910050,228862,482881,198307,910050
2023-04-17 07:56,910062,228873,482881,198308,910062
2023-04-17 07:57,910075,228884,482882,198309,910075
2023-04-17 07:58,910087,228895,482882,198310,910087
2023-04-17 07:59,910099,228902,482886,198311,910099
2023-04-17 08:00,910112,228915,482886,198311,910112
2023-04-17 08:01,910135,228937,482887,198311,910135
2023-04-17 08:02,910158,228958,482887,198313,910158
2023-04-17 08:03,910178,228973,482890,198315,910178
2023-04-17 08:04,910201,228996,482890,198315,910201
2023-04-17 08:05,910223,229015,482892,198316,910223
2023-04-17 08:06,910245,229037,482892,198316,910245
2023-04-17 08:07,910267,229055,482895,198317,910267
2023-04-17 08:08,910288,229075,482895,198318,910288
2023-04-17 08:09,910311,229093,482899,198319,910311
2023-04-17 08:10,910332,229113,482899,198320,910332
2023-04-17 08:11,910354,229133,482900,198321,910354
2023-04-17 08:12,910377,229155,482900,198322,910377
2023-04-17 08:13,910398,229175,482901,198322,910398
2023-04-17 08:14,910420,229197,482901,198322,910420
2023-04-17 08:15,910442,229217,482901,198324,910442
2023-04-17 08:16,910466,229238,482901,198327,910466
2023-04-17 08:17,910486,229254,482903,198329,910486
2023-04-17 08:18,910508,229274,482904,198330,910508
2023-04-17 08:19,910531,229295,482904,198332,910531
2023-04-17 08:20,910552,229313,482905,198334,910552
2023-04-17 08:21,910575,229335,482905,198335,910575
2023-04-17 08:22,910596,229353,482907,198336,910596
2023-04-17 08:23,910617,229374,482907,198336,910617
2023-04-17 08:24,910641,229393,482910,198338,910641
2023-04-17 08:25,910662,229414,482910,198338,910662
2023-04-17 08:26,910684,229433,482912,198339,910684
2023-04-17 08:27,910706,229455,482912,198339,910706
2023-04-17 08:28,910728,229470,482914,198344,910728
2023-04-17 08:29,910749,229491,482914,198344,910749
2023-04-17 08:30,910771,229509,482917,198345,910771
2023-04-17 08:31,910795,229532,482917,198346,910795
2023-04-17 08:32,910816,229548,482919,198349,910816
2023-04-17 08:33,910837,229567,482919,198351,910837
2023-04-17 08:34,910860,229584,482921,198355,910860
2023-04-17 08:35,910882,229606,482921,198355,910882
2023-04-17 08:36,910904,229624,482924,198356,910904
2023-04-17 08:37,910928,229647,482925,198356,910928
2023-04-17 08:38,910948,229667,482925,198356,910948
2023-04-17 08:40,910970,229683,482926,198361,910970
2023-04-17 08:41,910993,229705,482926,198362,910993
2023-04-17 08:42,911015,229724,482927,198364,911015
2023-04-17 08:43,911037,229745,482927,198365,911037
2023-04-17 08:44,911059,229766,482928,198365,911059
2023-04-17 08:45,911082,229788,482928,198366,911082
2023-04-17 08:46,911103,229805,482930,198368,911103
2023-04-17 08:47,911125,229824,482930,198371,911125
2023-04-17 08:48,911149,229846,482931,198372,911149
2023-04-17 08:49,911169,229865,482931,198373,911169
2023-04-17 08:50,911192,229888,482931,198373,911192
2023-04-17 08:51,911215,229910,482931,198374,911215
2023-04-17 08:52,911236,229931,482931,198374,911236
2023-04-17 08:53,911259,229952,482931,198376,911259
2023-04-17 08:54,911280,229971,482931,198378,911280
2023-04-17 08:55,911304,229995,482931,198378,911304
2023-04-17 08:56,911326,230016,482931,198379,911326
2023-04-17 08:57,911347,230031,482936,198380,911347
2023-04-17 08:58,911369,230053,482936,198380,911369
2023-04-17 08:59,911390,230074,482936,198380,911390
2023-04-17 09:00,911413,230095,482936,198382,911413
2023-04-17 09:01,911435,230116,482936,198383,911435
2023-04-17 09:02,911457,230138,482936,198383,911457
2023-04-17 09:03,911479,230159,482937,198383,911479
2023-04-17 09:04,911503,230181,482937,198385,911503
2023-04-17 09:05,911525,230200,482937,198388,911525
2023-04-17 09:06,911548,230221,482937,198390,911548
2023-04-17 09:07,911572,230244,482937,198391,911572
2023-04-17 09:08,911595,230265,482937,198393,911595
2023-04-17 09:09,911617,230282,482939,198396,911617
2023-04-17 09:10,911642,230304,482940,198398,911642
2023-04-17 09:11,911663,230324,482940,198399,911663
2023-04-17 09:12,911687,230345,482941,198401,911687
2023-04-17 09:13,911709,230365,482941,198403,911709
2023-04-17 09:14,911731,230385,482942,198404,911731
2023-04-17 09:15,911753,230404,482942,198407,911753
2023-04-17 09:16,911778,230425,482946,198407,911778
2023-04-17 09:17,911800,230446,482946,198408,911800
2023-04-17 09:18,911823,230467,482948,198408,911823
2023-04-17 09:19,911844,230488,482948,198408,911844
2023-04-17 09:20,911868,230509,482950,198409,911868
2023-04-17 09:21,911889,230529,482950,198410,911889
2023-04-17 09:22,911912,230551,482950,198411,911912
2023-04-17 09:23,911935,230571,482950,198414,911935
2023-04-17 09:24,911956,230590,482951,198415,911956
2023-04-17 09:25,911979,230613,482951,198415,911979
2023-04-17 09:27,912001,230631,482953,198417,912001
2023-04-17 09:28,912023,230653,482953,198417,912023
2023-04-17 09:29,912048,230677,482954,198417,912048
2023-04-17 09:30,912069,230695,482954,198420,912069
2023-04-17 09:31,912093,230717,482956,198420,912093
2023-04-17 09:32,912116,230739,482956,198421,912116
2023-04-17 09:33,912137,230754,482960,198423,912137
2023-04-17 09:34,912161,230777,482960,198424,912161
2023-04-17 09:35,912183,230794,482962,198427,912183
2023-04-17 09:36,912205,230813,482962,198430,912205
2023-04-17 09:37,912227,230831,482964,198432,912227
2023-04-17 09:38,912249,230851,482964,198434,912249
2023-04-17 09:39,912273,230875,482965,198433,912273
2023-04-17 09:40,912294,230895,482965,198434,912294
2023-04-17 09:41,912318,230916,482966,198436,912318
2023-04-17 09:42,912342,230939,482966,198437,912342
2023-04-17 09:43,912363,230958,482967,198438,912363
2023-04-17 09:44,912386,230979,482968,198439,912386
2023-04-17 09:45,912409,231001,482968,198440,912409
2023-04-17 09:46,912433,231020,482972,198441,912433
2023-04-17 09:47,912455,231039,482972,198444,912455
2023-04-17 09:48,912479,231059,482975,198445,912479
2023-04-17 09:49,912501,231081,482975,198445,912501
2023-04-17 09:50,912525,231102,482978,198445,912525
2023-04-17 09:51,912547,231122,482978,198447,912547
2023-04-17 09:52,912570,231141,482980,198449,912570
2023-04-17 09:53,912592,231162,482980,198450,912592
2023-04-17 09:54,912614,231178,482983,198453,912614
2023-04-17 09:55,912638,231200,482983,198455,912638
2023-04-17 09:56,912660,231221,482984,198455,912660
2023-04-17 09:57,912682,231241,482984,198457,912682
2023-04-17 09:58,912705,231261,482985,198459,912705
2023-04-17 09:59,912727,231281,482985,198461,912727
2023-04-17 10:00,912740,231294,482985,198461,912740
2023-04-17 10:01,912749,231302,482985,198462,912749
2023-04-17 10:02,912758,231305,482988,198465,912758
2023-04-17 10:03,912767,231312,482988,198467,912767
2023-04-17 10:04,912775,231319,482989,198467,912775
2023-04-17 10:05,912784,231328,482989,198467,912784
2023-04-17 10:06,912794,231337,482990,198467,912794
2023-04-17 10:07,912803,231344,482990,198469,912803
2023-04-17 10:08,912812,231353,482991,198468,912812
2023-04-17 10:09,912822,231362,482991,198469,912822
2023-04-17 10:10,912832,231369,482992,198471,912832
2023-04-17 10:11,912840,231377,482992,198471,912840
2023-04-17 10:12,912850,231384,482993,198473,912850
2023-04-17 10:14,912859,231392,482993,198474,912859
2023-04-17 10:15,912868,231397,482996,198475,912868
2023-04-17 10:16,912877,231405,482996,198476,912877
2023-04-17 10:17,912886,231410,482998,198478,912886
2023-04-17 10:18,912895,231418,482998,198479,912895
2023-04-17 10:19,912907,231428,482999,198480,912907
2023-04-17 10:20,912915,231435,482999,198481,912915
2023-04-17 10:21,912924,231443,483000,198481,912924
2023-04-17 10:22,912932,231449,483000,198483,912932
2023-04-17 10:23,912942,231454,483005,198483,912942
2023-04-17 10:24,912951,231463,483005,198483,912951
2023-04-17 10:25,912960,231470,483006,198484,912960
2023-04-17 10:26,912969,231478,483006,198485,912969
2023-04-17 10:27,912978,231483,483010,198485,912978
2023-04-17 10:28,912989,231493,483010,198486,912989
2023-04-17 10:29,912997,231493,483013,198491,912997
2023-04-17 10:30,913008,231505,483013,198490,913008
2023-04-17 10:31,913017,231508,483015,198494,913017
2023-04-17 10:32,913025,231515,483015,198495,913025
2023-04-17 10:33,913034,231518,483019,198497,913034
2023-04-17 10:34,913043,231527,483019,198497,913043
2023-04-17 10:35,913052,231534,483020,198498,913052
2023-04-17 10:36,913061,231541,483020,198500,913061
2023-04-17 10:37,913069,231542,483024,198503,913069
2023-04-17 10:38,913078,231551,483024,198503,913078
2023-04-17 10:39,913088,231555,483028,198505,913088
2023-04-17 10:40,913097,231562,483028,198507,913097
2023-04-17 10:41,913106,231562,483035,198509,913106
2023-04-17 10:42,913115,231569,483035,198511,913115
2023-04-17 10:43,913124,231575,483037,198512,913124
2023-04-17 10:44,913135,231584,483037,198514,913135
2023-04-17 10:45,913146,231589,483041,198516,913146
2023-04-17 10:46,913156,231598,483041,198517,913156
2023-04-17 10:47,913165,231603,483043,198519,913165
2023-04-17 10:48,913173,231610,483043,198520,913173
2023-04-17 10:49,913182,231619,483043,198520,913182
2023-04-17 10:50,913193,231628,483043,198522,913193
2023-04-17 10:51,913202,231634,483045,198523,913202
2023-04-17 10:52,913211,231642,483045,198524,913211
2023-04-17 10:53,913220,231645,483048,198527,913220
2023-04-17 10:54,913229,231653,483048,198528,913229
2023-04-17 10:55,913237,231655,483052,198530,913237
2023-04-17 10:56,913246,231661,483052,198533,913246
2023-04-17 10:57,913255,231667,483054,198534,913255
2023-04-17 10:58,913264,231675,483054,198535,913264
2023-04-17 10:59,913274,231681,483057,198536,913274
2023-04-17 11:01,913294,231698,483057,198539,913294
2023-04-17 11:02,913315,231715,483058,198542,913315
2023-04-17 11:03,913338,231730,483062,198546,913338
2023-04-17 11:04,913359,231750,483062,198547,913359
2023-04-17 11:05,913381,231770,483064,198547,913381
2023-04-17 11:06,913403,231790,483064,198549,913403
2023-04-17 11:07,913423,231806,483065,198552,913423
2023-04-17 11:08,913445,231827,483065,198553,913445
2023-04-17 11:09,913466,231843,483069,198554,913466
2023-04-17 11:10,913487,231861,483071,198555,913487
2023-04-17 11:11,913509,231884,483070,198555,913509
2023-04-17 11:12,913531,231902,483072,198557,913531
2023-04-17 11:13,913554,231925,483072,198557,913554
2023-04-17 11:14,913576,231938,483078,198560,913576
2023-04-17 11:15,913597,231957,483078,198562,913597
2023-04-17 11:16,913620,231972,483084,198564,913620
2023-04-17 11:17,913642,231990,483084,198568,913642
2023-04-17 11:18,913663,232011,483084,198568,913663
2023-04-17 11:19,913684,232029,483084,198571,913684
2023-04-17 11:20,913706,232049,483086,198571,913706
2023-04-17 11:21,913728,232070,483086,198572,913728
2023-04-17 11:22,913748,232088,483086,198574,913748
2023-04-17 11:23,913769,232109,483086,198574,913769
2023-04-17 11:24,913791,232123,483089,198579,913791
2023-04-17 11:25,913813,232141,483089,198583,913813
2023-04-17 11:26,913835,232161,483089,198585,913835
2023-04-17 11:27,913856,232177,483089,198590,913856
2023-04-17 11:28,913877,232196,483089,198592,913877
2023-04-17 11:29,913899,232217,483089,198593,913899
2023-04-17 11:30,913919,232235,483089,198595,913919
2023-04-17 11:31,913941,232256,483089,198596,913941
2023-04-17 11:32,913963,232275,483090,198598,913963
2023-04-17 11:33,913983,232292,483090,198601,913983
2023-04-17 11:34,914006,232312,483090,198604,914006
2023-04-17 11:35,914026,232331,483090,198605,914026
2023-04-17 11:36,914049,232350,483092,198607,914049
2023-04-17 11:37,914071,232370,483092,198609,914071
2023-04-17 11:38,914091,232387,483094,198610,914091
2023-04-17 11:39,914112,232407,483094,198611,914112
2023-04-17 11:40,914134,232423,483098,198613,914134
2023-04-17 11:41,914157,232445,483098,198614,914157
2023-04-17 11:42,914178,232462,483099,198617,914178
2023-04-17 11:43,914200,232484,483099,198617,914200
2023-04-17 11:44,914220,232500,483101,198619,914220
2023-04-17 11:45,914244,232522,483101,198621,914244
2023-04-17 11:46,914264,232540,483101,198623,914264
2023-04-17 11:47,914285,232557,483101,198627,914285
2023-04-17 11:49,914307,232573,483105,198629,914307
2023-04-17 11:50,914329,232592,483107,198630,914329
2023-04-17 11:51,914351,232613,483107,198631,914351
2023-04-17 11:52,914373,232634,483106,198633,914373
2023-04-17 11:53,914394,232652,483106,198636,914394
2023-04-17 11:54,914415,232667,483110,198638,914415
2023-04-17 11:55,914438,232689,483110,198639,914438
2023-04-17 11:56,914459,232704,483114,198641,914459
2023-04-17 11:57,914481,232723,483115,198643,914481
2023-04-17 11:58,914504,232744,483115,198645,914504
2023-04-17 11:59,914525,232763,483115,198647,914525
2023-04-17 12:00,914545,232776,483118,198651,914545
2023-04-17 12:01,914556,232787,483118,198651,914556
2023-04-17 12:02,914568,232793,483121,198654,914568
2023-04-17 12:03,914578,232803,483121,198654,914578
2023-04-17 12:04,914590,232813,483123,198654,914590
2023-04-17 12:05,914601,232819,483127,198655,914601
2023-04-17 12:06,914611,232828,483127,198656,914611
2023-04-17 12:07,914622,232835,483130,198657,914622
2023-04-17 12:08,914633,232845,483130,198658,914633
2023-04-17 12:09,914645,232853,483132,198660,914645
2023-04-17 12:10,914655,232860,483132,198663,914655
2023-04-17 12:11,914667,232870,483132,198665,914667
2023-04-17 12:12,914677,232879,483132,198666,914677
2023-04-17 12:13,914688,232889,483133,198666,914688
2023-04-17 12:14,914699,232896,483133,198670,914699
2023-04-17 12:15,914710,232904,483135,198671,914710
2023-04-17 12:16,914721,232914,483135,198672,914721
2023-04-17 12:17,914732,232916,483142,198674,914732
2023-04-17 12:18,914743,232926,483142,198675,914743
2023-04-17 12:19,914755,232932,483145,198678,914755
2023-04-17 12:20,914765,232940,483145,198680,914765
2023-04-17 12:21,914778,232951,483147,198680,914778
2023-04-17 12:22,914789,232961,483147,198681,914789
2023-04-17 12:23,914800,232965,483152,198683,914800
2023-04-17 12:24,914811,232975,483152,198684,914811
2023-04-17 12:25,914822,232980,483156,198686,914822
2023-04-17 12:26,914833,232990,483156,198687,914833
2023-04-17 12:27,914844,232995,483159,198690,914844
2023-04-17 12:28,914856,233007,483159,198690,914856
2023-04-17 12:29,914866,233008,483168,198690,914866
2023-04-17 12:30,914877,233018,483168,198691,914877
2023-04-17 12:31,914888,233019,483176,198693,914888
2023-04-17 12:32,914899,233026,483176,198697,914899
2023-04-17 12:33,914911,233034,483179,198698,914911
2023-04-17 12:34,914922,233045,483179,198698,914922
2023-04-17 12:36,914935,233052,483185,198698,914935
2023-04-17 12:37,914946,233063,483185,198698,914946
2023-04-17 12:38,914957,233063,483190,198704,914957
2023-04-17 12:39,914968,233068,483193,198707,914968
2023-04-17 12:40,914979,233079,483193,198707,914979
2023-04-17 12:41,914992,233089,483194,198709,914992
2023-04-17 12:42,915002,233099,483194,198709,915002
2023-04-17 12:43,915013,233108,483195,198710,915013
2023-04-17 12:44,915025,233118,483195,198712,915025
2023-04-17 12:45,915035,233126,483197,198712,915035
2023-04-17 12:46,915047,233137,483197,198713,915047
2023-04-17 12:47,915059,233144,483202,198713,915059
2023-04-17 12:48,915070,233152,483202,198716,915070
2023-04-17 12:49,915081,233162,483203,198716,915081
2023-04-17 12:50,915093,233172,483203,198718,915093
2023-04-17 12:51,915104,233173,483211,198720,915104
2023-04-17 12:52,915116,233185,483211,198720,915116
2023-04-17 12:53,915128,233196,483210,198722,915128
2023-04-17 12:54,915139,233206,483210,198723,915139
2023-04-17 12:55,915150,233212,483213,198725,915150
2023-04-17 12:56,915162,233219,483215,198728,915162
2023-04-17 12:57,915172,233228,483215,198729,915172
2023-04-17 12:58,915185,233241,483213,198731,915185
2023-04-17 12:59,915196,233252,483213,198731,915196
2023-04-17 13:00,915206,233259,483214,198733,915206
2023-04-17 13:01,915214,233266,483214,198734,915214
2023-04-17 13:02,915222,233271,483214,198737,915222
2023-04-17 13:03,915230,233278,483214,198738,915230
2023-04-17 13:04,915238,233279,483218,198741,915238
2023-04-17 13:05,915246,233284,483218,198744,915246
2023-04-17 13:06,915254,233288,483221,198745,915254
2023-04-17 13:07,915263,233297,483221,198745,915263
2023-04-17 13:08,915271,233299,483225,198747,915271
2023-04-17 13:09,915279,233306,483225,198748,915279
2023-04-17 13:10,915287,233307,483231,198749,915287
2023-04-17 13:11,915295,233314,483231,198750,915295
2023-04-17 13:12,915304,233319,483234,198751,915304
2023-04-17 13:13,915313,233324,483234,198755,915313
2023-04-17 13:14,915321,233328,483236,198757,915321
2023-04-17 13:15,915330,233336,483236,198758,915330
2023-04-17 13:16,915338,233338,483239,198761,915338
2023-04-17 13:17,915347,233346,483239,198762,915347
2023-04-17 13:18,915356,233348,483244,198764,915356
2023-04-17 13:19,915365,233357,483244,198764,915365
2023-04-17 13:20,915373,233358,483248,198767,915373
2023-04-17 13:21,915382,233365,483248,198769,915382
2023-04-17 13:23,915391,233369,483251,198771,915391
2023-04-17 13:24,915399,233377,483251,198771,915399
2023-04-17 13:25,915407,233379,483256,198772,915407
2023-04-17 13:26,915415,233384,483256,198775,915415
2023-04-17 13:27,915423,233390,483256,198777,915423
2023-04-17 13:28,915431,233396,483256,198779,915431
2023-04-17 13:29,915439,233404,483256,198779,915439
2023-04-17 13:30,915447,233411,483256,198780,915447
2023-04-17 13:31,915455,233417,483256,198782,915455
2023-04-17 13:32,915463,233422,483256,198785,915463
2023-04-17 13:33,915470,233429,483256,198785,915470
2023-04-17 13:34,915479,233437,483256,198786,915479
2023-04-17 13:35,915486,233428,483271,198787,915486
2023-04-17 13:36,915494,233434,483271,198789,915494
2023-04-17 13:37,915502,233436,483275,198791,915502
2023-04-17 13:38,915510,233443,483275,198792,915510
2023-04-17 13:39,915519,233449,483278,198792,915519
2023-04-17 13:40,915527,233454,483281,198792,915527
2023-04-17 13:41,915536,233462,483281,198793,915536
2023-04-17 13:42,915544,233466,483283,198795,915544
2023-04-17 13:43,915552,233472,483283,198797,915552
2023-04-17 13:44,915561,233473,483286,198802,915561
2023-04-17 13:45,915568,233479,483286,198803,915568
2023-04-17 13:46,915579,233484,483289,198806,915579
2023-04-17 13:47,915587,233489,483289,198809,915587
2023-04-17 13:48,915596,233491,483293,198812,915596
2023-04-17 13:49,915603,233497,483293,198813,915603
2023-04-17 13:50,915611,233504,483293,198814,915611
2023-04-17 13:51,915619,233511,483293,198815,915619
2023-04-17 13:52,915627,233515,483295,198817,915627
2023-04-17 13:53,915636,233524,483295,198817,915636
2023-04-17 13:54,915644,233524,483300,198820,915644
2023-04-17 13:55,915652,233531,483300,198821,915652
2023-04-17 13:56,915660,233533,483305,198822,915660
2023-04-17 13:57,915668,233536,483305,198827,915668
2023-04-17 13:58,915676,233538,483309,198829,915676
2023-04-17 13:59,915685,233545,483309,198831,915685
2023-04-17 14:00,915697,233555,483311,198831,915697
2023-04-17 14:01,915709,233566,483311,198832,915709
2023-04-17 14:02,915721,233572,483315,198834,915721
2023-04-17 14:03,915734,233582,483316,198836,915734
2023-04-17 14:04,915747,233594,483316,198837,915747
2023-04-17 14:05,915760,233604,483319,198837,915760
2023-04-17 14:06,915772,233616,483319,198837,915772
2023-04-17 14:07,915785,233626,483321,198838,915785
2023-04-17 14:08,915798,233638,483321,198839,915798
2023-04-17 14:10,915812,233648,483324,198840,915812
2023-04-17 14:11,915824,233659,483324,198841,915824
2023-04-17 14:12,915837,233669,483325,198843,915837
2023-04-17 14:13,915849,233681,483325,198843,915849
2023-04-17 14:14,915863,233695,483325,198843,915863
2023-04-17 14:15,915875,233707,483325,198843,915875
2023-04-17 14:16,915888,233719,483325,198844,915888
2023-04-17 14:17,915903,233734,483325,198844,915903
2023-04-17 14:18,915914,233743,483325,198846,915914
2023-04-17 14:19,915927,233749,483332,198846,915927
2023-04-17 14:20,915940,233761,483332,198847,915940
2023-04-17 14:21,915954,233772,483333,198849,915954
2023-04-17 14:22,915966,233782,483333,198851,915966
2023-04-17 14:23,915979,233789,483337,198853,915979
2023-04-17 14:24,915991,233800,483337,198854,915991
2023-04-17 14:25,916004,233812,483338,198854,916004
2023-04-17 14:26,916016,233821,483339,198856,916016
2023-04-17 14:27,916029,233831,483339,198859,916029
2023-04-17 14:28,916041,233840,483341,198860,916041
2023-04-17 14:29,916053,233851,483341,198861,916053
2023-04-17 14:30,916067,233859,483344,198864,916067
2023-04-17 14:31,916080,233869,483344,198867,916080
2023-04-17 14:32,916092,233877,483345,198870,916092
2023-04-17 14:33,916106,233890,483345,198871,916106
2023-04-17 14:34,916119,233900,483347,198872,916119
2023-04-17 14:35,916131,233911,483347,198873,916131
2023-04-17 14:36,916143,233919,483350,198874,916143
2023-04-17 14:37,916155,233930,483350,198875,916155
2023-04-17 14:38,916167,233940,483352,198875,916167
2023-04-17 14:39,916180,233952,483352,198876,916180
2023-04-17 14:40,916193,233960,483355,198878,916193
2023-04-17 14:41,916205,233972,483355,198878,916205
2023-04-17 14:42,916218,233979,483360,198879,916218
2023-04-17 14:43,916230,233991,483360,198879,916230
2023-04-17 14:44,916243,233999,483363,198881,916243
2023-04-17 14:45,916255,234010,483363,198882,916255
2023-04-17 14:46,916267,234021,483363,198883,916267
2023-04-17 14:47,916280,234032,483363,198885,916280
2023-04-17 14:48,916292,234044,483363,198885,916292
2023-04-17 14:49,916304,234053,483363,198888,916304
2023-04-17 14:50,916317,234065,483363,198889,916317
2023-04-17 14:51,916329,234076,483363,198890,916329
2023-04-17 14:52,916344,234089,483363,198892,916344
2023-04-17 14:53,916356,234101,483363,198892,916356
2023-04-17 14:54,916368,234104,483371,198893,916368
2023-04-17 14:55,916381,234112,483374,198895,916381
2023-04-17 14:57,916393,234123,483374,198896,916393
2023-04-17 14:58,916406,234129,483380,198897,916406
2023-04-17 14:59,916418,234140,483380,198898,916418
2023-04-17 15:00,916431,234147,483383,198901,916431
2023-04-17 15:01,916443,234159,483383,198901,916443
2023-04-17 15:02,916454,234167,483385,198902,916454
2023-04-17 15:03,916464,234174,483388,198902,916464
2023-04-17 15:04,916475,234185,483388,198902,916475
2023-04-17 15:05,916486,234193,483390,198903,916486
2023-04-17 15:06,916497,234203,483391,198903,916497
2023-04-17 15:07,916508,234214,483391,198903,916508
2023-04-17 15:08,916519,234213,483399,198907,916519
2023-04-17 15:09,916529,234223,483399,198907,916529
2023-04-17 15:10,916540,234232,483400,198908,916540
2023-04-17 15:11,916553,234244,483400,198909,916553
2023-04-17 15:12,916563,234250,483402,198911,916563
2023-04-17 15:13,916576,234261,483402,198913,916576
2023-04-17 15:14,916588,234269,483405,198914,916588
2023-04-17 15:15,916598,234277,483405,198916,916598
2023-04-17 15:16,916610,234289,483405,198916,916610
2023-04-17 15:17,916621,234299,483405,198917,916621
2023-04-17 15:18,916632,234305,483410,198917,916632
2023-04-17 15:19,916643,234313,483410,198920,916643
2023-04-17 15:20,916655,234322,483412,198921,916655
2023-04-17 15:21,916665,234332,483412,198921,916665
2023-04-17 15:22,916676,234340,483414,198922,916676
2023-04-17 15:23,916687,234351,483414,198922,916687
2023-04-17 15:24,916699,234358,483418,198923,916699
2023-04-17 15:25,916711,234370,483418,198923,916711
2023-04-17 15:26,916722,234379,483421,198922,916722
2023-04-17 15:27,916733,234387,483421,198925,916733
2023-04-17 15:28,916744,234392,483425,198927,916744
2023-04-17 15:29,916754,234398,483425,198931,916754
2023-04-17 15:30,916765,234402,483430,198933,916765
2023-04-17 15:31,916776,234413,483430,198933,916776
2023-04-17 15:32,916787,234421,483432,198934,916787
2023-04-17 15:33,916797,234430,483432,198935,916797
2023-04-17 15:34,916811,234443,483432,198936,916811
2023-04-17 15:35,916821,234451,483432,198938,916821
2023-04-17 15:36,916832,234457,483434,198941,916832
2023-04-17 15:37,916844,234467,483434,198943,916844
2023-04-17 15:38,916855,234477,483434,198944,916855
2023-04-17 15:39,916865,234482,483437,198946,916865
2023-04-17 15:40,916876,234491,483437,198948,916876
2023-04-17 15:41,916887,234500,483437,198950,916887
2023-04-17 15:42,916898,234510,483437,198951,916898
2023-04-17 15:43,916910,234521,483437,198952,916910
2023-04-17 15:45,916923,234532,483437,198954,916923
2023-04-17 15:46,916934,234540,483438,198956,916934
2023-04-17 15:47,916946,234552,483438,198956,916946
2023-04-17 15:48,916957,234558,483442,198957,916957
2023-04-17 15:49,916967,234565,483442,198960,916967
2023-04-17 15:50,916978,234571,483446,198961,916978
2023-04-17 15:51,916990,234581,483446,198963,916990
2023-04-17 15:52,917001,234591,483447,198963,917001
2023-04-17 15:53,917012,234601,483447,198964,917012
2023-04-17 15:54,917022,234609,483448,198965,917022
2023-04-17 15:55,917034,234618,483448,198968,917034
2023-04-17 15:56,917045,234628,483449,198968,917045
2023-04-17 15:57,917056,234638,483449,198969,917056
2023-04-17 15:58,917067,234645,483449,198973,917067
2023-04-17 15:59,917078,234657,483449,198972,917078
2023-04-17 16:00,917092,234670,483449,198973,917092
2023-04-17 16:01,917111,234689,483449,198973,917111
2023-04-17 16:02,917132,234706,483450,198976,917132
2023-04-17 16:03,917151,234725,483450,198976,917151
2023-04-17 16:04,917174,234746,483451,198977,917174
2023-04-17 16:05,917194,234764,483451,198979,917194
2023-04-17 16:06,917214,234782,483452,198980,917214
2023-04-17 16:07,917235,234800,483454,198981,917235
2023-04-17 16:08,917254,234817,483454,198983,917254
2023-04-17 16:09,917274,234834,483456,198984,917274
2023-04-17 16:10,917294,234853,483456,198985,917294
2023-04-17 16:11,917315,234868,483460,198987,917315
2023-04-17 16:12,917334,234887,483460,198987,917334
2023-04-17 16:13,917353,234900,483465,198988,917353
2023-04-17 16:14,917374,234921,483465,198988,917374
2023-04-17 16:15,917394,234939,483465,198990,917394
2023-04-17 16:16,917414,234958,483466,198990,917414
2023-04-17 16:17,917434,234976,483466,198992,917434
2023-04-17 16:18,917453,234991,483468,198994,917453
2023-04-17 16:19,917473,235009,483468,198996,917473
2023-04-17 16:20,917494,235028,483469,198997,917494
2023-04-17 16:21,917514,235045,483469,199000,917514
2023-04-17 16:22,917534,235061,483472,199001,917534
2023-04-17 16:23,917553,235078,483472,199003,917553
2023-04-17 16:24,917574,235094,483477,199003,917574
2023-04-17 16:25,917594,235110,483481,199003,917594
2023-04-17 16:26,917614,235128,483481,199005,917614
2023-04-17 16:27,917635,235146,483482,199007,917635
2023-04-17 16:28,917654,235164,483482,199008,917654
2023-04-17 16:29,917675,235181,483484,199010,917675
2023-04-17 16:30,917694,235200,483484,199010,917694
2023-04-17 16:32,917714,235217,483486,199011,917714
2023-04-17 16:33,917734,235234,483486,199014,917734
2023-04-17 16:34,917755,235251,483489,199015,917755
2023-04-17 16:35,917774,235270,483489,199015,917774
2023-04-17 16:36,917794,235284,483492,199018,917794
2023-04-17 16:37,917814,235303,483492,199019,917814
2023-04-17 16:38,917834,235322,483493,199019,917834
2023-04-17 16:39,917854,235340,483493,199021,917854
2023-04-17 16:40,917872,235356,483494,199022,917872
2023-04-17 16:41,917892,235376,483494,199022,917892
2023-04-17 16:42,917914,235396,483494,199024,917914
2023-04-17 16:43,917934,235414,483494,199026,917934
2023-04-17 16:44,917955,235433,483495,199027,917955
2023-04-17 16:45,917976,235453,483495,199028,917976
2023-04-17 16:46,917996,235470,483499,199027,917996
2023-04-17 16:47,918016,235488,483499,199029,918016
2023-04-17 16:48,918036,235506,483501,199029,918036
2023-04-17 16:49,918057,235526,483502,199029,918057
2023-04-17 16:50,918076,235544,483502,199030,918076
2023-04-17 16:51,918097,235557,483506,199034,918097
2023-04-17 16:52,918118,235576,483506,199036,918118
2023-04-17 16:53,918138,235589,483510,199039,918138
2023-04-17 16:54,918157,235605,483510,199042,918157
2023-04-17 16:55,918176,235620,483511,199045,918176
2023-04-17 16:56,918196,235638,483511,199047,918196
2023-04-17 16:57,918216,235654,483514,199048,918216
2023-04-17 16:58,918236,235672,483514,199050,918236
2023-04-17 16:59,918257,235689,483517,199051,918257
2023-04-17 17:00,918273,235703,483517,199053,918273
2023-04-17 17:01,918287,235712,483519,199056,918287
2023-04-17 17:02,918301,235724,483519,199058,918301
2023-04-17 17:03,918316,235735,483523,199058,918316
2023-04-17 17:04,918329,235746,483523,199060,918329
2023-04-17 17:05,918344,235758,483526,199060,918344
2023-04-17 17:06,918358,235772,483526,199060,918358
2023-04-17 17:07,918371,235780,483530,199061,918371
2023-04-17 17:08,918385,235790,483532,199063,918385
2023-04-17 17:09,918398,235803,483532,199063,918398
2023-04-17 17:10,918412,235814,483534,199064,918412
2023-04-17 17:11,918426,235827,483534,199065,918426
2023-04-17 17:12,918440,235836,483536,199068,918440
2023-04-17 17:13,918455,235851,483536,199068,918455
2023-04-17 17:14,918470,235863,483537,199070,918470
2023-04-17 17:15,918484,235875,483537,199072,918484
2023-04-17 17:16,918497,235883,483539,199075,918497
2023-04-17 17:17,918513,235899,483539,199075,918513
2023-04-17 17:19,918526,235908,483539,199079,918526
2023-04-17 17:20,918540,235920,483539,199081,918540
2023-04-17 17:21,918554,235931,483541,199082,918554
2023-04-17 17:22,918567,235943,483541,199083,918567
2023-04-17 17:23,918581,235954,483542,199085,918581
2023-04-17 17:24,918594,235962,483546,199086,918594
2023-04-17 17:25,918608,235975,483546,199087,918608
2023-04-17 17:26,918622,235986,483548,199088,918622
2023-04-17 17:27,918635,235997,483548,199090,918635
2023-04-17 17:28,918648,236006,483552,199090,918648
2023-04-17 17:29,918662,236020,483552,199090,918662
2023-04-17 17:30,918676,236029,483556,199091,918676
2023-04-17 17:31,918689,236041,483556,199092,918689
2023-04-17 17:32,918703,236051,483558,199094,918703
2023-04-17 17:33,918716,236062,483558,199096,918716
2023-04-17 17:34,918732,236075,483559,199098,918732
2023-04-17 17:35,918745,236082,483561,199102,918745
2023-04-17 17:36,918758,236096,483561,199101,918758
2023-04-17 17:37,918773,236106,483565,199102,918773
2023-04-17 17:38,918787,236120,483565,199102,918787
2023-04-17 17:39,918801,236128,483569,199104,918801
2023-04-17 17:40,918815,236142,483569,199104,918815
2023-04-17 17:41,918828,236152,483571,199105,918828
2023-04-17 17:42,918843,236167,483571,199105,918843
2023-04-17 17:43,918858,236177,483576,199105,918858
2023-04-17 17:44,918871,236188,483576,199107,918871
2023-04-17 17:45,918886,236200,483578,199108,918886
2023-04-17 17:46,918902,236215,483578,199109,918902
2023-04-17 17:47,918916,236227,483580,199109,918916
2023-04-17 17:48,918929,236235,483584,199110,918929
2023-04-17 17:49,918944,236249,483584,199111,918944
2023-04-17 17:50,918957,236259,483585,199113,918957
2023-04-17 17:51,918972,236274,483585,199113,918972
2023-04-17 17:52,918985,236282,483590,199113,918985
2023-04-17 17:53,919001,236291,483593,199117,919001
2023-04-17 17:54,919014,236303,483593,199118,919014
2023-04-17 17:55,919027,236316,483593,199118,919027
2023-04-17 17:56,919041,236330,483593,199118,919041
2023-04-17 17:57,919055,236343,483594,199118,919055
2023-04-17 17:58,919068,236355,483594,199119,919068
2023-04-17 17:59,919081,236363,483596,199122,919081
2023-04-17 18:00,919101,236381,483596,199124,919101
2023-04-17 18:01,919121,236397,483599,199125,919121
2023-04-17 18:02,919141,236414,483599,199128,919141
2023-04-17 18:03,919160,236428,483602,199130,919160
2023-04-17 18:04,919181,236445,483606,199130,919181
2023-04-17 18:05,919201,236461,483607,199133,919201
2023-04-17 18:07,919223,236480,483607,199136,919223
2023-04-17 18:08,919242,236495,483610,199137,919242
2023-04-17 18:09,919262,236515,483610,199137,919262
2023-04-17 18:10,919286,236533,483613,199140,919286
2023-04-17 18:11,919306,236553,483613,199140,919306
2023-04-17 18:12,919325,236568,483616,199141,919325
2023-04-17 18:13,919345,236588,483616,199141,919345
2023-04-17 18:14,919365,236606,483618,199141,919365
2023-04-17 18:15,919385,236622,483618,199145,919385
2023-04-17 18:16,919406,236637,483623,199146,919406
2023-04-17 18:17,919426,236657,483623,199146,919426
2023-04-17 18:18,919447,236672,483626,199149,919447
2023-04-17 18:19,919466,236688,483626,199152,919466
2023-04-17 18:20,919488,236708,483628,199152,919488
2023-04-17 18:21,919508,236723,483631,199154,919508
2023-04-17 18:22,919528,236741,483634,199153,919528
2023-04-17 18:23,919547,236759,483634,199154,919547
2023-04-17 18:24,919569,236781,483634,199154,919569
2023-04-17 18:25,919590,236799,483634,199157,919590
2023-04-17 18:26,919610,236816,483636,199158,919610
2023-04-17 18:27,919631,236837,483636,199158,919631
2023-04-17 18:28,919652,236853,483640,199159,919652
2023-04-17 18:29,919672,236874,483640,199158,919672
2023-04-17 18:30,919693,236891,483643,199159,919693
2023-04-17 18:31,919714,236911,483643,199160,919714
2023-04-17 18:32,919733,236925,483648,199160,919733
2023-04-17 18:33,919754,236945,483648,199161,919754
2023-04-17 18:34,919774,236961,483651,199162,919774
2023-04-17 18:35,919793,236976,483651,199166,919793
2023-04-17 18:36,919815,236993,483653,199169,919815
2023-04-17 18:37,919835,237013,483653,199169,919835
2023-04-17 18:38,919856,237027,483657,199172,919856
2023-04-17 18:39,919875,237046,483657,199172,919875
2023-04-17 18:40,919896,237064,483659,199173,919896
2023-04-17 18:41,919916,237082,483659,199175,919916
2023-04-17 18:42,919937,237102,483659,199176,919937
2023-04-17 18:43,919958,237118,483664,199176,919958
2023-04-17 18:44,919978,237137,483664,199177,919978
2023-04-17 18:45,919998,237156,483665,199177,919998
2023-04-17 18:46,920019,237175,483665,199179,920019
2023-04-17 18:47,920038,237186,483671,199181,920038
2023-04-17 18:48,920060,237208,483671,199181,920060
2023-04-17 18:49,920081,237222,483676,199183,920081
2023-04-17 18:50,920100,237241,483676,199183,920100
2023-04-17 18:51,920122,237262,483676,199184,920122
2023-04-17 18:52,920141,237279,483677,199185,920141
2023-04-17 18:53,920163,237297,483680,199186,920163
2023-04-17 18:55,920183,237315,483680,199188,920183
2023-04-17 18:56,920204,237326,483687,199191,920204
2023-04-17 18:57,920223,237342,483687,199194,920223
2023-04-17 18:58,920244,237358,483689,199197,920244
2023-04-17 18:59,920264,237377,483689,199198,920264
2023-04-17 19:00,920284,237394,483692,199198,920284
2023-04-17 19:01,920291,237399,483692,199200,920291
2023-04-17 19:02,920299,237404,483696,199199,920299
2023-04-17 19:03,920307,237412,483696,199199,920307
2023-04-17 19:04,920315,237414,483699,199202,920315
2023-04-17 19:05,920322,237415,483703,199204,920322
2023-04-17 19:06,920329,237421,483703,199205,920329
2023-04-17 19:07,920337,237426,483705,199206,920337
2023-04-17 19:08,920345,237431,483705,199209,920345
2023-04-17 19:09,920353,237434,483708,199211,920353
2023-04-17 19:10,920360,237439,483708,199213,920360
2023-04-17 19:11,920370,237447,483710,199213,920370
2023-04-17 19:12,920378,237453,483710,199215,920378
2023-04-17 19:13,920387,237455,483714,199218,920387
2023-04-17 19:14,920394,237458,483716,199220,920394
2023-04-17 19:15,920402,237463,483716,199223,920402
2023-04-17 19:16,920409,237466,483720,199223,920409
2023-04-17 19:17,920417,237472,483720,199225,920417
2023-04-17 19:18,920424,237476,483723,199225,920424
2023-04-17 19:19,920432,237483,483723,199226,920432
2023-04-17 19:20,920439,237485,483727,199227,920439
2023-04-17 19:21,920446,237489,483727,199230,920446
2023-04-17 19:22,920454,237490,483731,199233,920454
2023-04-17 19:23,920462,237498,483731,199233,920462
2023-04-17 19:24,920470,237500,483736,199234,920470
2023-04-17 19:25,920477,237505,483736,199236,920477
2023-04-17 19:26,920484,237504,483742,199238,920484
2023-04-17 19:27,920492,237512,483742,199238,920492
2023-04-17 19:28,920500,237519,483743,199238,920500
2023-04-17 19:29,920508,237524,483743,199241,920508
2023-04-17 19:30,920515,237530,483744,199241,920515
2023-04-17 19:31,920523,237535,483744,199244,920523
2023-04-17 19:32,920532,237540,483747,199245,920532
2023-04-17 19:33,920540,237544,483749,199247,920540
2023-04-17 19:34,920547,237550,483749,199248,920547
2023-04-17 19:35,920554,237555,483751,199248,920554
2023-04-17 19:36,920562,237558,483751,199253,920562
2023-04-17 19:37,920569,237562,483753,199254,920569
2023-04-17 19:38,920577,237569,483753,199255,920577
2023-04-17 19:39,920584,237572,483757,199255,920584
2023-04-17 19:40,920594,237581,483757,199256,920594
2023-04-17 19:42,920601,237586,483759,199256,920601
2023-04-17 19:43,920608,237593,483759,199256,920608
2023-04-17 19:44,920616,237599,483759,199258,920616
2023-04-17 19:45,920623,237604,483759,199260,920623
2023-04-17 19:46,920631,237612,483759,199260,920631
2023-04-17 19:47,920638,237619,483759,199260,920638
2023-04-17 19:48,920646,237625,483759,199262,920646
2023-04-17 19:49,920654,237629,483759,199266,920654
2023-04-17 19:50,920662,237636,483759,199267,920662
2023-04-17 19:51,920669,237640,483759,199270,920669
2023-04-17 19:52,920677,237627,483780,199270,920677
2023-04-17 19:53,920684,237633,483780,199271,920684
2023-04-17 19:54,920692,237638,483781,199273,920692
2023-04-17 19:55,920699,237645,483781,199273,920699
2023-04-17 19:56,920706,237648,483783,199275,920706
2023-04-17 19:57,920714,237656,483783,199275,920714
2023-04-17 19:58,920722,237663,483783,199276,920722
2023-04-17 19:59,920729,237669,483783,199277,920729
2023-04-17 20:00,920740,237678,483783,199279,920740
2023-04-17 20:01,920755,237692,483783,199280,920755
2023-04-17 20:02,920771,237706,483783,199282,920771
2023-04-17 20:03,920787,237720,483783,199284,920787
2023-04-17 20:04,920803,237732,483783,199288,920803
2023-04-17 20:05,920818,237744,483783,199291,920818
2023-04-17 20:06,920833,237743,483796,199294,920833
2023-04-17 20:07,920849,237758,483796,199295,920849
2023-04-17 20:08,920865,237773,483797,199295,920865
2023-04-17 20:09,920881,237786,483797,199298,920881
2023-04-17 20:10,920897,237794,483804,199299,920897
2023-04-17 20:11,920913,237808,483804,199301,920913
2023-04-17 20:12,920927,237822,483804,199301,920927
2023-04-17 20:13,920943,237837,483804,199302,920943
2023-04-17 20:14,920960,237851,483806,199303,920960
2023-04-17 20:15,920976,237867,483806,199303,920976
2023-04-17 20:16,920992,237878,483810,199304,920992
2023-04-17 20:17,921007,237890,483810,199307,921007
2023-04-17 20:18,921023,237900,483816,199307,921023
2023-04-17 20:19,921038,237915,483816,199307,921038
2023-04-17 20:20,921054,237927,483819,199308,921054
2023-04-17 20:21,921069,237941,483819,199309,921069
2023-04-17 20:22,921085,237955,483821,199309,921085
2023-04-17 20:23,921100,237969,483821,199310,921100
2023-04-17 20:24,921116,237984,483822,199310,921116
2023-04-17 20:25,921132,237998,483822,199312,921132
2023-04-17 20:26,921148,238010,483826,199312,921148
2023-04-17 20:28,921164,238025,483827,199312,921164
2023-04-17 20:29,921179,238038,483827,199314,921179
2023-04-17 20:30,921194,238049,483829,199316,921194
2023-04-17 20:31,921211,238064,483829,199318,921211
2023-04-17 20:32,921226,238070,483836,199320,921226
2023-04-17 20:33,921243,238085,483836,199322,921243
2023-04-17 20:34,921259,238098,483838,199323,921259
2023-04-17 20:35,921275,238111,483840,199324,921275
2023-04-17 20:36,921290,238122,483840,199328,921290
2023-04-17 20:37,921305,238133,483844,199328,921305
2023-04-17 20:38,921321,238147,483844,199330,921321
2023-04-17 20:39,921338,238161,483846,199331,921338
2023-04-17 20:40,921353,238173,483849,199331,921353
2023-04-17 20:41,921369,238188,483849,199332,921369
2023-04-17 20:42,921385,238201,483851,199333,921385
2023-04-17 20:43,921400,238213,483851,199336,921400
2023-04-17 20:44,921418,238230,483852,199336,921418
2023-04-17 20:45,921434,238241,483852,199341,921434
2023-04-17 20:46,921449,238253,483855,199341,921449
2023-04-17 20:47,921465,238267,483855,199343,921465
2023-04-17 20:48,921481,238277,483862,199342,921481
2023-04-17 20:49,921496,238292,483862,199342,921496
2023-04-17 20:50,921512,238304,483865,199343,921512
2023-04-17 20:51,921529,238318,483865,199346,921529
2023-04-17 20:52,921545,238326,483872,199347,921545
2023-04-17 20:53,921562,238342,483872,199348,921562
2023-04-17 20:54,921577,238354,483875,199348,921577
2023-04-17 20:55,921592,238369,483875,199348,921592
2023-04-17 20:56,921608,238379,483880,199349,921608
2023-04-17 20:57,921625,238396,483880,199349,921625
2023-04-17 20:58,921642,238411,483882,199349,921642
2023-04-17 20:59,921657,238424,483882,199351,921657
2023-04-17 21:00,921669,238434,483882,199353,921669
2023-04-17 21:01,921681,238444,483882,199355,921681
2023-04-17 21:02,921691,238449,483885,199357,921691
2023-04-17 21:03,921702,238455,483885,199362,921702
2023-04-17 21:04,921713,238458,483891,199364,921713
2023-04-17 21:05,921725,238466,483892,199367,921725
2023-04-17 21:06,921736,238476,483892,199368,921736
2023-04-17 21:07,921746,238482,483896,199368,921746
2023-04-17 21:08,921757,238490,483896,199371,921757
2023-04-17 21:09,921767,238496,483900,199371,921767
2023-04-17 21:10,921778,238506,483900,199372,921778
2023-04-17 21:11,921788,238514,483902,199372,921788
2023-04-17 21:12,921800,238523,483905,199372,921800
2023-04-17 21:14,921810,238533,483905,199372,921810
2023-04-17 21:15,921821,238543,483906,199372,921821
2023-04-17 21:16,921832,238550,483907,199375,921832
2023-04-17 21:17,921842,238551,483911,199380,921842
2023-04-17 21:18,921853,238561,483911,199381,921853
2023-04-17 21:19,921864,238566,483910,199388,921864
2023-04-17 21:20,921874,238576,483910,199388,921874
2023-04-17 21:21,921885,238582,483914,199389,921885
2023-04-17 21:22,921897,238591,483914,199392,921897
2023-04-17 21:23,921907,238594,483918,199395,921907
2023-04-17 21:24,921918,238603,483918,199397,921918
2023-04-17 21:25,921928,238605,483925,199398,921928
2023-04-17 21:26,921939,238612,483928,199399,921939
2023-04-17 21:27,921949,238621,483928,199400,921949
2023-04-17 21:28,921960,238629,483929,199402,921960
2023-04-17 21:29,921971,238638,483929,199404,921971
2023-04-17 21:30,921981,238642,483935,199404,921981
2023-04-17 21:31,921992,238653,483935,199404,921992
2023-04-17 21:32,922003,238660,483937,199406,922003
2023-04-17 21:33,922013,238668,483937,199408,922013
2023-04-17 21:34,922023,238675,483939,199409,922023
2023-04-17 21:35,922034,238682,483943,199409,922034
2023-04-17 21:36,922045,238687,483946,199412,922045
2023-04-17 21:37,922055,238695,483946,199414,922055
2023-04-17 21:38,922065,238702,483949,199414,922065
2023-04-17 21:39,922077,238711,483949,199417,922077
2023-04-17 21:40,922087,238717,483952,199418,922087
2023-04-17 21:41,922098,238725,483953,199420,922098
2023-04-17 21:42,922109,238733,483953,199423,922109
2023-04-17 21:43,922120,238733,483964,199423,922120
2023-04-17 21:44,922130,238742,483964,199424,922130
2023-04-17 21:45,922141,238747,483967,199427,922141
2023-04-17 21:46,922151,238757,483967,199427,922151
2023-04-17 21:47,922164,238761,483973,199430,922164
2023-04-17 21:48,922175,238770,483973,199432,922175
2023-04-17 21:49,922186,238779,483974,199433,922186
2023-04-17 21:50,922197,238790,483974,199433,922197
2023-04-17 21:51,922207,238797,483977,199433,922207
2023-04-17 21:52,922217,238806,483977,199434,922217
2023-04-17 21:53,922229,238812,483983,199434,922229
2023-04-17 21:54,922240,238823,483983,199434,922240
2023-04-17 21:55,922251,238831,483985,199435,922251
2023-04-17 21:56,922261,238840,483985,199436,922261
2023-04-17 21:57,922272,238845,483988,199439,922272
2023-04-17 21:58,922282,238853,483988,199441,922282
2023-04-17 22:00,922293,238860,483989,199444,922293
2023-04-17 22:01,922319,238882,483989,199448,922319
2023-04-17 22:02,922347,238905,483994,199448,922347
2023-04-17 22:03,922377,238934,483994,199449,922377
2023-04-17 22:04,922405,238957,483998,199450,922405
2023-04-17 22:05,922430,238980,483998,199452,922430
2023-04-17 22:06,922459,239002,484002,199455,922459
2023-04-17 22:07,922487,239030,484002,199455,922487
2023-04-17 22:08,922513,239047,484007,199459,922513
2023-04-17 22:09,922542,239075,484007,199460,922542
2023-04-17 22:10,922569,239093,484014,199462,922569
2023-04-17 22:11,922597,239120,484014,199463,922597
2023-04-17 22:12,922624,239136,484022,199466,922624
2023-04-17 22:13,922653,239163,484022,199468,922653
2023-04-17 22:14,922680,239183,484027,199470,922680
2023-04-17 22:15,922707,239206,484027,199474,922707
2023-04-17 22:16,922733,239223,484032,199478,922733
2023-04-17 22:17,922762,239250,484032,199480,922762
2023-04-17 22:18,922788,239274,484034,199480,922788
2023-04-17 22:19,922817,239300,484036,199481,922817
2023-04-17 22:20,922844,239325,484036,199483,922844
2023-04-17 22:21,922872,239345,484043,199484,922872
2023-04-17 22:22,922899,239372,484043,199484,922899
2023-04-17 22:23,922927,239394,484048,199485,922927
2023-04-17 22:24,922957,239423,484048,199486,922957
2023-04-17 22:25,922982,239442,484053,199487,922982
2023-04-17 22:26,923011,239470,484053,199488,923011
2023-04-17 22:27,923039,239492,484058,199489,923039
2023-04-17 22:28,923065,239514,484058,199493,923065
2023-04-17 22:29,923095,239537,484062,199496,923095
2023-04-17 22:30,923122,239561,484062,199499,923122
2023-04-17 22:31,923149,239582,484067,199500,923149
2023-04-17 22:32,923178,239608,484067,199503,923178
2023-04-17 22:33,923206,239631,484071,199504,923206
2023-04-17 22:34,923234,239658,484071,199505,923234
2023-04-17 22:35,923261,239679,484074,199508,923261
2023-04-17 22:36,923290,239705,484074,199511,923290
2023-04-17 22:37,923317,239726,484077,199514,923317
2023-04-17 22:38,923344,239748,484077,199519,923344
2023-04-17 22:39,923371,239770,484079,199522,923371
2023-04-17 22:40,923398,239796,484079,199523,923398
2023-04-17 22:41,923425,239817,484083,199525,923425
2023-04-17 22:42,923454,239845,484083,199526,923454
2023-04-17 22:43,923480,239868,484086,199526,923480
2023-04-17 22:44,923507,239893,484086,199528,923507
2023-04-17 22:45,923537,239916,484091,199530,923537
2023-04-17 22:47,923564,239940,484091,199533,923564
2023-04-17 22:48,923591,239962,484095,199534,923591
2023-04-17 22:49,923620,239989,484095,199536,923620
2023-04-17 22:50,923645,240007,484099,199539,923645
2023-04-17 22:51,923674,240036,484099,199539,923674
2023-04-17 22:52,923700,240055,484102,199543,923700
2023-04-17 22:53,923729,240084,484102,199543,923729
2023-04-17 22:54,923756,240108,484103,199545,923756
2023-04-17 22:55,923783,240132,484103,199548,923783
2023-04-17 22:56,923810,240151,484110,199549,923810
2023-04-17 22:57,923838,240177,484110,199551,923838
2023-04-17 22:58,923866,240196,484115,199555,923866
2023-04-17 22:59,923895,240223,484115,199557,923895
2023-04-17 23:00,923920,240239,484123,199558,923920
2023-04-17 23:01,923937,240250,484123,199564,923937
2023-04-17 23:02,923954,240257,484130,199567,923954
2023-04-17 23:03,923971,240272,484130,199569,923971
2023-04-17 23:04,923988,240278,484137,199573,923988
2023-04-17 23:05,924004,240284,484144,199576,924004
2023-04-17 23:06,924023,240302,484144,199577,924023
2023-04-17 23:07,924040,240313,484146,199581,924040
2023-04-17 23:08,924057,240326,484146,199585,924057
2023-04-17 23:09,924077,240335,484150,199592,924077
2023-04-17 23:10,924094,240350,484150,199594,924094
2023-04-17 23:11,924112,240364,484153,199595,924112
2023-04-17 23:12,924130,240382,484153,199595,924130
2023-04-17 23:13,924148,240394,484156,199598,924148
2023-04-17 23:14,924165,240412,484156,199597,924165
2023-04-17 23:15,924183,240424,484159,199600,924183
2023-04-17 23:16,924201,240441,484158,199602,924201
2023-04-17 23:17,924218,240457,484158,199603,924218
2023-04-17 23:18,924236,240470,484160,199606,924236
2023-04-17 23:19,924253,240487,484160,199606,924253
2023-04-17 23:20,924270,240501,484162,199607,924270
2023-04-17 23:21,924287,240516,484162,199609,924287
2023-04-17 23:22,924304,240530,484163,199611,924304
2023-04-17 23:23,924322,240547,484163,199612,924322
2023-04-17 23:24,924339,240558,484168,199613,924339
2023-04-17 23:25,924358,240574,484168,199616,924358
2023-04-17 23:26,924376,240589,484170,199617,924376
2023-04-17 23:27,924394,240604,484170,199620,924394
2023-04-17 23:28,924412,240617,484175,199620,924412
2023-04-17 23:29,924429,240631,484175,199623,924429
2023-04-17 23:30,924445,240642,484179,199624,924445
2023-04-17 23:31,924463,240658,484179,199626,924463
2023-04-17 23:32,924481,240670,484182,199629,924481
2023-04-17 23:34,924497,240683,484182,199632,924497
2023-04-17 23:35,924515,240691,484189,199635,924515
2023-04-17 23:36,924534,240709,484189,199636,924534
2023-04-17 23:37,924551,240725,484190,199636,924551
2023-04-17 23:38,924568,240739,484190,199639,924568
2023-04-17 23:39,924584,240750,484195,199639,924584
2023-04-17 23:40,924601,240765,484195,199641,924601
2023-04-17 23:41,924620,240776,484200,199644,924620
2023-04-17 23:42,924637,240792,484200,199645,924637
2023-04-17 23:43,924655,240802,484204,199649,924655
2023-04-17 23:44,924671,240818,484204,199649,924671
2023-04-17 23:45,924689,240824,484212,199653,924689
2023-04-17 23:46,924706,240838,484213,199655,924706
2023-04-17 23:47,924723,240854,484213,199656,924723
2023-04-17 23:48,924740,240866,484217,199657,924740
2023-04-17 23:49,924757,240880,484217,199660,924757
2023-04-17 23:50,924774,240891,484221,199662,924774
2023-04-17 23:51,924791,240907,484221,199663,924791
2023-04-17 23:52,924808,240920,484223,199665,924808
2023-04-17 23:53,924825,240933,484223,199669,924825
2023-04-17 23:54,924842,240944,484227,199671,924842
2023-04-17 23:55,924859,240958,484227,199674,924859
2023-04-17 23:56,924877,240973,484230,199674,924877
2023-04-17 23:57,924895,240991,484230,199674,924895
2023-04-17 23:58,924912,241004,484233,199675,924912
2023-04-17 23:59,924930,241017,484234,199679,924930
2023-04-18 00:00,924944,241029,484234,199681,924944
2023-04-18 00:01,924956,241035,484238,199683,924956
2023-04-18 00:02,924969,241046,484238,199685,924969
2023-04-18 00:03,924983,241053,484241,199689,924983
2023-04-18 00:04,924996,241064,484241,199691,924996
2023-04-18 00:05,925009,241071,484245,199693,925009
2023-04-18 00:06,925021,241083,484245,199693,925021
2023-04-18 00:07,925033,241092,484248,199693,925033
2023-04-18 00:08,925046,241103,484248,199695,925046
2023-04-18 00:09,925059,241112,484251,199696,925059
2023-04-18 00:10,925071,241122,484251,199698,925071
2023-04-18 00:11,925083,241126,484255,199702,925083
2023-04-18 00:12,925096,241138,484255,199703,925096
2023-04-18 00:13,925108,241141,484263,199704,925108
2023-04-18 00:14,925120,241152,484263,199705,925120
2023-04-18 00:15,925132,241161,484265,199706,925132
2023-04-18 00:16,925144,241170,484265,199709,925144
2023-04-18 00:17,925158,241181,484266,199711,925158
2023-04-18 00:18,925170,241193,484266,199711,925170
2023-04-18 00:19,925182,241196,484273,199713,925182
2023-04-18 00:21,925194,241208,484273,199713,925194
2023-04-18 00:22,925206,241215,484278,199713,925206
2023-04-18 00:23,925218,241223,484278,199717,925218
2023-04-18 00:24,925231,241231,484283,199717,925231
2023-04-18 00:25,925245,241241,484283,199721,925245
2023-04-18 00:26,925257,241246,484289,199722,925257
2023-04-18 00:27,925269,241257,484289,199723,925269
2023-04-18 00:28,925281,241263,484294,199724,925281
2023-04-18 00:29,925294,241276,484294,199724,925294
2023-04-18 00:30,925306,241285,484295,199726,925306
2023-04-18 00:31,925318,241296,484295,199727,925318
2023-04-18 00:32,925330,241307,484295,199728,925330
2023-04-18 00:33,925344,241320,484295,199729,925344
2023-04-18 00:34,925355,241327,484297,199731,925355
2023-04-18 00:35,925367,241339,484297,199731,925367
2023-04-18 00:36,925380,241346,484298,199736,925380
2023-04-18 00:37,925392,241356,484298,199738,925392
2023-04-18 00:38,925404,241361,484303,199740,925404
2023-04-18 00:39,925417,241374,484303,199740,925417
2023-04-18 00:40,925428,241381,484305,199742,925428
2023-04-18 00:41,925442,241395,484305,199742,925442
2023-04-18 00:42,925454,241404,484307,199743,925454
2023-04-18 00:43,925466,241414,484307,199745,925466
2023-04-18 00:44,925478,241421,484311,199746,925478
2023-04-18 00:45,925491,241433,484311,199747,925491
2023-04-18 00:46,925503,241440,484316,199747,925503
2023-04-18 00:47,925514,241450,484316,199748,925514
2023-04-18 00:48,925527,241459,484319,199749,925527
2023-04-18 00:49,925539,241470,484319,199750,925539
2023-04-18 00:50,925551,241478,484320,199753,925551
2023-04-18 00:51,925563,241488,484320,199755,925563
2023-04-18 00:52,925576,241500,484321,199755,925576
2023-04-18 00:53,925588,241510,484321,199757,925588
2023-04-18 00:54,925600,241520,484322,199758,925600
2023-04-18 00:55,925612,241529,484322,199761,925612
2023-04-18 00:56,925625,241536,484325,199764,925625
2023-04-18 00:57,925637,241545,484325,199767,925637
2023-04-18 00:58,925649,241555,484326,199768,925649
2023-04-18 00:59,925661,241564,484326,199771,925661
2023-04-18 01:00,925670,241571,484327,199772,925670
2023-04-18 01:01,925677,241577,484327,199773,925677
2023-04-18 01:02,925683,241582,484327,199774,925683
2023-04-18 01:03,925691,241588,484328,199775,925691
2023-04-18 01:04,925698,241595,484328,199775,925698
2023-04-18 01:05,925704,241598,484330,199776,925704
2023-04-18 01:06,925711,241603,484330,199778,925711
2023-04-18 01:07,925718,241608,484330,199780,925718
2023-04-18 01:08,925724,241613,484330,199781,925724
2023-04-18 01:10,925731,241617,484333,199781,925731
2023-04-18 01:11,925737,241622,484333,199782,925737
2023-04-18 01:12,925744,241626,484334,199784,925744
2023-04-18 01:13,925751,241631,484334,199786,925751
2023-04-18 01:14,925758,241635,484337,199786,925758
2023-04-18 01:15,925765,241642,484337,199786,925765
2023-04-18 01:16,925771,241646,484337,199788,925771
2023-04-18 01:17,925778,241653,484337,199788,925778
2023-04-18 01:18,925784,241658,484338,199788,925784
2023-04-18 01:19,925791,241665,484338,199788,925791
2023-04-18 01:20,925798,241665,484342,199791,925798
2023-04-18 01:21,925804,241671,484342,199791,925804
2023-04-18 01:22,925811,241676,484344,199791,925811
2023-04-18 01:23,925818,241682,484344,199792,925818
2023-04-18 01:24,925824,241686,484346,199792,925824
2023-04-18 01:25,925831,241691,484347,199793,925831
2023-04-18 01:26,925838,241698,484347,199793,925838
2023-04-18 01:27,925844,241702,484348,199794,925844
2023-04-18 01:28,925851,241706,484348,199797,925851
2023-04-18 01:29,925857,241710,484350,199797,925857
2023-04-18 01:30,925864,241716,484350,199798,925864
2023-04-18 01:31,925871,241722,484351,199798,925871
2023-04-18 01:32,925877,241728,484351,199798,925877
2023-04-18 01:33,925883,241731,484352,199800,925883
2023-04-18 01:34,925890,241737,484352,199801,925890
2023-04-18 01:35,925897,241742,484353,199802,925897
2023-04-18 01:36,925903,241746,484353,199804,925903
2023-04-18 01:37,925910,241753,484353,199804,925910
2023-04-18 01:38,925917,241760,484353,199804,925917
2023-04-18 01:39,925924,241766,484353,199805,925924
2023-04-18 01:40,925931,241773,484353,199805,925931
2023-04-18 01:41,925937,241777,484355,199805,925937
2023-04-18 01:42,925944,241784,484355,199805,925944
2023-04-18 01:43,925951,241788,484356,199807,925951
2023-04-18 01:44,925957,241794,484356,199807,925957
2023-04-18 01:45,925964,241801,484356,199807,925964
2023-04-18 01:46,925972,241809,484356,199807,925972
2023-04-18 01:47,925978,241813,484357,199808,925978
2023-04-18 01:48,925985,241820,484357,199808,925985
2023-04-18 01:49,925991,241822,484360,199809,925991
2023-04-18 01:50,925998,241829,484360,199809,925998
2023-04-18 01:51,926005,241834,484362,199809,926005
2023-04-18 01:52,926011,241839,484362,199810,926011
2023-04-18 01:53,926018,241845,484363,199810,926018
2023-04-18 01:54,926024,241850,484363,199811,926024
2023-04-18 01:55,926032,241855,484366,199811,926032
2023-04-18 01:56,926038,241861,484366,199811,926038
2023-04-18 01:57,926045,241868,484366,199811,926045
2023-04-18 01:58,926052,241875,484366,199811,926052
2023-04-18 02:00,926059,241880,484367,199812,926059
2023-04-18 02:01,926070,241890,484367,199813,926070
2023-04-18 02:02,926081,241900,484368,199813,926081
2023-04-18 02:03,926092,241912,484368,199812,926092
2023-04-18 02:04,926103,241921,484370,199812,926103
2023-04-18 02:05,926114,241931,484370,199813,926114
2023-04-18 02:06,926125,241940,484372,199813,926125
2023-04-18 02:07,926136,241951,484372,199813,926136
2023-04-18 02:08,926147,241958,484375,199814,926147
2023-04-18 02:09,926158,241966,484375,199817,926158
2023-04-18 02:10,926169,241976,484375,199818,926169
2023-04-18 02:11,926179,241986,484375,199818,926179
2023-04-18 02:12,926191,241996,484377,199818,926191
2023-04-18 02:13,926202,242006,484377,199819,926202
2023-04-18 02:14,926212,242014,484377,199821,926212
2023-04-18 02:15,926224,242025,484377,199822,926224
2023-04-18 02:16,926234,242032,484380,199822,926234
2023-04-18 02:17,926246,242042,484380,199824,926246
2023-04-18 02:18,926256,242052,484380,199824,926256
2023-04-18 02:19,926267,242063,484380,199824,926267
2023-04-18 02:20,926279,242073,484381,199825,926279
2023-04-18 02:21,926291,242085,484381,199825,926291
2023-04-18 02:22,926302,242095,484381,199826,926302
2023-04-18 02:23,926312,242105,484381,199826,926312
2023-04-18 02:24,926323,242111,484386,199826,926323
2023-04-18 02:25,926334,242122,484386,199826,926334
2023-04-18 02:26,926345,242131,484386,199828,926345
2023-04-18 02:27,926356,242140,484386,199830,926356
2023-04-18 02:28,926367,242151,484386,199830,926367
2023-04-18 02:29,926378,242162,484386,199830,926378
2023-04-18 02:30,926389,242169,484387,199833,926389
2023-04-18 02:31,926400,242180,484387,199833,926400
2023-04-18 02:32,926411,242190,484388,199833,926411
2023-04-18 02:33,926423,242202,484388,199833,926423
2023-04-18 02:34,926433,242210,484390,199833,926433
2023-04-18 02:35,926444,242221,484390,199833,926444
2023-04-18 02:36,926456,242232,484391,199833,926456
2023-04-18 02:37,926468,242244,484391,199833,926468
2023-04-18 02:38,926479,242253,484393,199833,926479
2023-04-18 02:39,926490,242264,484393,199833,926490
2023-04-18 02:40,926501,242273,484394,199834,926501
2023-04-18 02:41,926512,242284,484394,199834,926512
2023-04-18 02:42,926523,242295,484394,199834,926523
2023-04-18 02:43,926534,242306,484394,199834,926534
2023-04-18 02:44,926545,242316,484395,199834,926545
2023-04-18 02:45,926556,242327,484395,199834,926556
2023-04-18 02:47,926567,242335,484398,199834,926567
2023-04-18 02:48,926578,242346,484398,199834,926578
2023-04-18 02:49,926589,242356,484399,199834,926589
2023-04-18 02:50,926599,242366,484399,199834,926599
2023-04-18 02:51,926611,242377,484400,199834,926611
2023-04-18 02:52,926621,242386,484400,199835,926621
2023-04-18 02:53,926633,242397,484401,199835,926633
2023-04-18 02:54,926644,242408,484401,199835,926644
2023-04-18 02:55,926655,242418,484402,199835,926655
2023-04-18 02:56,926665,242428,484402,199835,926665
2023-04-18 02:57,926676,242437,484404,199835,926676
2023-04-18 02:58,926688,242449,484404,199835,926688
2023-04-18 02:59,926698,242459,484404,199835,926698
2023-04-18 03:00,926709,242470,484404,199835,926709
2023-04-18 03:01,926720,242480,484405,199835,926720
2023-04-18 03:02,926731,242491,484405,199835,926731
2023-04-18 03:03,926741,242501,484405,199835,926741
2023-04-18 03:04,926751,242511,484405,199835,926751
2023-04-18 03:05,926761,242520,484406,199835,926761
2023-04-18 03:06,926771,242529,484406,199836,926771
2023-04-18 03:07,926781,242540,484405,199836,926781
2023-04-18 03:08,926791,242548,484405,199838,926791
2023-04-18 03:09,926801,242558,484405,199838,926801
2023-04-18 03:10,926811,242568,484405,199838,926811
2023-04-18 03:11,926821,242578,484405,199838,926821
2023-04-18 03:12,926831,242588,484405,199838,926831
2023-04-18 03:13,926841,242598,484405,199838,926841
2023-04-18 03:14,926851,242608,484405,199838,926851
2023-04-18 03:15,926861,242618,484405,199838,926861
2023-04-18 03:16,926871,242628,484405,199838,926871
2023-04-18 03:17,926881,242638,484405,199838,926881
2023-04-18 03:18,926891,242648,484405,199838,926891
2023-04-18 03:19,926901,242657,484406,199838,926901
2023-04-18 03:20,926911,242667,484406,199838,926911
2023-04-18 03:21,926921,242675,484408,199838,926921
2023-04-18 03:22,926931,242685,484408,199838,926931
2023-04-18 03:23,926941,242695,484408,199838,926941
2023-04-18 03:24,926951,242705,484408,199838,926951
2023-04-18 03:25,926961,242715,484408,199838,926961
2023-04-18 03:26,926971,242724,484408,199839,926971
2023-04-18 03:27,926981,242732,484410,199839,926981
2023-04-18 03:28,926990,242741,484410,199839,926990
2023-04-18 03:29,927001,242752,484410,199839,927001
2023-04-18 03:30,927011,242762,484410,199839,927011
2023-04-18 03:31,927021,242771,484411,199839,927021
2023-04-18 03:33,927031,242780,484411,199840,927031
2023-04-18 03:34,927040,242787,484412,199841,927040
2023-04-18 03:35,927051,242798,484412,199841,927051
2023-04-18 03:36,927061,242808,484412,199841,927061
2023-04-18 03:37,927071,242818,484412,199841,927071
2023-04-18 03:38,927081,242827,484413,199841,927081
2023-04-18 03:39,927091,242837,484413,199841,927091
2023-04-18 03:40,927101,242847,484413,199841,927101
2023-04-18 03:41,927111,242856,484413,199842,927111
2023-04-18 03:42,927121,242866,484413,199842,927121
2023-04-18 03:43,927131,242875,484413,199843,927131
2023-04-18 03:44,927141,242885,484413,199843,927141
2023-04-18 03:45,927151,242895,484413,199843,927151
2023-04-18 03:46,927161,242904,484413,199844,927161
2023-04-18 03:47,927171,242914,484413,199844,927171
2023-04-18 03:48,927181,242924,484413,199844,927181
2023-04-18 03:49,927191,242934,484413,199844,927191
2023-04-18 03:50,927201,242942,484414,199845,927201
2023-04-18 03:51,927211,242951,484414,199846,927211
2023-04-18 03:52,927221,242960,484415,199846,927221
2023-04-18 03:53,927231,242970,484415,199846,927231
2023-04-18 03:54,927241,242979,484416,199846,927241
2023-04-18 03:55,927251,242989,484416,199846,927251
2023-04-18 03:56,927260,242997,484417,199846,927260
2023-04-18 03:57,927270,243007,484417,199846,927270
2023-04-18 03:58,927281,243018,484417,199846,927281
2023-04-18 03:59,927291,243028,484417,199846,927291
2023-04-18 04:00,927300,243036,484417,199847,927300
2023-04-18 04:01,927307,243043,484417,199847,927307
2023-04-18 04:02,927315,243051,484417,199847,927315
2023-04-18 04:03,927322,243058,484417,199847,927322
2023-04-18 04:04,927330,243065,484417,199848,927330
2023-04-18 04:05,927337,243072,484417,199848,927337
2023-04-18 04:06,927345,243080,484417,199848,927345
2023-04-18 04:07,927353,243088,484417,199848,927353
2023-04-18 04:08,927360,243093,484419,199848,927360
2023-04-18 04:09,927368,243101,484419,199848,927368
2023-04-18 04:10,927376,243109,484419,199848,927376
2023-04-18 04:11,927383,243115,484419,199849,927383
2023-04-18 04:12,927391,243123,484419,199849,927391
2023-04-18 04:13,927398,243130,484419,199849,927398
2023-04-18 04:14,927406,243138,484419,199849,927406
2023-04-18 04:15,927414,243146,484419,199849,927414
2023-04-18 04:16,927421,243153,484419,199849,927421
2023-04-18 04:17,927429,243161,484419,199849,927429
2023-04-18 04:18,927436,243165,484421,199850,927436
2023-04-18 04:20,927444,243173,484421,199850,927444
2023-04-18 04:21,927451,243180,484421,199850,927451
2023-04-18 04:22,927459,243188,484421,199850,927459
2023-04-18 04:23,927467,243196,484421,199850,927467
2023-04-18 04:24,927474,243203,484421,199850,927474
2023-04-18 04:25,927482,243211,484421,199850,927482
2023-04-18 04:26,927490,243219,484421,199850,927490
2023-04-18 04:27,927497,243226,484421,199850,927497
2023-04-18 04:28,927505,243234,484421,199850,927505
2023-04-18 04:29,927512,243241,484421,199850,927512
2023-04-18 04:30,927520,243248,484421,199851,927520
2023-04-18 04:31,927527,243254,484422,199851,927527
2023-04-18 04:32,927535,243262,484422,199851,927535
2023-04-18 04:33,927543,243270,484422,199851,927543
2023-04-18 04:34,927550,243277,484422,199851,927550
2023-04-18 04:35,927558,243285,484422,199851,927558
2023-04-18 04:36,927565,243292,484422,199851,927565
2023-04-18 04:37,927573,243298,484424,199851,927573
2023-04-18 04:38,927580,243305,484424,199851,927580
2023-04-18 04:39,927588,243313,484424,199851,927588
2023-04-18 04:40,927596,243320,484424,199852,927596
2023-04-18 04:41,927603,243327,484424,199852,927603
2023-04-18 04:42,927611,243335,484424,199852,927611
2023-04-18 04:43,927619,243343,484424,199852,927619
2023-04-18 04:44,927626,243350,484424,199852,927626
2023-04-18 04:45,927634,243357,484424,199853,927634
2023-04-18 04:46,927641,243364,484424,199853,927641
2023-04-18 04:47,927649,243371,484425,199853,927649
2023-04-18 04:48,927656,243377,484425,199854,927656
2023-04-18 04:49,927664,243385,484425,199854,927664
2023-04-18 04:50,927672,243393,484425,199854,927672
2023-04-18 04:51,927679,243400,484425,199854,927679
2023-04-18 04:52,927687,243408,484425,199854,927687
2023-04-18 04:53,927694,243415,484425,199854,927694
2023-04-18 04:54,927702,243423,484425,199854,927702
2023-04-18 04:55,927710,243431,484425,199854,927710
2023-04-18 04:56,927717,243438,484425,199854,927717
2023-04-18 04:57,927725,243446,484425,199854,927725
2023-04-18 04:58,927732,243453,484425,199854,927732
2023-04-18 04:59,927740,243461,484425,199854,927740
2023-04-18 05:00,927748,243469,484425,199854,927748
2023-04-18 05:01,927757,243477,484425,199855,927757
2023-04-18 05:02,927765,243485,484425,199855,927765
2023-04-18 05:03,927774,243494,484425,199855,927774
2023-04-18 05:04,927782,243502,484425,199855,927782
2023-04-18 05:06,927790,243510,484425,199855,927790
2023-04-18 05:07,927799,243519,484425,199855,927799
2023-04-18 05:08,927808,243528,484425,199855,927808
2023-04-18 05:09,927816,243536,484425,199855,927816
2023-04-18 05:10,927824,243542,484426,199856,927824
2023-04-18 05:11,927833,243551,484426,199856,927833
2023-04-18 05:12,927841,243559,484426,199856,927841
2023-04-18 05:13,927850,243568,484426,199856,927850
2023-04-18 05:14,927858,243576,484426,199856,927858
2023-04-18 05:15,927866,243584,484426,199856,927866
2023-04-18 05:16,927875,243593,484426,199856,927875
2023-04-18 05:17,927884,243602,484426,199856,927884
2023-04-18 05:18,927892,243610,484426,199856,927892
2023-04-18 05:19,927900,243618,484426,199856,927900
2023-04-18 05:20,927909,243625,484428,199856,927909
2023-04-18 05:21,927917,243633,484428,199856,927917
2023-04-18 05:22,927926,243641,484429,199856,927926
2023-04-18 05:23,927934,243648,484429,199857,927934
2023-04-18 05:24,927943,243656,484430,199857,927943
2023-04-18 05:25,927951,243664,484430,199857,927951
2023-04-18 05:26,927960,243673,484430,199857,927960
2023-04-18 05:27,927968,243680,484430,199858,927968
2023-04-18 05:28,927976,243687,484431,199858,927976
2023-04-18 05:29,927985,243696,484431,199858,927985
2023-04-18 05:30,927994,243705,484431,199858,927994
2023-04-18 05:31,928002,243712,484431,199859,928002
2023-04-18 05:32,928010,243719,484431,199860,928010
2023-04-18 05:33,928019,243728,484431,199860,928019
2023-04-18 05:34,928027,243735,484431,199861,928027
2023-04-18 05:35,928036,243744,484431,199861,928036
2023-04-18 05:36,928044,243752,484431,199861,928044
2023-04-18 05:37,928052,243760,484431,199861,928052
2023-04-18 05:38,928061,243768,484431,199862,928061
2023-04-18 05:39,928070,243777,484431,199862,928070
2023-04-18 05:40,928078,243785,484431,199862,928078
2023-04-18 05:41,928086,243793,484431,199862,928086
2023-04-18 05:42,928095,243803,484431,199861,928095
2023-04-18 05:43,928103,243811,484431,199861,928103
2023-04-18 05:44,928112,243818,484432,199862,928112
2023-04-18 05:45,928120,243825,484432,199863,928120
2023-04-18 05:46,928130,243834,484433,199863,928130
2023-04-18 05:47,928139,243843,484433,199863,928139
2023-04-18 05:48,928147,243850,484432,199865,928147
2023-04-18 05:49,928156,243859,484432,199865,928156
2023-04-18 05:50,928164,243866,484432,199866,928164
2023-04-18 05:51,928173,243875,484432,199866,928173
2023-04-18 05:52,928181,243883,484432,199866,928181
2023-04-18 05:54,928190,243892,484432,199866,928190
2023-04-18 05:55,928198,243900,484432,199866,928198
2023-04-18 05:56,928207,243908,484432,199867,928207
2023-04-18 05:57,928215,243915,484433,199867,928215
2023-04-18 05:58,928223,243923,484433,199867,928223
2023-04-18 05:59,928232,243931,484433,199868,928232
2023-04-18 06:00,928240,243939,484433,199868,928240
2023-04-18 06:01,928247,243946,484433,199868,928247
2023-04-18 06:02,928254,243952,484433,199869,928254
2023-04-18 06:03,928261,243959,484433,199869,928261
2023-04-18 06:04,928268,243966,484433,199869,928268
2023-04-18 06:05,928275,243973,484433,199869,928275
2023-04-18 06:06,928282,243979,484433,199870,928282
2023-04-18 06:07,928289,243985,484434,199870,928289
2023-04-18 06:08,928297,243993,484434,199870,928297
2023-04-18 06:09,928303,243999,484434,199870,928303
2023-04-18 06:10,928311,244007,484434,199870,928311
2023-04-18 06:11,928317,244013,484434,199870,928317
2023-04-18 06:12,928325,244021,484434,199870,928325
2023-04-18 06:13,928331,244026,484434,199871,928331
2023-04-18 06:14,928339,244034,484434,199871,928339
2023-04-18 06:15,928346,244039,484436,199871,928346
2023-04-18 06:16,928354,244046,484436,199872,928354
2023-04-18 06:17,928361,244051,484438,199872,928361
2023-04-18 06:18,928368,244058,484438,199872,928368
2023-04-18 06:19,928375,244063,484439,199873,928375
2023-04-18 06:20,928382,244070,484439,199873,928382
2023-04-18 06:21,928389,244077,484439,199873,928389
2023-04-18 06:22,928396,244083,484439,199874,928396
2023-04-18 06:23,928403,244088,484440,199875,928403
2023-04-18 06:24,928410,244095,484440,199875,928410
2023-04-18 06:25,928417,244101,484441,199875,928417
2023-04-18 06:26,928424,244108,484441,199875,928424
2023-04-18 06:27,928432,244114,484442,199876,928432
2023-04-18 06:28,928439,244121,484442,199876,928439
2023-04-18 06:29,928446,244128,484442,199876,928446
2023-04-18 06:30,928453,244133,484442,199878,928453
2023-04-18 06:31,928460,244140,484442,199878,928460
2023-04-18 06:32,928467,244147,484442,199878,928467
2023-04-18 06:33,928473,244153,484442,199878,928473
2023-04-18 06:34,928482,244162,484442,199878,928482
2023-04-18 06:35,928489,244168,484443,199878,928489
2023-04-18 06:36,928496,244175,484443,199878,928496
2023-04-18 06:37,928503,244181,484444,199878,928503
2023-04-18 06:38,928510,244188,484444,199878,928510
2023-04-18 06:39,928517,244195,484444,199878,928517
2023-04-18 06:41,928524,244200,484444,199880,928524
2023-04-18 06:42,928531,244204,484446,199881,928531
2023-04-18 06:43,928538,244211,484446,199881,928538
2023-04-18 06:44,928545,244216,484448,199881,928545
2023-04-18 06:45,928552,244223,484448,199881,928552
2023-04-18 06:46,928559,244230,484448,199881,928559
2023-04-18 06:47,928566,244237,484448,199881,928566
2023-04-18 06:48,928573,244244,484448,199881,928573
2023-04-18 06:49,928580,244251,484448,199881,928580
2023-04-18 06:50,928587,244255,484449,199883,928587
2023-04-18 06:51,928595,244262,484449,199884,928595
2023-04-18 06:52,928601,244267,484450,199884,928601
2023-04-18 06:53,928609,244275,484450,199884,928609
2023-04-18 06:54,928616,244282,484450,199884,928616
2023-04-18 06:55,928623,244289,484450,199884,928623
2023-04-18 06:56,928630,244296,484450,199884,928630
2023-04-18 06:57,928637,244303,484450,199884,928637
2023-04-18 06:58,928644,244310,484450,199884,928644
2023-04-18 06:59,928651,244317,484450,199884,928651
2023-04-18 07:00,928658,244322,484451,199885,928658
2023-04-18 07:01,928667,244330,484451,199886,928667
2023-04-18 07:02,928675,244336,484453,199886,928675
2023-04-18 07:03,928683,244343,484453,199887,928683
2023-04-18 07:04,928691,244351,484453,199887,928691
2023-04-18 07:05,928699,244359,484453,199887,928699
2023-04-18 07:06,928707,244365,484454,199888,928707
2023-04-18 07:07,928715,244372,484454,199889,928715
2023-04-18 07:08,928725,244381,484455,199889,928725
2023-04-18 07:09,928733,244388,484455,199890,928733
2023-04-18 07:10,928741,244396,484455,199890,928741
2023-04-18 07:11,928749,244404,484455,199890,928749
2023-04-18 07:12,928757,244411,484456,199890,928757
2023-04-18 07:13,928766,244419,484456,199891,928766
2023-04-18 07:14,928775,244427,484456,199892,928775
2023-04-18 07:15,928783,244435,484456,199892,928783
2023-04-18 07:16,928791,244439,484458,199894,928791
2023-04-18 07:17,928799,244447,484458,199894,928799
2023-04-18 07:18,928807,244453,484459,199895,928807
2023-04-18 07:19,928816,244462,484459,199895,928816
2023-04-18 07:20,928824,244467,484461,199896,928824
2023-04-18 07:21,928832,244475,484461,199896,928832
2023-04-18 07:22,928840,244483,484461,199896,928840
2023-04-18 07:23,928848,244491,484461,199896,928848
2023-04-18 07:24,928857,244500,484461,199896,928857
2023-04-18 07:25,928865,244508,484461,199896,928865
2023-04-18 07:26,928873,244514,484462,199897,928873
2023-04-18 07:27,928881,244521,484462,199898,928881
2023-04-18 07:29,928889,244526,484464,199899,928889
2023-04-18 07:30,928897,244534,484464,199899,928897
2023-04-18 07:31,928905,244541,484465,199899,928905
2023-04-18 07:32,928914,244550,484465,199899,928914
2023-04-18 07:33,928922,244557,484466,199899,928922
2023-04-18 07:34,928930,244563,484466,199901,928930
2023-04-18 07:35,928938,244570,484467,199901,928938
2023-04-18 07:36,928946,244579,484467,199900,928946
2023-04-18 07:37,928955,244583,484471,199901,928955
2023-04-18 07:38,928963,244589,484471,199903,928963
2023-04-18 07:39,928971,244598,484470,199903,928971
2023-04-18 07:40,928979,244605,484470,199904,928979
2023-04-18 07:41,928987,244608,484475,199904,928987
2023-04-18 07:42,928996,244616,484475,199905,928996
2023-04-18 07:43,929005,244622,484476,199907,929005
2023-04-18 07:44,929012,244628,484476,199908,929012
2023-04-18 07:45,929021,244636,484477,199908,929021
2023-04-18 07:46,929030,244643,484477,199910,929030
2023-04-18 07:47,929039,244652,484477,199910,929039
2023-04-18 07:48,929046,244659,484477,199910,929046
2023-04-18 07:49,929054,244666,484478,199910,929054
2023-04-18 07:50,929063,244675,484478,199910,929063
2023-04-18 07:51,929071,244678,484482,199911,929071
2023-04-18 07:52,929079,244684,484482,199913,929079
2023-04-18 07:53,929087,244692,484482,199913,929087
2023-04-18 07:54,929095,244699,484482,199914,929095
2023-04-18 07:55,929104,244706,484484,199914,929104
2023-04-18 07:56,929113,244715,484484,199914,929113
2023-04-18 07:57,929121,244719,484488,199914,929121
2023-04-18 07:58,929129,244727,484488,199914,929129
2023-04-18 07:59,929138,244736,484488,199914,929138
2023-04-18 08:00,929147,244745,484488,199914,929147
2023-04-18 08:01,929156,244753,484489,199914,929156
2023-04-18 08:02,929165,244762,484489,199914,929165
2023-04-18 08:03,929175,244769,484492,199914,929175
2023-04-18 08:04,929184,244778,484492,199914,929184
2023-04-18 08:05,929193,244784,484494,199915,929193
2023-04-18 08:06,929203,244793,484494,199916,929203
2023-04-18 08:07,929212,244801,484495,199916,929212
2023-04-18 08:08,929222,244810,484495,199917,929222
2023-04-18 08:09,929231,244816,484497,199918,929231
2023-04-18 08:10,929241,244826,484497,199918,929241
2023-04-18 08:11,929250,244832,484497,199921,929250
2023-04-18 08:12,929260,244841,484497,199922,929260
2023-04-18 08:13,929269,244848,484499,199922,929269
2023-04-18 08:15,929278,244857,484499,199922,929278
2023-04-18 08:16,929288,244867,484499,199922,929288
2023-04-18 08:17,929298,244877,484499,199922,929298
2023-04-18 08:18,929307,244881,484500,199926,929307
2023-04-18 08:19,929317,244891,484500,199926,929317
2023-04-18 08:20,929326,244899,484501,199926,929326
2023-04-18 08:21,929335,244907,484501,199927,929335
2023-04-18 08:22,929346,244914,484503,199929,929346
2023-04-18 08:23,929355,244921,484503,199931,929355
2023-04-18 08:24,929364,244930,484503,199931,929364
2023-04-18 08:25,929374,244940,484503,199931,929374
2023-04-18 08:26,929384,244948,484504,199932,929384
2023-04-18 08:27,929393,244955,484504,199934,929393
2023-04-18 08:28,929403,244963,484506,199934,929403
2023-04-18 08:29,929412,244972,484506,199934,929412
2023-04-18 08:30,929421,244977,484508,199936,929421
2023-04-18 08:31,929431,244987,484508,199936,929431
2023-04-18 08:32,929440,244995,484508,199937,929440
2023-04-18 08:33,929450,245004,484508,199938,929450
2023-04-18 08:34,929460,245013,484509,199938,929460
2023-04-18 08:35,929469,245021,484509,199939,929469
2023-04-18 08:36,929478,245029,484510,199939,929478
2023-04-18 08:37,929487,245038,484510,199939,929487
2023-04-18 08:38,929497,245047,484511,199939,929497
2023-04-18 08:39,929507,245055,484511,199941,929507
2023-04-18 08:40,929516,245061,484514,199941,929516
2023-04-18 08:41,929525,245068,484514,199943,929525
2023-04-18 08:42,929535,245077,484515,199943,929535
2023-04-18 08:43,929544,245085,484515,199944,929544
2023-04-18 08:44,929555,245093,484517,199945,929555
2023-04-18 08:45,929564,245099,484517,199948,929564
2023-04-18 08:46,929574,245107,484517,199950,929574
2023-04-18 08:47,929583,245115,484517,199951,929583
2023-04-18 08:48,929593,245124,484518,199951,929593
2023-04-18 08:49,929602,245133,484518,199951,929602
2023-04-18 08:50,929611,245142,484518,199951,929611
2023-04-18 08:51,929621,245150,484520,199951,929621
2023-04-18 08:52,929630,245159,484520,199951,929630
2023-04-18 08:53,929640,245167,484521,199952,929640
2023-04-18 08:54,929649,245172,484524,199953,929649
2023-04-18 08:55,929659,245182,484524,199953,929659
2023-04-18 08:56,929668,245186,484526,199956,929668
2023-04-18 08:57,929677,245195,484526,199956,929677
2023-04-18 08:58,929687,245203,484528,199956,929687
2023-04-18 08:59,929697,245213,484528,199956,929697
2023-04-18 09:00,929704,245219,484529,199956,929704
2023-04-18 09:01,929712,245227,484529,199956,929712
2023-04-18 09:03,929718,245226,484534,199958,929718
2023-04-18 09:04,929724,245232,484533,199959,929724
2023-04-18 09:05,929730,245237,484533,199960,929730
2023-04-18 09:06,929736,245241,484533,199962,929736
2023-04-18 09:07,929742,245246,484533,199963,929742
2023-04-18 09:08,929748,245248,484535,199965,929748
2023-04-18 09:09,929754,245252,484535,199967,929754
2023-04-18 09:10,929760,245253,484538,199969,929760
2023-04-18 09:11,929766,245259,484538,199969,929766
2023-04-18 09:12,929773,245263,484541,199969,929773
2023-04-18 09:13,929779,245270,484541,199968,929779
2023-04-18 09:14,929784,245272,484543,199969,929784
2023-04-18 09:15,929791,245277,484543,199971,929791
2023-04-18 09:16,929797,245279,484546,199972,929797
2023-04-18 09:17,929803,245285,484546,199972,929803
2023-04-18 09:18,929809,245290,484547,199972,929809
2023-04-18 09:19,929815,245296,484547,199972,929815
2023-04-18 09:20,929821,245299,484547,199975,929821
2023-04-18 09:21,929827,245304,484547,199976,929827
2023-04-18 09:22,929833,245308,484549,199976,929833
2023-04-18 09:23,929839,245314,484549,199976,929839
2023-04-18 09:24,929845,245318,484550,199977,929845
2023-04-18 09:25,929851,245323,484550,199978,929851
2023-04-18 09:26,929858,245325,484554,199979,929858
2023-04-18 09:27,929865,245332,484554,199979,929865
2023-04-18 09:28,929871,245339,484553,199979,929871
2023-04-18 09:29,929877,245345,484553,199979,929877
2023-04-18 09:30,929883,245348,484556,199979,929883
2023-04-18 09:31,929889,245353,484556,199980,929889
2023-04-18 09:32,929895,245358,484556,199981,929895
2023-04-18 09:33,929902,245364,484556,199982,929902
2023-04-18 09:34,929908,245368,484556,199984,929908
2023-04-18 09:35,929914,245374,484556,199984,929914
2023-04-18 09:36,929920,245379,484556,199985,929920
2023-04-18 09:37,929926,245384,484556,199986,929926
2023-04-18 09:38,929932,245389,484556,199987,929932
2023-04-18 09:39,929939,245396,484556,199987,929939
2023-04-18 09:40,929945,245400,484556,199989,929945
2023-04-18 09:41,929951,245404,484556,199991,929951
2023-04-18 09:42,929957,245405,484560,199992,929957
2023-04-18 09:43,929965,245413,484560,199992,929965
2023-04-18 09:44,929971,245417,484560,199994,929971
2023-04-18 09:45,929977,245423,484560,199994,929977
2023-04-18 09:46,929983,245426,484560,199997,929983
2023-04-18 09:47,929990,245433,484560,199997,929990
2023-04-18 09:48,929997,245438,484560,199999,929997
2023-04-18 09:50,930005,245444,484560,200001,930005
2023-04-18 09:51,930011,245447,484560,200004,930011
2023-04-18 09:52,930017,245452,484560,200005,930017
2023-04-18 09:53,930023,245445,484571,200007,930023
2023-04-18 09:54,930029,245449,484571,200009,930029
2023-04-18 09:55,930035,245455,484571,200009,930035
2023-04-18 09:56,930041,245461,484571,200009,930041
2023-04-18 09:57,930047,245464,484571,200012,930047
2023-04-18 09:58,930053,245469,484571,200013,930053
2023-04-18 09:59,930060,245474,484571,200015,930060
2023-04-18 10:00,930067,245476,484571,200020,930067
2023-04-18 10:01,930078,245487,484571,200020,930078
2023-04-18 10:02,930091,245499,484571,200021,930091
2023-04-18 10:03,930103,245503,484578,200022,930103
2023-04-18 10:04,930114,245511,484578,200025,930114
2023-04-18 10:05,930126,245523,484578,200025,930126
2023-04-18 10:06,930140,245536,484578,200026,930140
2023-04-18 10:07,930152,245547,484578,200027,930152
2023-04-18 10:08,930164,245557,484578,200029,930164
2023-04-18 10:09,930177,245569,484578,200030,930177
2023-04-18 10:10,930189,245579,484578,200032,930189
2023-04-18 10:11,930202,245592,484578,200032,930202
2023-04-18 10:12,930214,245603,484578,200033,930214
2023-04-18 10:13,930226,245609,484583,200034,930226
2023-04-18 10:14,930240,245622,484583,200035,930240
2023-04-18 10:15,930251,245632,484583,200036,930251
2023-04-18 10:16,930263,245642,484583,200038,930263
2023-04-18 10:17,930275,245651,484583,200041,930275
2023-04-18 10:18,930288,245663,484583,200042,930288
2023-04-18 10:19,930301,245675,484583,200043,930301
2023-04-18 10:20,930312,245686,484583,200043,930312
2023-04-18 10:21,930324,245698,484583,200043,930324
2023-04-18 10:22,930337,245711,484583,200043,930337
2023-04-18 10:23,930348,245705,484598,200045,930348
2023-04-18 10:24,930360,245715,484598,200047,930360
2023-04-18 10:25,930372,245727,484598,200047,930372
2023-04-18 10:26,930384,245736,484600,200048,930384
2023-04-18 10:27,930397,245748,484600,200049,930397
2023-04-18 10:28,930409,245756,484602,200051,930409
2023-04-18 10:29,930421,245766,484602,200053,930421
2023-04-18 10:30,930433,245776,484604,200053,930433
2023-04-18 10:31,930445,245786,484604,200055,930445
2023-04-18 10:32,930457,245793,484607,200057,930457
2023-04-18 10:33,930470,245806,484607,200057,930470
2023-04-18 10:34,930482,245813,484611,200058,930482
2023-04-18 10:35,930494,245823,484613,200058,930494
2023-04-18 10:36,930506,245835,484613,200058,930506
2023-04-18 10:38,930518,245839,484619,200060,930518
2023-04-18 10:39,930530,245848,484621,200061,930530
2023-04-18 10:40,930542,245860,484621,200061,930542
2023-04-18 10:41,930554,245869,484623,200062,930554
2023-04-18 10:42,930566,245879,484623,200064,930566
2023-04-18 10:43,930578,245890,484623,200065,930578
2023-04-18 10:44,930590,245899,484624,200067,930590
2023-04-18 10:45,930602,245908,484624,200070,930602
2023-04-18 10:46,930615,245917,484627,200071,930615
2023-04-18 10:47,930628,245926,484629,200073,930628
2023-04-18 10:48,930640,245938,484629,200073,930640
2023-04-18 10:49,930652,245942,484637,200073,930652
2023-04-18 10:50,930665,245954,484637,200074,930665
2023-04-18 10:51,930677,245960,484640,200077,930677
2023-04-18 10:52,930689,245971,484640,200078,930689
2023-04-18 10:53,930701,245982,484641,200078,930701
2023-04-18 10:54,930713,245992,484641,200080,930713
2023-04-18 10:55,930725,246000,484644,200081,930725
2023-04-18 10:56,930738,246013,484644,200081,930738
2023-04-18 10:57,930750,246023,484646,200081,930750
2023-04-18 10:58,930763,246036,484646,200081,930763
2023-04-18 10:59,930775,246047,484646,200082,930775
2023-04-18 11:00,930786,246057,484646,200083,930786
2023-04-18 11:01,930795,246061,484648,200086,930795
2023-04-18 11:02,930807,246073,484648,200086,930807
2023-04-18 11:03,930817,246079,484650,200088,930817
2023-04-18 11:04,930827,246088,484650,200089,930827
2023-04-18 11:05,930837,246093,484653,200091,930837
2023-04-18 11:06,930848,246104,484653,200091,930848
2023-04-18 11:07,930858,246112,484655,200091,930858
2023-04-18 11:08,930868,246121,484655,200092,930868
2023-04-18 11:09,930878,246124,484660,200094,930878
2023-04-18 11:10,930888,246134,484660,200094,930888
2023-04-18 11:11,930898,246142,484662,200094,930898
2023-04-18 11:12,930908,246152,484662,200094,930908
2023-04-18 11:13,930918,246160,484662,200096,930918
2023-04-18 11:14,930928,246170,484662,200096,930928
2023-04-18 11:15,930939,246180,484662,200097,930939
2023-04-18 11:16,930950,246189,484662,200099,930950
2023-04-18 11:17,930960,246191,484669,200100,930960
2023-04-18 11:18,930970,246198,484669,200103,930970
2023-04-18 11:19,930980,246202,484672,200106,930980
2023-04-18 11:20,930992,246211,484674,200107,930992
2023-04-18 11:21,931002,246220,484674,200108,931002
2023-04-18 11:22,931013,246229,484676,200108,931013
2023-04-18 11:23,931023,246237,484676,200110,931023
2023-04-18 11:24,931033,246241,484681,200111,931033
2023-04-18 11:26,931043,246248,484681,200114,931043
2023-04-18 11:27,931054,246257,484683,200114,931054
2023-04-18 11:28,931063,246266,484683,200114,931063
2023-04-18 11:29,931073,246274,484685,200114,931073
2023-04-18 11:30,931084,246284,484685,200115,931084
2023-04-18 11:31,931094,246290,484688,200116,931094
2023-04-18 11:32,931104,246298,484688,200118,931104
2023-04-18 11:33,931113,246302,484690,200121,931113
2023-04-18 11:34,931124,246313,484690,200121,931124
2023-04-18 11:35,931134,246322,484691,200121,931134
2023-04-18 11:36,931144,246332,484691,200121,931144
2023-04-18 11:37,931154,246342,484691,200121,931154
2023-04-18 11:38,931164,246351,484691,200122,931164
2023-04-18 11:39,931174,246359,484692,200123,931174
2023-04-18 11:40,931184,246368,484692,200124,931184
2023-04-18 11:41,931194,246375,484695,200124,931194
2023-04-18 11:42,931204,246385,484695,200124,931204
2023-04-18 11:43,931214,246391,484696,200127,931214
2023-04-18 11:44,931224,246401,484696,200127,931224
2023-04-18 11:45,931234,246407,484698,200129,931234
2023-04-18 11:46,931244,246417,484698,200129,931244
2023-04-18 11:47,931254,246423,484700,200131,931254
2023-04-18 11:48,931264,246433,484700,200131,931264
2023-04-18 11:49,931274,246435,484706,200133,931274
2023-04-18 11:50,931284,246445,484706,200133,931284
2023-04-18 11:51,931294,246448,484708,200138,931294
2023-04-18 11:52,931304,246455,484708,200141,931304
2023-04-18 11:53,931314,246463,484710,200141,931314
2023-04-18 11:54,931325,246473,484710,200142,931325
2023-04-18 11:55,931335,246481,484712,200142,931335
2023-04-18 11:56,931345,246490,484712,200143,931345
2023-04-18 11:57,931355,246497,484714,200144,931355
2023-04-18 11:58,931365,246507,484714,200144,931365
2023-04-18 11:59,931375,246510,484721,200144,931375
2023-04-18 12:00,931384,246519,484721,200144,931384
2023-04-18 12:01,931393,246526,484723,200144,931393
2023-04-18 12:02,931401,246534,484723,200144,931401
2023-04-18 12:03,931410,246540,484725,200145,931410
2023-04-18 12:04,931419,246546,484725,200148,931419
2023-04-18 12:05,931428,246548,484730,200150,931428
2023-04-18 12:06,931436,246554,484730,200152,931436
2023-04-18 12:07,931446,246560,484734,200152,931446
2023-04-18 12:08,931454,246565,484736,200153,931454
2023-04-18 12:09,931462,246571,484736,200155,931462
2023-04-18 12:10,931471,246578,484737,200156,931471
2023-04-18 12:11,931480,246587,484737,200156,931480
2023-04-18 12:12,931489,246590,484742,200157,931489
2023-04-18 12:14,931498,246594,484742,200162,931498
2023-04-18 12:15,931507,246599,484744,200164,931507
2023-04-18 12:16,931515,246606,484745,200164,931515
2023-04-18 12:17,931524,246613,484745,200166,931524
2023-04-18 12:18,931532,246615,484751,200166,931532
2023-04-18 12:19,931541,246622,484751,200168,931541
2023-04-18 12:20,931549,246626,484755,200168,931549
2023-04-18 12:21,931558,246632,484757,200169,931558
2023-04-18 12:22,931566,246639,484757,200170,931566
2023-04-18 12:23,931575,246647,484757,200171,931575
2023-04-18 12:24,931584,246653,484757,200174,931584
2023-04-18 12:25,931592,246659,484759,200174,931592
2023-04-18 12:26,931601,246664,484759,200178,931601
2023-04-18 12:27,931613,246675,484759,200179,931613
2023-04-18 12:28,931621,246683,484759,200179,931621
2023-04-18 12:29,931630,246687,484762,200181,931630
2023-04-18 12:30,931639,246693,484762,200184,931639
2023-04-18 12:31,931649,246702,484763,200184,931649
2023-04-18 12:32,931658,246711,484763,200184,931658
2023-04-18 12:33,931668,246717,484766,200185,931668
2023-04-18 12:34,931677,246723,484766,200188,931677
2023-04-18 12:35,931685,246726,484769,200190,931685
2023-04-18 12:36,931694,246733,484769,200192,931694
2023-04-18 12:37,931703,246736,484774,200193,931703
2023-04-18 12:38,931712,246745,484774,200193,931712
2023-04-18 12:39,931721,246751,484776,200194,931721
2023-04-18 12:40,931729,246756,484776,200197,931729
2023-04-18 12:41,931739,246763,484778,200198,931739
2023-04-18 12:42,931747,246768,484778,200201,931747
2023-04-18 12:43,931756,246775,484780,200201,931756
2023-04-18 12:44,931764,246779,484780,200205,931764
2023-04-18 12:45,931773,246782,484786,200205,931773
2023-04-18 12:46,931781,246785,484788,200208,931781
2023-04-18 12:47,931790,246794,484788,200208,931790
2023-04-18 12:48,931798,246797,484793,200208,931798
2023-04-18 12:49,931807,246804,484793,200210,931807
2023-04-18 12:50,931817,246808,484797,200212,931817
2023-04-18 12:51,931826,246815,484797,200214,931826
2023-04-18 12:52,931835,246821,484799,200215,931835
2023-04-18 12:53,931844,246830,484799,200215,931844
2023-04-18 12:54,931852,246835,484802,200215,931852
2023-04-18 12:55,931861,246841,484802,200218,931861
2023-04-18 12:56,931869,246840,484807,200222,931869
2023-04-18 12:57,931880,246851,484807,200222,931880
2023-04-18 12:58,931889,246857,484808,200224,931889
2023-04-18 13:01,931904,246866,484812,200226,931904
2023-04-18 13:02,931912,246873,484812,200227,931912
2023-04-18 13:03,931919,246874,484816,200229,931919
2023-04-18 13:04,931926,246881,484816,200229,931926
2023-04-18 13:05,931933,246885,484818,200230,931933
2023-04-18 13:06,931941,246891,484818,200232,931941
2023-04-18 13:07,931949,246896,484820,200233,931949
2023-04-18 13:08,931956,246903,484820,200233,931956
2023-04-18 13:09,931964,246906,484825,200233,931964
2023-04-18 13:10,931971,246911,484825,200235,931971
2023-04-18 13:11,931978,246917,484825,200236,931978
2023-04-18 13:12,931985,246923,484825,200237,931985
2023-04-18 13:13,931992,246929,484826,200237,931992
2023-04-18 13:14,932001,246933,484829,200239,932001
2023-04-18 13:15,932008,246939,484829,200240,932008
2023-04-18 13:16,932015,246944,484831,200240,932015
2023-04-18 13:17,932022,246949,484831,200242,932022
2023-04-18 13:18,932029,246956,484831,200242,932029
2023-04-18 13:19,932036,246963,484831,200242,932036
2023-04-18 13:20,932044,246968,484834,200242,932044
2023-04-18 13:21,932051,246975,484834,200242,932051
2023-04-18 13:22,932058,246976,484839,200243,932058
2023-04-18 13:23,932065,246983,484839,200243,932065
2023-04-18 13:24,932075,246988,484842,200245,932075
2023-04-18 13:25,932082,246995,484842,200245,932082
2023-04-18 13:26,932089,246999,484844,200246,932089
2023-04-18 13:27,932098,247007,484844,200247,932098
2023-04-18 13:28,932107,247011,484849,200247,932107
2023-04-18 13:29,932114,247014,484849,200251,932114
2023-04-18 13:30,932122,247019,484851,200252,932122
2023-04-18 13:31,932129,247026,484851,200252,932129
2023-04-18 13:32,932137,247031,484852,200254,932137
2023-04-18 13:33,932144,247037,484852,200255,932144
2023-04-18 13:34,932152,247043,484853,200256,932152
2023-04-18 13:35,932159,247047,484853,200259,932159
2023-04-18 13:36,932166,247050,484857,200259,932166
2023-04-18 13:37,932175,247059,484857,200259,932175
2023-04-18 13:38,932183,247066,484858,200259,932183
2023-04-18 13:39,932190,247072,484858,200260,932190
2023-04-18 13:40,932199,247078,484861,200260,932199
2023-04-18 13:41,932206,247083,484861,200262,932206
2023-04-18 13:42,932213,247086,484863,200264,932213
2023-04-18 13:43,932220,247090,484863,200267,932220
2023-04-18 13:44,932227,247094,484866,200267,932227
2023-04-18 13:45,932234,247100,484866,200268,932234
2023-04-18 13:46,932243,247105,484867,200271,932243
2023-04-18 13:48,932250,247110,484868,200272,932250
2023-04-18 13:49,932257,247117,484868,200272,932257
2023-04-18 13:50,932265,247119,484873,200273,932265
2023-04-18 13:51,932272,247126,484873,200273,932272
2023-04-18 13:52,932279,247131,484873,200275,932279
2023-04-18 13:53,932287,247135,484873,200279,932287
2023-04-18 13:54,932294,247138,484876,200280,932294
2023-04-18 13:55,932301,247144,484876,200281,932301
2023-04-18 13:56,932308,247149,484876,200283,932308
2023-04-18 13:57,932315,247156,484876,200283,932315
2023-04-18 13:58,932324,247161,484878,200285,932324
2023-04-18 13:59,932331,247167,484878,200286,932331
2023-04-18 14:00,932337,247171,484879,200287,932337
2023-04-18 14:01,932342,247176,484879,200287,932342
2023-04-18 14:02,932347,247179,484881,200287,932347
2023-04-18 14:03,932351,247183,484881,200287,932351
2023-04-18 14:04,932355,247187,484881,200287,932355
2023-04-18 14:05,932360,247190,484881,200289,932360
2023-04-18 14:06,932365,247191,484884,200290,932365
2023-04-18 14:07,932370,247193,484884,200293,932370
2023-04-18 14:08,932374,247197,484884,200293,932374
2023-04-18 14:09,932379,247200,484884,200295,932379
2023-04-18 14:10,932383,247200,484886,200297,932383
2023-04-18 14:11,932388,247205,484886,200297,932388
2023-04-18 14:12,932392,247206,484886,200300,932392
2023-04-18 14:13,932398,247213,484886,200299,932398
2023-04-18 14:14,932402,247214,484889,200299,932402
2023-04-18 14:15,932407,247219,484889,200299,932407
2023-04-18 14:16,932411,247222,484889,200300,932411
2023-04-18 14:17,932416,247224,484889,200303,932416
2023-04-18 14:18,932420,247224,484893,200303,932420
2023-04-18 14:19,932424,247226,484893,200305,932424
2023-04-18 14:20,932429,247228,484896,200305,932429
2023-04-18 14:21,932434,247231,484896,200307,932434
2023-04-18 14:22,932438,247231,484898,200309,932438
2023-04-18 14:23,932442,247235,484898,200309,932442
2023-04-18 14:24,932447,247239,484899,200309,932447
2023-04-18 14:25,932451,247242,484899,200310,932451
2023-04-18 14:26,932456,247244,484902,200310,932456
2023-04-18 14:27,932461,247249,484902,200310,932461
2023-04-18 14:28,932467,247252,484905,200310,932467
2023-04-18 14:29,932471,247255,484905,200311,932471
2023-04-18 14:30,932476,247259,484906,200311,932476
2023-04-18 14:31,932480,247260,484906,200314,932480
2023-04-18 14:32,932487,247263,484909,200315,932487
2023-04-18 14:33,932491,247266,484909,200316,932491
2023-04-18 14:35,932496,247268,484911,200317,932496
2023-04-18 14:36,932500,247272,484911,200317,932500
2023-04-18 14:37,932505,247274,484913,200318,932505
2023-04-18 14:38,932509,247277,484913,200319,932509
2023-04-18 14:39,932513,247280,484913,200320,932513
2023-04-18 14:40,932518,247281,484916,200321,932518
2023-04-18 14:41,932523,247286,484916,200321,932523
2023-04-18 14:42,932528,247286,484920,200322,932528
2023-04-18 14:43,932532,247290,484920,200322,932532
2023-04-18 14:44,932537,247294,484921,200322,932537
2023-04-18 14:45,932541,247296,484921,200324,932541
2023-04-18 14:46,932546,247300,484921,200325,932546
2023-04-18 14:47,932551,247302,484922,200327,932551
2023-04-18 14:48,932559,247308,484922,200329,932559
2023-04-18 14:50,932563,247311,484922,200330,932563
2023-04-18 14:51,932568,247314,484924,200330,932568
2023-04-18 14:52,932572,247317,484924,200331,932572
2023-04-18 14:53,932577,247314,484930,200333,932577
2023-04-18 14:54,932581,247317,484930,200334,932581
2023-04-18 14:55,932586,247319,484933,200334,932586
2023-04-18 14:56,932590,247321,484933,200336,932590
2023-04-18 14:57,932595,247323,484934,200338,932595
2023-04-18 14:58,932599,247324,484935,200340,932599
2023-04-18 14:59,932604,247330,484935,200339,932604
2023-04-18 15:00,932608,247331,484936,200341,932608
2023-04-18 15:01,932613,247336,484936,200341,932613
2023-04-18 15:02,932618,247340,484937,200341,932618
2023-04-18 15:03,932624,247345,484937,200342,932624
2023-04-18 15:04,932629,247348,484939,200342,932629
2023-04-18 15:05,932634,247353,484939,200342,932634
2023-04-18 15:06,932639,247353,484943,200343,932639
2023-04-18 15:07,932644,247358,484943,200343,932644
2023-04-18 15:08,932649,247362,484943,200344,932649
2023-04-18 15:09,932654,247367,484943,200344,932654
2023-04-18 15:10,932660,247372,484944,200344,932660
2023-04-18 15:11,932665,247375,484944,200346,932665
2023-04-18 15:12,932670,247373,484945,200352,932670
2023-04-18 15:13,932675,247377,484945,200353,932675
2023-04-18 15:14,932680,247378,484948,200354,932680
2023-04-18 15:15,932685,247382,484948,200355,932685
2023-04-18 15:16,932690,247383,484952,200355,932690
2023-04-18 15:17,932695,247387,484952,200356,932695
2023-04-18 15:18,932700,247388,484953,200359,932700
2023-04-18 15:19,932705,247391,484953,200361,932705
2023-04-18 15:20,932710,247390,484957,200363,932710
2023-04-18 15:21,932716,247395,484957,200364,932716
2023-04-18 15:22,932721,247397,484959,200365,932721
2023-04-18 15:23,932726,247402,484959,200365,932726
2023-04-18 15:24,932731,247407,484959,200365,932731
2023-04-18 15:25,932736,247412,484959,200365,932736
2023-04-18 15:26,932741,247411,484963,200367,932741
2023-04-18 15:27,932746,247415,484964,200367,932746
2023-04-18 15:28,932751,247417,484964,200370,932751
2023-04-18 15:29,932755,247419,484966,200370,932755
2023-04-18 15:30,932761,247424,484966,200371,932761
2023-04-18 15:31,932765,247427,484966,200372,932765
2023-04-18 15:32,932771,247432,484967,200372,932771
2023-04-18 15:33,932775,247436,484967,200372,932775
2023-04-18 15:34,932781,247437,484970,200374,932781
2023-04-18 15:35,932785,247439,484970,200376,932785
2023-04-18 15:37,932790,247443,484971,200376,932790
2023-04-18 15:38,932795,247448,484971,200376,932795
2023-04-18 15:39,932801,247452,484974,200375,932801
2023-04-18 15:40,932806,247455,484974,200377,932806
2023-04-18 15:41,932811,247459,484975,200377,932811
2023-04-18 15:42,932816,247463,484975,200378,932816
2023-04-18 15:43,932821,247465,484977,200379,932821
2023-04-18 15:44,932826,247468,484977,200381,932826
2023-04-18 15:45,932831,247469,484981,200381,932831
2023-04-18 15:46,932836,247473,484981,200382,932836
2023-04-18 15:47,932841,247473,484984,200384,932841
2023-04-18 15:48,932846,247477,484984,200385,932846
2023-04-18 15:49,932852,247479,484988,200385,932852
2023-04-18 15:50,932857,247484,484988,200385,932857
2023-04-18 15:51,932862,247489,484988,200385,932862
2023-04-18 15:52,932868,247493,484988,200387,932868
2023-04-18 15:53,932873,247496,484988,200389,932873
2023-04-18 15:54,932879,247501,484988,200390,932879
2023-04-18 15:55,932884,247504,484988,200392,932884
2023-04-18 15:56,932889,247508,484988,200393,932889
2023-04-18 15:57,932894,247511,484988,200395,932894
2023-04-18 15:58,932899,247506,484996,200397,932899
2023-04-18 15:59,932904,247508,484996,200400,932904
2023-04-18 16:00,932908,247508,485000,200400,932908
2023-04-18 16:01,932914,247514,485000,200400,932914
2023-04-18 16:02,932918,247515,485002,200401,932918
2023-04-18 16:03,932922,247518,485003,200401,932922
2023-04-18 16:04,932927,247523,485003,200401,932927
2023-04-18 16:05,932932,247525,485006,200401,932932
2023-04-18 16:06,932936,247527,485006,200403,932936
2023-04-18 16:07,932941,247527,485010,200404,932941
2023-04-18 16:08,932946,247529,485010,200407,932946
2023-04-18 16:09,932950,247529,485014,200407,932950
2023-04-18 16:10,932955,247534,485014,200407,932955
2023-04-18 16:11,932959,247533,485016,200410,932959
2023-04-18 16:12,932965,247536,485016,200413,932965
2023-04-18 16:13,932969,247534,485022,200413,932969
2023-04-18 16:14,932973,247537,485022,200414,932973
2023-04-18 16:15,932979,247540,485025,200414,932979
2023-04-18 16:16,932983,247542,485025,200416,932983
2023-04-18 16:17,932987,247542,485027,200418,932987
2023-04-18 16:18,932992,247545,485027,200420,932992
2023-04-18 16:19,932996,247549,485027,200420,932996
2023-04-18 16:20,933000,247553,485027,200420,933000
2023-04-18 16:21,933005,247558,485027,200420,933005
2023-04-18 16:22,933009,247561,485027,200421,933009
2023-04-18 16:24,933014,247562,485030,200422,933014
2023-04-18 16:25,933019,247567,485030,200422,933019
2023-04-18 16:26,933023,247570,485031,200422,933023
2023-04-18 16:27,933028,247574,485031,200423,933028
2023-04-18 16:28,933033,247576,485034,200423,933033
2023-04-18 16:29,933038,247580,485034,200424,933038
2023-04-18 16:30,933042,247582,485035,200425,933042
2023-04-18 16:31,933047,247583,485035,200429,933047
2023-04-18 16:32,933051,247584,485037,200430,933051
2023-04-18 16:33,933055,247587,485037,200431,933055
2023-04-18 16:34,933061,247590,485039,200432,933061
2023-04-18 16:35,933065,247594,485039,200432,933065
2023-04-18 16:36,933069,247598,485039,200432,933069
2023-04-18 16:37,933074,247601,485039,200434,933074
2023-04-18 16:38,933078,247602,485041,200435,933078
2023-04-18 16:39,933083,247608,485041,200434,933083
2023-04-18 16:40,933090,247610,485044,200436,933090
2023-04-18 16:41,933094,247614,485044,200436,933094
2023-04-18 16:42,933099,247618,485044,200437,933099
2023-04-18 16:43,933104,247620,485044,200440,933104
2023-04-18 16:44,933109,247625,485043,200441,933109
2023-04-18 16:45,933114,247630,485043,200441,933114
2023-04-18 16:46,933118,247626,485049,200443,933118
2023-04-18 16:47,933122,247627,485051,200444,933122
2023-04-18 16:48,933126,247628,485051,200447,933126
2023-04-18 16:49,933131,247631,485052,200448,933131
2023-04-18 16:50,933135,247634,485052,200449,933135
2023-04-18 16:51,933140,247637,485054,200449,933140
2023-04-18 16:52,933145,247641,485054,200450,933145
2023-04-18 16:53,933149,247639,485059,200451,933149
2023-04-18 16:54,933154,247643,485059,200452,933154
2023-04-18 16:55,933158,247645,485061,200452,933158
2023-04-18 16:56,933162,247648,485061,200453,933162
2023-04-18 16:57,933166,247649,485063,200454,933166
2023-04-18 16:58,933171,247651,485065,200455,933171
2023-04-18 16:59,933175,247651,485069,200455,933175
2023-04-18 17:00,933180,247652,485070,200458,933180
2023-04-18 17:01,933184,247656,485070,200458,933184
2023-04-18 17:02,933189,247659,485072,200458,933189
2023-04-18 17:03,933194,247661,485072,200461,933194
2023-04-18 17:04,933198,247661,485075,200462,933198
2023-04-18 17:05,933204,247666,485075,200463,933204
2023-04-18 17:06,933209,247669,485077,200463,933209
2023-04-18 17:07,933213,247672,485077,200464,933213
2023-04-18 17:08,933218,247672,485081,200465,933218
2023-04-18 17:09,933223,247676,485081,200466,933223
2023-04-18 17:10,933227,247678,485082,200467,933227
2023-04-18 17:12,933232,247682,485082,200468,933232
2023-04-18 17:13,933238,247682,485087,200469,933238
2023-04-18 17:14,933242,247685,485087,200470,933242
2023-04-18 17:15,933247,247687,485090,200470,933247
2023-04-18 17:16,933252,247689,485090,200473,933252
2023-04-18 17:17,933256,247689,485092,200475,933256
2023-04-18 17:18,933263,247695,485092,200476,933263
2023-04-18 17:19,933268,247698,485094,200476,933268
2023-04-18 17:20,933272,247702,485094,200476,933272
2023-04-18 17:21,933278,247706,485095,200477,933278
2023-04-18 17:22,933282,247708,485095,200479,933282
2023-04-18 17:23,933287,247708,485099,200480,933287
2023-04-18 17:24,933292,247710,485101,200481,933292
2023-04-18 17:25,933297,247712,485101,200484,933297
2023-04-18 17:26,933302,247713,485103,200486,933302
2023-04-18 17:27,933307,247717,485103,200487,933307
2023-04-18 17:28,933311,247720,485104,200487,933311
2023-04-18 17:29,933317,247724,485104,200489,933317
2023-04-18 17:30,933321,247724,485108,200489,933321
2023-04-18 17:31,933326,247728,485108,200490,933326
2023-04-18 17:32,933331,247729,485111,200491,933331
2023-04-18 17:33,933336,247734,485111,200491,933336
2023-04-18 17:34,933342,247739,485112,200491,933342
2023-04-18 17:35,933347,247744,485112,200491,933347
2023-04-18 17:36,933352,247746,485115,200491,933352
2023-04-18 17:37,933357,247751,485115,200491,933357
2023-04-18 17:38,933362,247754,485116,200492,933362
2023-04-18 17:39,933366,247756,485116,200494,933366
2023-04-18 17:40,933372,247760,485118,200494,933372
2023-04-18 17:41,933377,247765,485118,200494,933377
2023-04-18 17:42,933382,247768,485120,200494,933382
2023-04-18 17:43,933387,247772,485120,200495,933387
2023-04-18 17:44,933393,247776,485121,200496,933393
2023-04-18 17:45,933397,247780,485121,200496,933397
2023-04-18 17:46,933402,247780,485125,200497,933402
2023-04-18 17:47,933407,247784,485125,200498,933407
2023-04-18 17:48,933411,247787,485125,200499,933411
2023-04-18 17:49,933417,247793,485125,200499,933417
2023-04-18 17:50,933422,247794,485129,200499,933422
2023-04-18 17:51,933426,247796,485129,200501,933426
2023-04-18 17:52,933431,247799,485130,200502,933431
2023-04-18 17:53,933436,247801,485130,200505,933436
2023-04-18 17:54,933440,247799,485134,200507,933440
2023-04-18 17:55,933445,247802,485136,200507,933445
2023-04-18 17:56,933449,247806,485136,200507,933449
2023-04-18 17:57,933454,247809,485137,200508,933454
2023-04-18 17:58,933459,247814,485137,200508,933459
2023-04-18 18:00,933463,247811,485143,200509,933463
2023-04-18 18:01,933471,247818,485143,200510,933471
2023-04-18 18:02,933481,247827,485144,200510,933481
2023-04-18 18:03,933489,247833,485144,200512,933489
2023-04-18 18:04,933497,247839,485146,200512,933497
2023-04-18 18:05,933506,247846,485146,200514,933506
2023-04-18 18:06,933514,247847,485150,200517,933514
2023-04-18 18:07,933523,247853,485150,200520,933523
2023-04-18 18:08,933532,247857,485154,200521,933532
2023-04-18 18:09,933543,247864,485154,200525,933543
2023-04-18 18:10,933551,247870,485155,200526,933551
2023-04-18 18:11,933560,247877,485155,200528,933560
2023-04-18 18:12,933569,247879,485160,200530,933569
2023-04-18 18:13,933577,247887,485160,200530,933577
2023-04-18 18:14,933586,247893,485161,200532,933586
2023-04-18 18:15,933594,247901,485161,200532,933594
2023-04-18 18:16,933602,247907,485162,200533,933602
2023-04-18 18:17,933611,247916,485162,200533,933611
2023-04-18 18:18,933620,247924,485162,200534,933620
2023-04-18 18:19,933628,247930,485162,200536,933628
2023-04-18 18:20,933637,247935,485165,200537,933637
2023-04-18 18:21,933647,247943,485165,200539,933647
2023-04-18 18:22,933655,247950,485165,200540,933655
2023-04-18 18:23,933664,247957,485165,200542,933664
2023-04-18 18:24,933672,247965,485165,200542,933672
2023-04-18 18:25,933681,247974,485165,200542,933681
2023-04-18 18:26,933690,247980,485167,200543,933690
2023-04-18 18:27,933699,247986,485167,200546,933699
2023-04-18 18:28,933707,247992,485167,200548,933707
2023-04-18 18:29,933715,247999,485167,200549,933715
2023-04-18 18:30,933724,248008,485167,200549,933724
2023-04-18 18:31,933733,248015,485167,200551,933733
2023-04-18 18:32,933741,248021,485167,200553,933741
2023-04-18 18:33,933750,248029,485167,200554,933750
2023-04-18 18:34,933758,248037,485167,200554,933758
2023-04-18 18:35,933767,248046,485167,200554,933767
2023-04-18 18:36,933775,248042,485179,200554,933775
2023-04-18 18:37,933784,248048,485179,200557,933784
2023-04-18 18:38,933792,248054,485179,200559,933792
2023-04-18 18:39,933801,248063,485179,200559,933801
2023-04-18 18:40,933810,248072,485179,200559,933810
2023-04-18 18:41,933819,248079,485179,200561,933819
2023-04-18 18:42,933828,248087,485179,200562,933828
2023-04-18 18:43,933837,248094,485179,200564,933837
2023-04-18 18:44,933845,248101,485179,200565,933845
2023-04-18 18:45,933855,248096,485194,200565,933855
2023-04-18 18:46,933864,248102,485194,200568,933864
2023-04-18 18:48,933873,248107,485197,200569,933873
2023-04-18 18:49,933881,248112,485199,200570,933881
2023-04-18 18:50,933890,248121,485199,200570,933890
2023-04-18 18:51,933899,248128,485201,200570,933899
2023-04-18 18:52,933907,248132,485204,200571,933907
2023-04-18 18:53,933916,248138,485204,200574,933916
2023-04-18 18:54,933924,248143,485207,200574,933924
2023-04-18 18:55,933934,248151,485207,200576,933934
2023-04-18 18:56,933942,248155,485211,200576,933942
2023-04-18 18:57,933951,248163,485211,200577,933951
2023-04-18 18:58,933960,248168,485213,200579,933960
2023-04-18 18:59,933969,248176,485213,200580,933969
2023-04-18 19:00,933978,248184,485213,200581,933978
2023-04-18 19:01,933992,248198,485213,200581,933992
2023-04-18 19:02,934004,248205,485217,200582,934004
2023-04-18 19:03,934017,248216,485217,200584,934017
2023-04-18 19:04,934031,248226,485220,200585,934031
2023-04-18 19:05,934043,248237,485220,200586,934043
2023-04-18 19:06,934057,248245,485224,200588,934057
2023-04-18 19:07,934071,248259,485224,200588,934071
2023-04-18 19:08,934086,248271,485227,200588,934086
2023-04-18 19:09,934098,248282,485228,200588,934098
2023-04-18 19:10,934111,248294,485228,200589,934111
2023-04-18 19:11,934125,248305,485230,200590,934125
2023-04-18 19:12,934138,248317,485230,200591,934138
2023-04-18 19:13,934150,248322,485236,200592,934150
2023-04-18 19:14,934164,248335,485236,200593,934164
2023-04-18 19:15,934177,248345,485238,200594,934177
2023-04-18 19:16,934191,248357,485238,200596,934191
2023-04-18 19:17,934204,248365,485241,200598,934204
2023-04-18 19:18,934218,248376,485241,200601,934218
2023-04-18 19:19,934231,248386,485243,200602,934231
2023-04-18 19:20,934244,248399,485243,200602,934244
2023-04-18 19:21,934258,248411,485245,200602,934258
2023-04-18 19:22,934271,248423,485245,200603,934271
2023-04-18 19:23,934284,248433,485247,200604,934284
2023-04-18 19:24,934297,248444,485247,200606,934297
2023-04-18 19:25,934310,248451,485252,200607,934310
2023-04-18 19:26,934323,248463,485252,200608,934323
2023-04-18 19:27,934336,248473,485254,200609,934336
2023-04-18 19:28,934349,248486,485254,200609,934349
2023-04-18 19:29,934362,248496,485256,200610,934362
2023-04-18 19:30,934376,248510,485256,200610,934376
2023-04-18 19:31,934389,248521,485257,200611,934389
2023-04-18 19:32,934402,248532,485257,200613,934402
2023-04-18 19:33,934415,248544,485257,200614,934415
2023-04-18 19:35,934428,248557,485257,200614,934428
2023-04-18 19:36,934441,248568,485259,200614,934441
2023-04-18 19:37,934454,248579,485259,200616,934454
2023-04-18 19:38,934468,248591,485259,200618,934468
2023-04-18 19:39,934480,248599,485262,200619,934480
2023-04-18 19:40,934494,248613,485262,200619,934494
2023-04-18 19:41,934508,248627,485262,200619,934508
2023-04-18 19:42,934521,248640,485262,200619,934521
2023-04-18 19:43,934535,248653,485262,200620,934535
2023-04-18 19:44,934548,248664,485262,200622,934548
2023-04-18 19:45,934562,248675,485262,200625,934562
2023-04-18 19:46,934576,248689,485262,200625,934576
2023-04-18 19:47,934588,248701,485262,200625,934588
2023-04-18 19:48,934602,248714,485262,200626,934602
2023-04-18 19:49,934615,248714,485274,200627,934615
2023-04-18 19:50,934628,248726,485274,200628,934628
2023-04-18 19:51,934642,248737,485277,200628,934642
2023-04-18 19:52,934655,248746,485279,200630,934655
2023-04-18 19:53,934669,248759,485279,200631,934669
2023-04-18 19:54,934682,248769,485281,200632,934682
2023-04-18 19:55,934695,248779,485281,200635,934695
2023-04-18 19:56,934708,248789,485282,200637,934708
2023-04-18 19:57,934721,248798,485286,200637,934721
2023-04-18 19:58,934734,248811,485286,200637,934734
2023-04-18 19:59,934749,248819,485292,200638,934749
2023-04-18 20:00,934760,248828,485292,200640,934760
2023-04-18 20:01,934768,248833,485292,200643,934768
2023-04-18 20:02,934776,248841,485292,200643,934776
2023-04-18 20:03,934784,248846,485295,200643,934784
2023-04-18 20:04,934793,248855,485295,200643,934793
2023-04-18 20:05,934803,248863,485297,200643,934803
2023-04-18 20:06,934811,248866,485300,200645,934811
2023-04-18 20:07,934819,248873,485300,200646,934819
2023-04-18 20:08,934828,248873,485307,200648,934828
2023-04-18 20:09,934836,248878,485308,200650,934836
2023-04-18 20:10,934844,248882,485308,200654,934844
2023-04-18 20:11,934852,248888,485310,200654,934852
2023-04-18 20:12,934861,248895,485310,200656,934861
2023-04-18 20:13,934869,248900,485313,200656,934869
2023-04-18 20:14,934878,248904,485313,200661,934878
2023-04-18 20:15,934887,248911,485315,200661,934887
2023-04-18 20:16,934895,248916,485317,200662,934895
2023-04-18 20:17,934903,248923,485317,200663,934903
2023-04-18 20:18,934912,248927,485321,200664,934912
2023-04-18 20:19,934920,248934,485322,200664,934920
2023-04-18 20:20,934928,248942,485322,200664,934928
2023-04-18 20:21,934936,248945,485326,200665,934936
2023-04-18 20:23,934944,248953,485326,200665,934944
2023-04-18 20:24,934953,248960,485328,200665,934953
2023-04-18 20:25,934961,248967,485328,200666,934961
2023-04-18 20:26,934969,248972,485329,200668,934969
2023-04-18 20:27,934978,248981,485329,200668,934978
2023-04-18 20:28,934986,248988,485329,200669,934986
2023-04-18 20:29,934994,248992,485329,200673,934994
2023-04-18 20:30,935003,248997,485332,200674,935003
2023-04-18 20:31,935011,249002,485332,200677,935011
2023-04-18 20:32,935019,249005,485336,200678,935019
2023-04-18 20:33,935028,249015,485336,200677,935028
2023-04-18 20:34,935035,249016,485341,200678,935035
2023-04-18 20:35,935044,249025,485341,200678,935044
2023-04-18 20:36,935053,249029,485345,200679,935053
2023-04-18 20:37,935061,249036,485345,200680,935061
2023-04-18 20:38,935069,249037,485348,200684,935069
2023-04-18 20:39,935078,249043,485351,200684,935078
2023-04-18 20:40,935086,249050,485351,200685,935086
2023-04-18 20:41,935094,249054,485354,200686,935094
2023-04-18 20:42,935105,249065,485354,200686,935105
2023-04-18 20:43,935115,249072,485356,200687,935115
2023-04-18 20:44,935124,249079,485356,200689,935124
2023-04-18 20:45,935132,249086,485357,200689,935132
2023-04-18 20:46,935140,249094,485357,200689,935140
2023-04-18 20:47,935148,249099,485358,200691,935148
2023-04-18 20:48,935156,249107,485358,200691,935156
2023-04-18 20:49,935165,249112,485362,200691,935165
2023-04-18 20:50,935173,249117,485362,200694,935173
2023-04-18 20:51,935182,249121,485365,200696,935182
2023-04-18 20:52,935190,249127,485365,200698,935190
2023-04-18 20:53,935198,249134,485365,200699,935198
2023-04-18 20:54,935206,249140,485365,200701,935206
2023-04-18 20:55,935214,249139,485372,200703,935214
2023-04-18 20:56,935224,249148,485372,200704,935224
2023-04-18 20:57,935232,249152,485376,200704,935232
2023-04-18 20:58,935240,249158,485376,200706,935240
2023-04-18 20:59,935248,249161,485380,200707,935248
2023-04-18 21:00,935259,249170,485380,200709,935259
2023-04-18 21:01,935270,249176,485381,200713,935270
2023-04-18 21:02,935281,249186,485381,200714,935281
2023-04-18 21:03,935292,249187,485389,200716,935292
2023-04-18 21:04,935303,249196,485389,200718,935303
2023-04-18 21:05,935313,249199,485392,200722,935313
2023-04-18 21:06,935324,249210,485392,200722,935324
2023-04-18 21:07,935334,249216,485396,200722,935334
2023-04-18 21:09,935345,249227,485396,200722,935345
2023-04-18 21:10,935355,249231,485402,200722,935355
2023-04-18 21:11,935367,249242,485402,200723,935367
2023-04-18 21:12,935377,249248,485406,200723,935377
2023-04-18 21:13,935388,249257,485407,200724,935388
2023-04-18 21:14,935398,249265,485409,200724,935398
2023-04-18 21:15,935409,249275,485409,200725,935409
2023-04-18 21:16,935420,249284,485410,200726,935420
2023-04-18 21:17,935430,249294,485410,200726,935430
2023-04-18 21:18,935441,249302,485413,200726,935441
2023-04-18 21:19,935451,249310,485413,200728,935451
2023-04-18 21:20,935463,249319,485415,200729,935463
2023-04-18 21:21,935474,249328,485415,200731,935474
2023-04-18 21:22,935484,249336,485417,200731,935484
2023-04-18 21:23,935495,249347,485417,200731,935495
2023-04-18 21:24,935505,249354,485420,200731,935505
2023-04-18 21:25,935517,249365,485420,200732,935517
2023-04-18 21:26,935528,249371,485425,200732,935528
2023-04-18 21:27,935539,249380,485425,200734,935539
2023-04-18 21:28,935550,249387,485428,200735,935550
2023-04-18 21:29,935561,249397,485428,200736,935561
2023-04-18 21:30,935571,249407,485427,200737,935571
2023-04-18 21:31,935582,249413,485430,200739,935582
2023-04-18 21:32,935593,249423,485430,200740,935593
2023-04-18 21:33,935604,249434,485429,200741,935604
2023-04-18 21:34,935615,249442,485429,200744,935615
2023-04-18 21:35,935626,249451,485429,200746,935626
2023-04-18 21:36,935637,249461,485429,200747,935637
2023-04-18 21:37,935647,249469,485429,200749,935647
2023-04-18 21:38,935658,249479,485429,200750,935658
2023-04-18 21:39,935668,249487,485429,200752,935668
2023-04-18 21:40,935679,249487,485439,200753,935679
2023-04-18 21:41,935690,249498,485439,200753,935690
2023-04-18 21:42,935702,249506,485442,200754,935702
2023-04-18 21:43,935712,249516,485442,200754,935712
2023-04-18 21:44,935723,249523,485444,200756,935723
2023-04-18 21:45,935733,249533,485444,200756,935733
2023-04-18 21:46,935745,249544,485444,200757,935745
2023-04-18 21:47,935755,249552,485444,200759,935755
2023-04-18 21:48,935765,249559,485447,200759,935765
2023-04-18 21:49,935776,249566,485449,200761,935776
2023-04-18 21:50,935787,249574,485449,200764,935787
2023-04-18 21:51,935797,249577,485455,200765,935797
2023-04-18 21:52,935808,249588,485455,200765,935808
2023-04-18 21:53,935819,249594,485459,200766,935819
2023-04-18 21:54,935830,249603,485461,200766,935830
2023-04-18 21:56,935842,249611,485461,200770,935842
2023-04-18 21:57,935854,249613,485468,200773,935854
2023-04-18 21:58,935865,249623,485469,200773,935865
2023-04-18 21:59,935875,249632,485469,200774,935875
2023-04-18 22:00,935886,249640,485472,200774,935886
2023-04-18 22:01,935899,249654,485472,200773,935899
2023-04-18 22:02,935912,249661,485474,200777,935912
2023-04-18 22:03,935925,249674,485474,200777,935925
2023-04-18 22:04,935938,249683,485477,200778,935938
2023-04-18 22:05,935950,249695,485477,200778,935950
2023-04-18 22:06,935964,249700,485481,200783,935964
2023-04-18 22:07,935977,249712,485481,200784,935977
2023-04-18 22:08,935989,249719,485485,200785,935989
2023-04-18 22:09,936002,249729,485485,200788,936002
2023-04-18 22:10,936015,249739,485487,200789,936015
2023-04-18 22:11,936029,249751,485487,200791,936029
2023-04-18 22:12,936042,249760,485489,200793,936042
2023-04-18 22:13,936054,249772,485489,200793,936054
2023-04-18 22:14,936067,249779,485494,200794,936067
2023-04-18 22:15,936081,249791,485494,200796,936081
2023-04-18 22:16,936094,249799,485498,200797,936094
2023-04-18 22:17,936107,249807,485498,200802,936107
2023-04-18 22:18,936120,249809,485507,200804,936120
2023-04-18 22:19,936132,249820,485507,200805,936132
2023-04-18 22:20,936146,249827,485511,200808,936146
2023-04-18 22:21,936159,249840,485511,200808,936159
2023-04-18 22:22,936172,249852,485511,200809,936172
2023-04-18 22:23,936185,249858,485514,200813,936185
2023-04-18 22:24,936197,249867,485514,200816,936197
2023-04-18 22:25,936211,249875,485518,200818,936211
2023-04-18 22:26,936225,249883,485521,200821,936225
2023-04-18 22:27,936237,249893,485521,200823,936237
2023-04-18 22:28,936250,249900,485526,200824,936250
2023-04-18 22:29,936262,249909,485527,200826,936262
2023-04-18 22:30,936275,249920,485528,200827,936275
2023-04-18 22:31,936289,249934,485528,200827,936289
2023-04-18 22:32,936302,249941,485533,200828,936302
2023-04-18 22:33,936315,249953,485533,200829,936315
2023-04-18 22:34,936328,249965,485534,200829,936328
2023-04-18 22:35,936341,249974,485534,200833,936341
2023-04-18 22:36,936354,249982,485538,200834,936354
2023-04-18 22:37,936368,249995,485538,200835,936368
2023-04-18 22:38,936381,250006,485539,200836,936381
2023-04-18 22:39,936395,250019,485539,200837,936395
2023-04-18 22:40,936408,250026,485541,200841,936408
2023-04-18 22:41,936421,250032,485546,200843,936421
2023-04-18 22:43,936434,250043,485546,200845,936434
2023-04-18 22:44,936446,250048,485551,200847,936446
2023-04-18 22:45,936460,250059,485553,200848,936460
2023-04-18 22:46,936473,250070,485554,200849,936473
2023-04-18 22:47,936486,250082,485554,200850,936486
2023-04-18 22:48,936499,250085,485562,200852,936499
2023-04-18 22:49,936512,250097,485562,200853,936512
2023-04-18 22:50,936525,250107,485564,200854,936525
2023-04-18 22:51,936539,250119,485564,200856,936539
2023-04-18 22:52,936552,250125,485570,200857,936552
2023-04-18 22:53,936565,250135,485570,200860,936565
2023-04-18 22:54,936577,250143,485572,200862,936577
2023-04-18 22:55,936591,250155,485572,200864,936591
2023-04-18 22:56,936604,250162,485577,200865,936604
2023-04-18 22:57,936616,250169,485577,200870,936616
2023-04-18 22:58,936629,250173,485585,200871,936629
2023-04-18 22:59,936644,250187,485585,200872,936644
2023-04-18 23:00,936655,250194,485588,200873,936655
2023-04-18 23:01,936663,250197,485588,200878,936663
2023-04-18 23:02,936671,250203,485590,200878,936671
2023-04-18 23:03,936679,250210,485590,200879,936679
2023-04-18 23:04,936687,250213,485593,200881,936687
2023-04-18 23:05,936695,250220,485593,200882,936695
2023-04-18 23:06,936704,250224,485595,200885,936704
2023-04-18 23:07,936712,250228,485595,200889,936712
2023-04-18 23:08,936720,250232,485599,200889,936720
2023-04-18 23:09,936729,250237,485601,200891,936729
2023-04-18 23:10,936737,250243,485601,200893,936737
2023-04-18 23:11,936746,250245,485607,200894,936746
2023-04-18 23:12,936754,250253,485607,200894,936754
2023-04-18 23:13,936762,250259,485607,200896,936762
2023-04-18 23:14,936770,250265,485607,200898,936770
2023-04-18 23:15,936778,250265,485612,200901,936778
2023-04-18 23:16,936786,250273,485612,200901,936786
2023-04-18 23:17,936795,250277,485615,200903,936795
2023-04-18 23:18,936803,250284,485615,200904,936803
2023-04-18 23:19,936810,250285,485617,200908,936810
2023-04-18 23:20,936819,250291,485617,200911,936819
2023-04-18 23:21,936827,250295,485620,200912,936827
2023-04-18 23:22,936836,250302,485621,200913,936836
2023-04-18 23:23,936844,250310,485621,200913,936844
2023-04-18 23:24,936852,250313,485624,200915,936852
2023-04-18 23:25,936860,250319,485624,200917,936860
2023-04-18 23:26,936868,250319,485631,200918,936868
2023-04-18 23:27,936876,250325,485631,200920,936876
2023-04-18 23:28,936885,250326,485638,200921,936885
2023-04-18 23:30,936893,250334,485638,200921,936893
2023-04-18 23:31,936901,250337,485642,200922,936901
2023-04-18 23:32,936909,250343,485643,200923,936909
2023-04-18 23:33,936917,250351,485643,200923,936917
2023-04-18 23:34,936926,250354,485646,200926,936926
2023-04-18 23:35,936934,250362,485646,200926,936934
2023-04-18 23:36,936942,250362,485652,200928,936942
2023-04-18 23:37,936950,250368,485652,200930,936950
2023-04-18 23:38,936957,250371,485655,200931,936957
2023-04-18 23:39,936967,250379,485655,200933,936967
2023-04-18 23:40,936977,250385,485657,200935,936977
2023-04-18 23:41,936985,250393,485657,200935,936985
2023-04-18 23:42,936995,250401,485658,200936,936995
2023-04-18 23:43,937003,250408,485658,200937,937003
2023-04-18 23:44,937011,250410,485663,200938,937011
2023-04-18 23:45,937019,250418,485663,200938,937019
2023-04-18 23:46,937028,250419,485668,200941,937028
2023-04-18 23:47,937037,250428,485668,200941,937037
2023-04-18 23:48,937045,250434,485669,200942,937045
2023-04-18 23:49,937054,250441,485669,200944,937054
2023-04-18 23:50,937062,250441,485677,200944,937062
2023-04-18 23:51,937071,250449,485677,200945,937071
2023-04-18 23:52,937079,250454,485679,200946,937079
2023-04-18 23:53,937087,250460,485679,200948,937087
2023-04-18 23:54,937095,250464,485681,200950,937095
2023-04-18 23:55,937104,250472,485681,200951,937104
2023-04-18 23:56,937112,250471,485687,200954,937112
2023-04-18 23:57,937121,250478,485687,200956,937121
2023-04-18 23:58,937129,250481,485691,200957,937129
2023-04-18 23:59,937138,250488,485691,200959,937138
2023-04-19 00:00,937146,250493,485694,200959,937146
2023-04-19 00:01,937155,250501,485694,200960,937155
2023-04-19 00:02,937164,250509,485694,200961,937164
2023-04-19 00:03,937172,250516,485694,200962,937172
2023-04-19 00:04,937179,250517,485698,200964,937179
2023-04-19 00:05,937188,250525,485698,200965,937188
2023-04-19 00:06,937195,250525,485701,200969,937195
2023-04-19 00:07,937203,250532,485701,200970,937203
2023-04-19 00:08,937211,250537,485702,200972,937211
2023-04-19 00:09,937219,250542,485702,200975,937219
2023-04-19 00:10,937227,250549,485703,200975,937227
2023-04-19 00:11,937234,250554,485703,200977,937234
2023-04-19 00:12,937242,250560,485705,200977,937242
2023-04-19 00:13,937250,250568,485705,200977,937250
2023-04-19 00:14,937260,250578,485706,200976,937260
2023-04-19 00:15,937268,250584,485708,200976,937268
2023-04-19 00:17,937276,250589,485708,200979,937276
2023-04-19 00:18,937284,250595,485708,200981,937284
2023-04-19 00:19,937291,250599,485708,200984,937291
2023-04-19 00:20,937299,250606,485708,200985,937299
2023-04-19 00:21,937307,250612,485708,200987,937307
2023-04-19 00:22,937315,250617,485708,200990,937315
2023-04-19 00:23,937323,250622,485708,200993,937323
2023-04-19 00:24,937331,250629,485708,200994,937331
2023-04-19 00:25,937339,250633,485708,200998,937339
2023-04-19 00:26,937346,250622,485725,200999,937346
2023-04-19 00:27,937354,250628,485725,201001,937354
2023-04-19 00:28,937363,250637,485725,201001,937363
2023-04-19 00:29,937371,250645,485725,201001,937371
2023-04-19 00:30,937379,250652,485725,201002,937379
2023-04-19 00:31,937387,250658,485725,201004,937387
2023-04-19 00:32,937395,250666,485725,201004,937395
2023-04-19 00:33,937403,250672,485725,201006,937403
2023-04-19 00:34,937411,250677,485725,201009,937411
2023-04-19 00:35,937419,250682,485725,201012,937419
2023-04-19 00:36,937427,250669,485743,201015,937427
2023-04-19 00:37,937435,250677,485743,201015,937435
2023-04-19 00:38,937444,250685,485743,201016,937444
2023-04-19 00:39,937452,250692,485743,201017,937452
2023-04-19 00:40,937459,250697,485743,201019,937459
2023-04-19 00:41,937467,250705,485743,201019,937467
2023-04-19 00:42,937476,250713,485743,201020,937476
2023-04-19 00:43,937484,250720,485743,201021,937484
2023-04-19 00:44,937492,250727,485743,201022,937492
2023-04-19 00:45,937500,250721,485755,201024,937500
2023-04-19 00:46,937507,250728,485755,201024,937507
2023-04-19 00:47,937515,250734,485755,201026,937515
2023-04-19 00:48,937523,250741,485755,201027,937523
2023-04-19 00:49,937531,250746,485755,201030,937531
2023-04-19 00:50,937540,250754,485755,201031,937540
2023-04-19 00:51,937548,250761,485755,201032,937548
2023-04-19 00:52,937556,250768,485755,201033,937556
2023-04-19 00:53,937563,250775,485755,201033,937563
2023-04-19 00:54,937571,250783,485755,201033,937571
2023-04-19 00:55,937579,250782,485764,201033,937579
2023-04-19 00:56,937587,250789,485764,201034,937587
2023-04-19 00:57,937594,250796,485764,201034,937594
2023-04-19 00:58,937602,250804,485764,201034,937602
2023-04-19 00:59,937610,250810,485764,201036,937610
2023-04-19 01:00,937617,250815,485764,201038,937617
2023-04-19 01:01,937623,250819,485764,201040,937623
2023-04-19 01:02,937629,250824,485764,201041,937629
2023-04-19 01:03,937634,250828,485764,201042,937634
2023-04-19 01:05,937640,250823,485775,201042,937640
2023-04-19 01:06,937646,250829,485775,201042,937646
2023-04-19 01:07,937653,250832,485778,201043,937653
2023-04-19 01:08,937659,250838,485778,201043,937659
2023-04-19 01:09,937665,250843,485778,201044,937665
2023-04-19 01:10,937671,250847,485778,201046,937671
2023-04-19 01:11,937677,250849,485780,201048,937677
2023-04-19 01:12,937683,250855,485780,201048,937683
2023-04-19 01:13,937689,250856,485784,201049,937689
2023-04-19 01:14,937695,250862,485784,201049,937695
2023-04-19 01:15,937701,250867,485785,201049,937701
2023-04-19 01:16,937707,250872,485785,201050,937707
2023-04-19 01:17,937713,250875,485788,201050,937713
2023-04-19 01:18,937719,250880,485788,201051,937719
2023-04-19 01:19,937726,250885,485790,201051,937726
2023-04-19 01:20,937732,250890,485790,201052,937732
2023-04-19 01:21,937738,250891,485795,201052,937738
2023-04-19 01:22,937744,250896,485795,201053,937744
2023-04-19 01:23,937751,250902,485795,201054,937751
2023-04-19 01:24,937757,250907,485795,201055,937757
2023-04-19 01:25,937762,250911,485796,201055,937762
2023-04-19 01:26,937769,250917,485796,201056,937769
2023-04-19 01:27,937776,250925,485796,201055,937776
2023-04-19 01:28,937782,250931,485796,201055,937782
2023-04-19 01:29,937789,250935,485799,201055,937789
2023-04-19 01:30,937795,250941,485799,201055,937795
2023-04-19 01:31,937801,250946,485801,201054,937801
2023-04-19 01:32,937807,250952,485801,201054,937807
2023-04-19 01:33,937813,250958,485801,201054,937813
2023-04-19 01:34,937819,250964,485801,201054,937819
2023-04-19 01:35,937825,250968,485802,201055,937825
2023-04-19 01:36,937831,250974,485802,201055,937831
2023-04-19 01:37,937837,250979,485803,201055,937837
2023-04-19 01:38,937844,250986,485803,201055,937844
2023-04-19 01:39,937850,250989,485805,201056,937850
2023-04-19 01:40,937856,250994,485805,201057,937856
2023-04-19 01:41,937862,250998,485806,201058,937862
2023-04-19 01:42,937868,251003,485806,201059,937868
2023-04-19 01:43,937874,251007,485807,201060,937874
2023-04-19 01:44,937880,251011,485807,201062,937880
2023-04-19 01:45,937888,251017,485807,201064,937888
2023-04-19 01:46,937894,251023,485807,201064,937894
2023-04-19 01:47,937899,251027,485807,201065,937899
2023-04-19 01:48,937906,251034,485807,201065,937906
2023-04-19 01:49,937912,251039,485808,201065,937912
2023-04-19 01:50,937918,251044,485808,201066,937918
2023-04-19 01:51,937924,251049,485809,201066,937924
2023-04-19 01:52,937930,251055,485809,201066,937930
2023-04-19 01:53,937936,251059,485810,201067,937936
2023-04-19 01:55,937942,251064,485810,201068,937942
2023-04-19 01:56,937948,251070,485810,201068,937948
2023-04-19 01:57,937954,251076,485810,201068,937954
2023-04-19 01:58,937960,251082,485810,201068,937960
2023-04-19 01:59,937966,251086,485810,201070,937966
2023-04-19 02:00,937972,251091,485811,201070,937972
2023-04-19 02:01,937976,251094,485811,201071,937976
2023-04-19 02:02,937981,251098,485812,201071,937981
2023-04-19 02:03,937986,251103,485812,201071,937986
2023-04-19 02:04,937990,251104,485812,201074,937990
2023-04-19 02:05,937995,251109,485812,201074,937995
2023-04-19 02:06,937999,251109,485816,201074,937999
2023-04-19 02:07,938004,251114,485816,201074,938004
2023-04-19 02:08,938009,251119,485816,201074,938009
2023-04-19 02:09,938013,251123,485816,201074,938013
2023-04-19 02:10,938018,251128,485816,201074,938018
2023-04-19 02:11,938022,251131,485816,201075,938022
2023-04-19 02:12,938027,251137,485815,201075,938027
2023-04-19 02:13,938032,251142,485815,201075,938032
2023-04-19 02:14,938036,251145,485816,201075,938036
2023-04-19 02:15,938041,251150,485816,201075,938041
2023-04-19 02:16,938045,251154,485816,201075,938045
2023-04-19 02:17,938050,251158,485816,201076,938050
2023-04-19 02:18,938055,251162,485817,201076,938055
2023-04-19 02:19,938059,251165,485817,201077,938059
2023-04-19 02:20,938064,251169,485817,201078,938064
2023-04-19 02:21,938069,251173,485818,201078,938069
2023-04-19 02:22,938074,251178,485818,201078,938074
2023-04-19 02:23,938079,251183,485818,201078,938079
2023-04-19 02:24,938083,251186,485818,201079,938083
2023-04-19 02:25,938088,251191,485818,201079,938088
2023-04-19 02:26,938092,251195,485818,201079,938092
2023-04-19 02:27,938097,251200,485818,201079,938097
2023-04-19 02:28,938102,251205,485818,201079,938102
2023-04-19 02:29,938107,251209,485818,201080,938107
2023-04-19 02:30,938112,251214,485818,201080,938112
2023-04-19 02:31,938117,251219,485818,201080,938117
2023-04-19 02:32,938121,251223,485818,201080,938121
2023-04-19 02:33,938126,251229,485817,201080,938126
2023-04-19 02:34,938130,251233,485817,201080,938130
2023-04-19 02:35,938135,251235,485819,201081,938135
2023-04-19 02:36,938140,251240,485819,201081,938140
2023-04-19 02:37,938144,251244,485819,201081,938144
2023-04-19 02:38,938149,251249,485819,201081,938149
2023-04-19 02:40,938153,251252,485820,201081,938153
2023-04-19 02:41,938158,251256,485820,201082,938158
2023-04-19 02:42,938162,251259,485821,201082,938162
2023-04-19 02:43,938167,251263,485821,201083,938167
2023-04-19 02:44,938172,251267,485821,201084,938172
2023-04-19 02:45,938176,251271,485821,201084,938176
2023-04-19 02:46,938181,251277,485820,201084,938181
2023-04-19 02:47,938185,251281,485820,201084,938185
2023-04-19 02:48,938190,251285,485820,201085,938190
2023-04-19 02:49,938195,251290,485820,201085,938195
2023-04-19 02:50,938199,251294,485820,201085,938199
2023-04-19 02:51,938204,251299,485820,201085,938204
2023-04-19 02:52,938209,251301,485822,201086,938209
2023-04-19 02:53,938213,251305,485822,201086,938213
2023-04-19 02:54,938218,251307,485825,201086,938218
2023-04-19 02:55,938222,251311,485825,201086,938222
2023-04-19 02:56,938227,251313,485828,201086,938227
2023-04-19 02:57,938232,251317,485828,201087,938232
2023-04-19 02:58,938236,251318,485830,201088,938236
2023-04-19 02:59,938241,251323,485830,201088,938241
2023-04-19 03:00,938247,251328,485831,201088,938247
2023-04-19 03:01,938258,251339,485831,201088,938258
2023-04-19 03:02,938269,251348,485832,201089,938269
2023-04-19 03:03,938279,251358,485832,201089,938279
2023-04-19 03:04,938289,251368,485832,201089,938289
2023-04-19 03:05,938300,251379,485832,201089,938300
2023-04-19 03:06,938311,251389,485833,201089,938311
2023-04-19 03:07,938321,251399,485833,201089,938321
2023-04-19 03:08,938331,251408,485833,201090,938331
2023-04-19 03:09,938341,251418,485833,201090,938341
2023-04-19 03:10,938352,251427,485834,201091,938352
2023-04-19 03:11,938363,251438,485834,201091,938363
2023-04-19 03:12,938373,251448,485834,201091,938373
2023-04-19 03:13,938383,251458,485834,201091,938383
2023-04-19 03:14,938394,251469,485834,201091,938394
2023-04-19 03:15,938405,251480,485834,201091,938405
2023-04-19 03:16,938415,251489,485835,201091,938415
2023-04-19 03:17,938425,251499,485835,201091,938425
2023-04-19 03:18,938436,251508,485836,201092,938436
2023-04-19 03:19,938447,251519,485836,201092,938447
2023-04-19 03:20,938457,251528,485837,201092,938457
2023-04-19 03:21,938467,251538,485837,201092,938467
2023-04-19 03:22,938477,251549,485836,201092,938477
2023-04-19 03:23,938489,251561,485836,201092,938489
2023-04-19 03:24,938500,251571,485837,201092,938500
2023-04-19 03:25,938510,251581,485837,201092,938510
2023-04-19 03:27,938520,251590,485837,201093,938520
2023-04-19 03:28,938531,251600,485837,201094,938531
2023-04-19 03:29,938542,251609,485839,201094,938542
2023-04-19 03:30,938552,251619,485839,201094,938552
2023-04-19 03:31,938562,251627,485841,201094,938562
2023-04-19 03:32,938572,251637,485841,201094,938572
2023-04-19 03:33,938583,251648,485841,201094,938583
2023-04-19 03:34,938594,251659,485841,201094,938594
2023-04-19 03:35,938604,251669,485841,201094,938604
2023-04-19 03:36,938615,251679,485841,201095,938615
2023-04-19 03:37,938625,251689,485841,201095,938625
2023-04-19 03:38,938635,251699,485841,201095,938635
2023-04-19 03:39,938646,251710,485841,201095,938646
2023-04-19 03:40,938656,251720,485841,201095,938656
2023-04-19 03:41,938667,251730,485841,201096,938667
2023-04-19 03:42,938677,251740,485841,201096,938677
2023-04-19 03:43,938688,251751,485841,201096,938688
2023-04-19 03:44,938698,251761,485841,201096,938698
2023-04-19 03:45,938709,251772,485841,201096,938709
2023-04-19 03:46,938720,251782,485841,201097,938720
2023-04-19 03:47,938730,251792,485841,201097,938730
2023-04-19 03:48,938740,251802,485841,201097,938740
2023-04-19 03:49,938750,251812,485841,201097,938750
2023-04-19 03:50,938761,251823,485841,201097,938761
2023-04-19 03:51,938772,251834,485841,201097,938772
2023-04-19 03:52,938782,251844,485841,201097,938782
2023-04-19 03:53,938793,251850,485845,201098,938793
2023-04-19 03:54,938804,251860,485845,201099,938804
2023-04-19 03:55,938814,251868,485846,201100,938814
2023-04-19 03:56,938824,251878,485846,201100,938824
2023-04-19 03:57,938835,251888,485847,201100,938835
2023-04-19 03:58,938846,251899,485847,201100,938846
2023-04-19 03:59,938856,251908,485847,201101,938856
2023-04-19 04:00,938865,251916,485847,201102,938865
2023-04-19 04:01,938873,251923,485848,201102,938873
2023-04-19 04:02,938882,251931,485848,201103,938882
2023-04-19 04:03,938890,251939,485848,201103,938890
2023-04-19 04:04,938898,251947,485848,201103,938898
2023-04-19 04:05,938907,251956,485848,201103,938907
2023-04-19 04:06,938916,251965,485848,201103,938916
2023-04-19 04:07,938924,251972,485848,201104,938924
2023-04-19 04:08,938932,251979,485848,201105,938932
2023-04-19 04:09,938941,251988,485848,201105,938941
2023-04-19 04:10,938949,251996,485848,201105,938949
2023-04-19 04:11,938957,252004,485848,201105,938957
2023-04-19 04:13,938966,252013,485848,201105,938966
2023-04-19 04:14,938974,252021,485848,201105,938974
2023-04-19 04:15,938982,252029,485848,201105,938982
2023-04-19 04:16,938991,252038,485848,201105,938991
2023-04-19 04:17,938999,252044,485848,201107,938999
2023-04-19 04:18,939007,252052,485848,201107,939007
2023-04-19 04:19,939016,252060,485848,201108,939016
2023-04-19 04:20,939023,252067,485848,201108,939023
2023-04-19 04:21,939032,252076,485848,201108,939032
2023-04-19 04:22,939040,252083,485849,201108,939040
2023-04-19 04:23,939049,252092,485849,201108,939049
2023-04-19 04:24,939057,252099,485850,201108,939057
2023-04-19 04:25,939065,252107,485850,201108,939065
2023-04-19 04:26,939073,252114,485851,201108,939073
2023-04-19 04:27,939082,252123,485851,201108,939082
2023-04-19 04:28,939090,252129,485853,201108,939090
2023-04-19 04:29,939099,252138,485853,201108,939099
2023-04-19 04:30,939106,252145,485853,201108,939106
2023-04-19 04:31,939115,252154,485853,201108,939115
2023-04-19 04:32,939123,252162,485853,201108,939123
2023-04-19 04:33,939132,252171,485853,201108,939132
2023-04-19 04:34,939140,252179,485853,201108,939140
2023-04-19 04:35,939148,252187,485853,201108,939148
2023-04-19 04:36,939157,252196,485853,201108,939157
2023-04-19 04:37,939165,252204,485853,201108,939165
2023-04-19 04:38,939173,252209,485856,201108,939173
2023-04-19 04:39,939181,252216,485856,201109,939181
2023-04-19 04:40,939189,252224,485856,201109,939189
2023-04-19 04:41,939198,252233,485856,201109,939198
2023-04-19 04:42,939206,252241,485856,201109,939206
2023-04-19 04:43,939214,252249,485856,201109,939214
2023-04-19 04:44,939223,252258,485856,201109,939223
2023-04-19 04:45,939231,252266,485856,201109,939231
2023-04-19 04:46,939239,252274,485856,201109,939239
2023-04-19 04:47,939248,252283,485856,201109,939248
2023-04-19 04:48,939256,252291,485856,201109,939256
2023-04-19 04:49,939264,252299,485856,201109,939264
2023-04-19 04:50,939273,252308,485856,201109,939273
2023-04-19 04:51,939281,252316,485856,201109,939281
2023-04-19 04:52,939289,252324,485856,201109,939289
2023-04-19 04:53,939298,252333,485856,201109,939298
2023-04-19 04:54,939306,252341,485856,201109,939306
2023-04-19 04:55,939314,252349,485856,201109,939314
2023-04-19 04:56,939322,252356,485857,201109,939322
2023-04-19 04:57,939331,252365,485857,201109,939331
2023-04-19 04:58,939339,252372,485857,201110,939339
2023-04-19 05:00,939347,252380,485857,201110,939347
2023-04-19 05:01,939354,252386,485857,201111,939354
2023-04-19 05:02,939361,252393,485857,201111,939361
2023-04-19 05:03,939368,252399,485858,201111,939368
2023-04-19 05:04,939375,252406,485858,201111,939375
2023-04-19 05:05,939382,252413,485858,201111,939382
2023-04-19 05:06,939389,252420,485858,201111,939389
2023-04-19 05:07,939396,252425,485860,201111,939396
2023-04-19 05:08,939403,252432,485860,201111,939403
2023-04-19 05:09,939410,252439,485860,201111,939410
2023-04-19 05:10,939417,252445,485860,201112,939417
2023-04-19 05:11,939424,252452,485860,201112,939424
2023-04-19 05:12,939431,252459,485860,201112,939431
2023-04-19 05:13,939438,252464,485861,201113,939438
2023-04-19 05:14,939445,252471,485861,201113,939445
2023-04-19 05:15,939452,252476,485862,201114,939452
2023-04-19 05:16,939459,252483,485862,201114,939459
2023-04-19 05:17,939467,252491,485862,201114,939467
2023-04-19 05:18,939474,252498,485862,201114,939474
2023-04-19 05:19,939481,252505,485862,201114,939481
2023-04-19 05:20,939488,252512,485862,201114,939488
2023-04-19 05:21,939495,252519,485862,201114,939495
2023-04-19 05:22,939501,252525,485862,201114,939501
2023-04-19 05:23,939509,252533,485862,201114,939509
2023-04-19 05:24,939515,252538,485862,201115,939515
2023-04-19 05:25,939522,252545,485862,201115,939522
2023-04-19 05:26,939530,252553,485862,201115,939530
2023-04-19 05:27,939536,252557,485863,201116,939536
2023-04-19 05:28,939544,252565,485863,201116,939544
2023-04-19 05:29,939550,252568,485865,201117,939550
2023-04-19 05:30,939558,252576,485865,201117,939558
2023-04-19 05:31,939564,252582,485865,201117,939564
2023-04-19 05:32,939571,252588,485865,201118,939571
2023-04-19 05:33,939578,252595,485865,201118,939578
2023-04-19 05:34,939585,252602,485865,201118,939585
2023-04-19 05:35,939592,252609,485865,201118,939592
2023-04-19 05:36,939599,252616,485865,201118,939599
2023-04-19 05:37,939606,252622,485865,201119,939606
2023-04-19 05:38,939613,252629,485865,201119,939613
2023-04-19 05:39,939620,252635,485866,201119,939620
2023-04-19 05:40,939627,252642,485866,201119,939627
2023-04-19 05:41,939634,252649,485866,201119,939634
2023-04-19 05:42,939641,252656,485866,201119,939641
2023-04-19 05:43,939648,252663,485866,201119,939648
2023-04-19 05:44,939655,252670,485866,201119,939655
2023-04-19 05:46,939662,252674,485868,201120,939662
2023-04-19 05:47,939669,252680,485869,201120,939669
2023-04-19 05:48,939676,252687,485869,201120,939676
2023-04-19 05:49,939683,252693,485870,201120,939683
2023-04-19 05:50,939691,252700,485870,201121,939691
2023-04-19 05:51,939698,252706,485871,201121,939698
2023-04-19 05:52,939705,252713,485871,201121,939705
2023-04-19 05:53,939712,252717,485874,201121,939712
2023-04-19 05:54,939718,252723,485874,201121,939718
2023-04-19 05:55,939725,252730,485874,201121,939725
2023-04-19 05:56,939733,252738,485874,201121,939733
2023-04-19 05:57,939740,252744,485875,201121,939740
2023-04-19 05:58,939747,252751,485875,201121,939747
2023-04-19 05:59,939753,252756,485876,201121,939753
2023-04-19 06:00,939761,252764,485876,201121,939761
2023-04-19 06:01,939769,252772,485876,201121,939769
2023-04-19 06:02,939777,252780,485876,201121,939777
2023-04-19 06:03,939786,252789,485876,201121,939786
2023-04-19 06:04,939794,252797,485876,201121,939794
2023-04-19 06:05,939802,252805,485876,201121,939802
2023-04-19 06:06,939811,252814,485876,201121,939811
2023-04-19 06:07,939819,252822,485876,201121,939819
2023-04-19 06:08,939827,252830,485876,201121,939827
2023-04-19 06:09,939835,252838,485876,201121,939835
2023-04-19 06:10,939844,252847,485876,201121,939844
2023-04-19 06:11,939852,252853,485878,201121,939852
2023-04-19 06:12,939861,252861,485878,201122,939861
2023-04-19 06:13,939869,252869,485878,201122,939869
2023-04-19 06:14,939877,252877,485878,201122,939877
2023-04-19 06:15,939887,252885,485879,201123,939887
2023-04-19 06:16,939895,252891,485879,201125,939895
2023-04-19 06:17,939903,252900,485878,201125,939903
2023-04-19 06:18,939912,252909,485878,201125,939912
2023-04-19 06:19,939920,252914,485879,201127,939920
2023-04-19 06:20,939929,252923,485879,201127,939929
2023-04-19 06:21,939937,252929,485881,201127,939937
2023-04-19 06:22,939945,252937,485881,201127,939945
2023-04-19 06:23,939954,252944,485882,201128,939954
2023-04-19 06:24,939962,252952,485882,201128,939962
2023-04-19 06:25,939970,252960,485882,201128,939970
2023-04-19 06:26,939978,252968,485882,201128,939978
2023-04-19 06:27,939987,252977,485882,201128,939987
2023-04-19 06:28,939995,252984,485882,201129,939995
2023-04-19 06:29,940004,252992,485882,201130,940004
2023-04-19 06:30,940011,252999,485882,201130,940011
2023-04-19 06:32,940020,253008,485882,201130,940020
2023-04-19 06:33,940028,253016,485882,201130,940028
2023-04-19 06:34,940037,253023,485883,201131,940037
2023-04-19 06:35,940046,253031,485883,201132,940046
2023-04-19 06:36,940054,253039,485883,201132,940054
2023-04-19 06:37,940063,253048,485883,201132,940063
2023-04-19 06:38,940071,253054,485884,201133,940071
2023-04-19 06:39,940079,253062,485884,201133,940079
2023-04-19 06:40,940088,253069,485885,201134,940088
2023-04-19 06:41,940096,253077,485885,201134,940096
2023-04-19 06:42,940104,253083,485887,201134,940104
2023-04-19 06:43,940113,253092,485887,201134,940113
2023-04-19 06:44,940121,253101,485887,201133,940121
2023-04-19 06:45,940129,253108,485887,201134,940129
2023-04-19 06:46,940138,253116,485888,201134,940138
2023-04-19 06:47,940146,253124,485888,201134,940146
2023-04-19 06:48,940154,253132,485888,201134,940154
2023-04-19 06:49,940162,253139,485888,201135,940162
2023-04-19 06:50,940171,253145,485889,201137,940171
2023-04-19 06:51,940179,253153,485889,201137,940179
2023-04-19 06:52,940187,253161,485889,201137,940187
2023-04-19 06:53,940196,253169,485889,201138,940196
2023-04-19 06:54,940205,253176,485889,201140,940205
2023-04-19 06:55,940213,253184,485889,201140,940213
2023-04-19 06:56,940221,253192,485889,201140,940221
2023-04-19 06:57,940230,253201,485889,201140,940230
2023-04-19 06:58,940240,253210,485890,201140,940240
2023-04-19 06:59,940247,253216,485890,201141,940247
2023-04-19 07:00,940256,253223,485891,201142,940256
2023-04-19 07:01,940265,253232,485891,201142,940265
2023-04-19 07:02,940273,253240,485891,201142,940273
2023-04-19 07:03,940281,253246,485891,201144,940281
2023-04-19 07:04,940290,253254,485891,201145,940290
2023-04-19 07:05,940298,253262,485891,201145,940298
2023-04-19 07:06,940307,253271,485892,201144,940307
2023-04-19 07:07,940316,253280,485892,201144,940316
2023-04-19 07:08,940324,253287,485892,201145,940324
2023-04-19 07:09,940332,253295,485892,201145,940332
2023-04-19 07:10,940341,253304,485892,201145,940341
2023-04-19 07:11,940349,253312,485892,201145,940349
2023-04-19 07:12,940357,253320,485892,201145,940357
2023-04-19 07:13,940366,253328,485892,201146,940366
2023-04-19 07:14,940375,253335,485894,201146,940375
2023-04-19 07:15,940383,253341,485894,201148,940383
2023-04-19 07:16,940391,253348,485894,201149,940391
2023-04-19 07:17,940400,253356,485894,201150,940400
2023-04-19 07:18,940408,253362,485895,201151,940408
2023-04-19 07:20,940417,253370,485895,201152,940417
2023-04-19 07:21,940426,253379,485895,201152,940426
2023-04-19 07:22,940434,253387,485895,201152,940434
2023-04-19 07:23,940442,253394,485896,201152,940442
2023-04-19 07:24,940451,253403,485896,201152,940451
2023-04-19 07:25,940459,253409,485897,201153,940459
2023-04-19 07:26,940468,253417,485897,201154,940468
2023-04-19 07:27,940476,253424,485897,201155,940476
2023-04-19 07:28,940484,253432,485897,201155,940484
2023-04-19 07:29,940493,253440,485897,201156,940493
2023-04-19 07:30,940502,253449,485897,201156,940502
2023-04-19 07:31,940510,253458,485896,201156,940510
2023-04-19 07:32,940518,253466,485896,201156,940518
2023-04-19 07:33,940527,253474,485897,201156,940527
2023-04-19 07:34,940535,253482,485897,201156,940535
2023-04-19 07:35,940544,253489,485898,201157,940544
2023-04-19 07:36,940552,253496,485898,201158,940552
2023-04-19 07:37,940561,253500,485901,201160,940561
2023-04-19 07:38,940569,253507,485901,201161,940569
2023-04-19 07:39,940577,253512,485904,201161,940577
2023-04-19 07:40,940586,253519,485904,201163,940586
2023-04-19 07:41,940595,253523,485909,201163,940595
2023-04-19 07:42,940603,253530,485909,201164,940603
2023-04-19 07:43,940612,253537,485910,201165,940612
2023-04-19 07:44,940620,253545,485910,201165,940620
2023-04-19 07:45,940629,253552,485912,201165,940629
2023-04-19 07:46,940637,253560,485912,201165,940637
2023-04-19 07:47,940645,253566,485914,201165,940645
2023-04-19 07:48,940653,253574,485914,201165,940653
2023-04-19 07:49,940662,253582,485915,201165,940662
2023-04-19 07:50,940671,253591,485915,201165,940671
2023-04-19 07:51,940679,253597,485915,201167,940679
2023-04-19 07:52,940687,253605,485915,201167,940687
2023-04-19 07:53,940696,253611,485916,201169,940696
2023-04-19 07:54,940705,253619,485916,201170,940705
2023-04-19 07:55,940713,253625,485918,201170,940713
2023-04-19 07:56,940721,253631,485918,201172,940721
2023-04-19 07:57,940730,253636,485918,201176,940730
2023-04-19 07:58,940739,253644,485918,201177,940739
2023-04-19 07:59,940747,253650,485919,201178,940747
2023-04-19 08:00,940755,253658,485919,201178,940755
2023-04-19 08:01,940762,253663,485920,201179,940762
2023-04-19 08:02,940768,253668,485920,201180,940768
2023-04-19 08:03,940775,253672,485921,201182,940775
2023-04-19 08:04,940781,253678,485921,201182,940781
2023-04-19 08:05,940788,253685,485921,201182,940788
2023-04-19 08:06,940795,253692,485921,201182,940795
2023-04-19 08:08,940801,253695,485922,201184,940801
2023-04-19 08:09,940809,253702,485922,201185,940809
2023-04-19 08:10,940816,253707,485923,201186,940816
2023-04-19 08:11,940822,253711,485923,201188,940822
2023-04-19 08:12,940829,253717,485923,201189,940829
2023-04-19 08:13,940835,253721,485923,201191,940835
2023-04-19 08:14,940843,253728,485924,201191,940843
2023-04-19 08:15,940850,253735,485924,201191,940850
2023-04-19 08:16,940856,253740,485925,201191,940856
2023-04-19 08:17,940863,253747,485925,201191,940863
2023-04-19 08:18,940870,253753,485926,201191,940870
2023-04-19 08:19,940876,253757,485926,201193,940876
2023-04-19 08:20,940884,253762,485929,201193,940884
2023-04-19 08:21,940891,253769,485929,201193,940891
2023-04-19 08:22,940897,253775,485929,201193,940897
2023-04-19 08:23,940904,253781,485929,201194,940904
2023-04-19 08:24,940910,253787,485929,201194,940910
2023-04-19 08:25,940917,253794,485929,201194,940917
2023-04-19 08:26,940924,253800,485929,201195,940924
2023-04-19 08:27,940930,253806,485929,201195,940930
2023-04-19 08:28,940937,253812,485929,201196,940937
2023-04-19 08:29,940944,253818,485929,201197,940944
2023-04-19 08:30,940950,253824,485929,201197,940950
2023-04-19 08:31,940957,253829,485929,201199,940957
2023-04-19 08:32,940964,253826,485938,201200,940964
2023-04-19 08:33,940970,253832,485938,201200,940970
2023-04-19 08:34,940977,253838,485938,201201,940977
2023-04-19 08:35,940985,253846,485938,201201,940985
2023-04-19 08:36,940991,253851,485938,201202,940991
2023-04-19 08:37,940998,253854,485942,201202,940998
2023-04-19 08:38,941004,253857,485942,201205,941004
2023-04-19 08:39,941011,253860,485944,201207,941011
2023-04-19 08:40,941018,253865,485944,201209,941018
2023-04-19 08:41,941024,253869,485946,201209,941024
2023-04-19 08:42,941032,253874,485947,201211,941032
2023-04-19 08:43,941040,253882,485947,201211,941040
2023-04-19 08:44,941046,253887,485947,201212,941046
2023-04-19 08:45,941053,253893,485947,201213,941053
2023-04-19 08:46,941059,253896,485947,201216,941059
2023-04-19 08:47,941066,253903,485947,201216,941066
2023-04-19 08:48,941073,253911,485946,201216,941073
2023-04-19 08:49,941080,253918,485946,201216,941080
2023-04-19 08:50,941087,253921,485948,201218,941087
2023-04-19 08:51,941094,253928,485948,201218,941094
2023-04-19 08:52,941101,253935,485948,201218,941101
2023-04-19 08:53,941107,253941,485948,201218,941107
2023-04-19 08:55,941114,253945,485948,201221,941114
2023-04-19 08:56,941120,253951,485948,201221,941120
2023-04-19 08:57,941127,253955,485950,201222,941127
2023-04-19 08:58,941134,253961,485950,201223,941134
2023-04-19 08:59,941140,253966,485950,201224,941140
2023-04-19 09:00,941147,253973,485950,201224,941147
2023-04-19 09:01,941153,253979,485949,201225,941153
2023-04-19 09:02,941160,253984,485949,201227,941160
2023-04-19 09:03,941166,253989,485949,201228,941166
2023-04-19 09:04,941173,253994,485949,201230,941173
2023-04-19 09:05,941179,253999,485950,201230,941179
2023-04-19 09:06,941185,254005,485950,201230,941185
2023-04-19 09:07,941192,254009,485952,201231,941192
2023-04-19 09:08,941198,254012,485952,201234,941198
2023-04-19 09:09,941205,254017,485953,201235,941205
2023-04-19 09:10,941211,254022,485953,201236,941211
2023-04-19 09:11,941219,254027,485954,201238,941219
2023-04-19 09:12,941225,254032,485954,201239,941225
2023-04-19 09:13,941232,254035,485958,201239,941232
2023-04-19 09:14,941238,254040,485958,201240,941238
2023-04-19 09:15,941244,254045,485958,201241,941244
2023-04-19 09:16,941251,254051,485958,201242,941251
2023-04-19 09:17,941258,254053,485963,201242,941258
2023-04-19 09:18,941265,254059,485963,201243,941265
2023-04-19 09:19,941271,254059,485966,201246,941271
2023-04-19 09:20,941277,254064,485966,201247,941277
2023-04-19 09:21,941284,254070,485967,201247,941284
2023-04-19 09:22,941291,254076,485967,201248,941291
2023-04-19 09:23,941297,254081,485967,201249,941297
2023-04-19 09:24,941303,254084,485967,201252,941303
2023-04-19 09:25,941309,254089,485968,201252,941309
2023-04-19 09:26,941316,254096,485968,201252,941316
2023-04-19 09:27,941322,254100,485968,201254,941322
2023-04-19 09:28,941329,254107,485968,201254,941329
2023-04-19 09:29,941335,254110,485971,201254,941335
2023-04-19 09:30,941341,254114,485971,201256,941341
2023-04-19 09:31,941348,254120,485972,201256,941348
2023-04-19 09:32,941355,254126,485972,201257,941355
2023-04-19 09:33,941362,254131,485974,201257,941362
2023-04-19 09:34,941368,254136,485974,201258,941368
2023-04-19 09:35,941374,254136,485977,201261,941374
2023-04-19 09:36,941382,254144,485977,201261,941382
2023-04-19 09:37,941388,254147,485978,201263,941388
2023-04-19 09:38,941394,254153,485978,201263,941394
2023-04-19 09:39,941401,254157,485979,201265,941401
2023-04-19 09:40,941407,254162,485979,201266,941407
2023-04-19 09:42,941414,254168,485981,201265,941414
2023-04-19 09:43,941420,254170,485983,201267,941420
2023-04-19 09:44,941427,254178,485982,201267,941427
2023-04-19 09:45,941433,254178,485983,201272,941433
2023-04-19 09:46,941439,254184,485983,201272,941439
2023-04-19 09:47,941446,254190,485984,201272,941446
2023-04-19 09:48,941452,254195,485984,201273,941452
2023-04-19 09:49,941459,254200,485986,201273,941459
2023-04-19 09:50,941466,254206,485986,201274,941466
2023-04-19 09:51,941472,254209,485988,201275,941472
2023-04-19 09:52,941479,254214,485988,201277,941479
2023-04-19 09:53,941485,254217,485990,201278,941485
2023-04-19 09:54,941491,254223,485990,201278,941491
2023-04-19 09:55,941498,254227,485992,201279,941498
2023-04-19 09:56,941504,254233,485992,201279,941504
2023-04-19 09:57,941511,254237,485994,201280,941511
2023-04-19 09:58,941517,254241,485994,201282,941517
2023-04-19 09:59,941523,254244,485995,201284,941523
2023-04-19 10:00,941531,254249,485995,201287,941531
2023-04-19 10:01,941542,254253,485998,201291,941542
2023-04-19 10:02,941554,254264,485998,201292,941554
2023-04-19 10:03,941564,254269,486002,201293,941564
2023-04-19 10:04,941575,254280,486002,201293,941575
2023-04-19 10:05,941586,254291,486002,201293,941586
2023-04-19 10:06,941596,254298,486004,201294,941596
2023-04-19 10:07,941607,254307,486006,201294,941607
2023-04-19 10:08,941618,254318,486006,201294,941618
2023-04-19 10:09,941629,254327,486006,201296,941629
2023-04-19 10:10,941639,254336,486006,201297,941639
2023-04-19 10:11,941650,254346,486007,201297,941650
2023-04-19 10:12,941662,254357,486007,201298,941662
2023-04-19 10:13,941672,254363,486009,201300,941672
2023-04-19 10:14,941683,254374,486009,201300,941683
2023-04-19 10:15,941694,254379,486010,201305,941694
2023-04-19 10:16,941705,254390,486010,201305,941705
2023-04-19 10:17,941715,254399,486012,201304,941715
2023-04-19 10:18,941727,254410,486012,201305,941727
2023-04-19 10:19,941737,254420,486012,201305,941737
2023-04-19 10:20,941749,254431,486012,201306,941749
2023-04-19 10:21,941760,254437,486014,201309,941760
2023-04-19 10:22,941771,254447,486014,201310,941771
2023-04-19 10:23,941782,254457,486015,201310,941782
2023-04-19 10:24,941792,254465,486015,201312,941792
2023-04-19 10:25,941803,254475,486016,201312,941803
2023-04-19 10:26,941814,254484,486016,201314,941814
2023-04-19 10:27,941825,254490,486019,201316,941825
2023-04-19 10:29,941836,254500,486019,201317,941836
2023-04-19 10:30,941846,254510,486019,201317,941846
2023-04-19 10:31,941858,254522,486019,201317,941858
2023-04-19 10:32,941869,254529,486021,201319,941869
2023-04-19 10:33,941880,254540,486021,201319,941880
2023-04-19 10:34,941891,254547,486025,201319,941891
2023-04-19 10:35,941902,254555,486025,201322,941902
2023-04-19 10:36,941913,254560,486030,201323,941913
2023-04-19 10:37,941924,254568,486030,201326,941924
2023-04-19 10:38,941935,254577,486031,201327,941935
2023-04-19 10:39,941945,254584,486033,201328,941945
2023-04-19 10:40,941957,254596,486033,201328,941957
2023-04-19 10:41,941968,254605,486034,201329,941968
2023-04-19 10:42,941979,254615,486034,201330,941979
2023-04-19 10:43,941990,254622,486035,201333,941990
2023-04-19 10:44,942000,254632,486035,201333,942000
2023-04-19 10:45,942011,254642,486035,201334,942011
2023-04-19 10:46,942022,254653,486035,201334,942022
2023-04-19 10:47,942034,254661,486039,201334,942034
2023-04-19 10:48,942046,254672,486039,201335,942046
2023-04-19 10:49,942056,254679,486040,201337,942056
2023-04-19 10:50,942068,254691,486040,201337,942068
2023-04-19 10:51,942079,254701,486041,201337,942079
2023-04-19 10:52,942089,254710,486041,201338,942089
2023-04-19 10:53,942101,254718,486043,201340,942101
2023-04-19 10:54,942111,254728,486043,201340,942111
2023-04-19 10:55,942122,254739,486043,201340,942122
2023-04-19 10:56,942133,254749,486044,201340,942133
2023-04-19 10:57,942144,254757,486044,201343,942144
2023-04-19 10:58,942155,254765,486044,201346,942155
2023-04-19 10:59,942165,254772,486046,201347,942165
2023-04-19 11:00,942173,254779,486046,201348,942173
2023-04-19 11:01,942180,254785,486047,201348,942180
2023-04-19 11:02,942186,254791,486047,201348,942186
2023-04-19 11:03,942193,254795,486049,201349,942193
2023-04-19 11:04,942199,254801,486049,201349,942199
2023-04-19 11:05,942205,254805,486050,201350,942205
2023-04-19 11:06,942212,254812,486050,201350,942212
2023-04-19 11:07,942218,254812,486051,201355,942218
2023-04-19 11:08,942225,254817,486052,201356,942225
2023-04-19 11:09,942232,254823,486052,201357,942232
2023-04-19 11:10,942238,254825,486054,201359,942238
2023-04-19 11:11,942244,254829,486054,201361,942244
2023-04-19 11:12,942251,254832,486055,201364,942251
2023-04-19 11:13,942257,254837,486055,201365,942257
2023-04-19 11:14,942263,254841,486055,201367,942263
2023-04-19 11:16,942270,254848,486055,201367,942270
2023-04-19 11:17,942276,254853,486055,201368,942276
2023-04-19 11:18,942283,254856,486055,201372,942283
2023-04-19 11:19,942289,254861,486055,201373,942289
2023-04-19 11:20,942296,254867,486055,201374,942296
2023-04-19 11:21,942302,254873,486055,201374,942302
2023-04-19 11:22,942308,254878,486055,201375,942308
2023-04-19 11:23,942314,254871,486067,201376,942314
2023-04-19 11:24,942321,254876,486067,201378,942321
2023-04-19 11:25,942327,254882,486067,201378,942327
2023-04-19 11:26,942333,254887,486067,201379,942333
2023-04-19 11:27,942339,254893,486067,201379,942339
2023-04-19 11:28,942346,254899,486067,201380,942346
2023-04-19 11:29,942352,254895,486076,201381,942352
2023-04-19 11:30,942358,254900,486076,201382,942358
2023-04-19 11:31,942365,254905,486077,201383,942365
2023-04-19 11:32,942371,254910,486077,201384,942371
2023-04-19 11:33,942379,254918,486077,201384,942379
2023-04-19 11:34,942386,254924,486077,201385,942386
2023-04-19 11:35,942392,254929,486077,201386,942392
2023-04-19 11:36,942398,254933,486077,201388,942398
2023-04-19 11:37,942404,254934,486082,201388,942404
2023-04-19 11:38,942411,254937,486082,201392,942411
2023-04-19 11:39,942417,254940,486085,201392,942417
2023-04-19 11:40,942423,254944,486085,201394,942423
2023-04-19 11:41,942430,254946,486085,201399,942430
2023-04-19 11:42,942436,254952,486085,201399,942436
2023-04-19 11:43,942442,254953,486089,201400,942442
2023-04-19 11:44,942449,254960,486089,201400,942449
2023-04-19 11:45,942455,254964,486091,201400,942455
2023-04-19 11:46,942462,254968,486094,201400,942462
2023-04-19 11:47,942468,254971,486094,201403,942468
2023-04-19 11:48,942474,254974,486094,201406,942474
2023-04-19 11:49,942480,254975,486094,201411,942480
2023-04-19 11:50,942487,254982,486094,201411,942487
2023-04-19 11:51,942494,254987,486094,201413,942494
2023-04-19 11:52,942500,254990,486095,201415,942500
2023-04-19 11:53,942506,254995,486095,201416,942506
2023-04-19 11:54,942513,254998,486098,201417,942513
2023-04-19 11:55,942519,255003,486098,201418,942519
2023-04-19 11:56,942525,255006,486099,201420,942525
2023-04-19 11:57,942531,255012,486099,201420,942531
2023-04-19 11:58,942538,255017,486100,201421,942538
2023-04-19 11:59,942544,255021,486100,201423,942544
2023-04-19 12:00,942552,255025,486103,201424,942552
2023-04-19 12:01,942561,255033,486103,201425,942561
2023-04-19 12:02,942569,255040,486104,201425,942569
2023-04-19 12:04,942578,255046,486107,201425,942578
2023-04-19 12:05,942586,255053,486107,201426,942586
2023-04-19 12:06,942595,255059,486109,201427,942595
2023-04-19 12:07,942604,255067,486109,201428,942604
2023-04-19 12:08,942612,255071,486111,201430,942612
2023-04-19 12:09,942621,255079,486111,201431,942621
2023-04-19 12:10,942629,255083,486112,201434,942629
2023-04-19 12:11,942638,255090,486112,201436,942638
2023-04-19 12:12,942647,255097,486113,201437,942647
2023-04-19 12:13,942656,255104,486113,201439,942656
2023-04-19 12:14,942664,255107,486117,201440,942664
2023-04-19 12:15,942675,255116,486117,201442,942675
2023-04-19 12:16,942685,255125,486118,201442,942685
2023-04-19 12:17,942694,255132,486118,201444,942694
2023-04-19 12:18,942703,255141,486118,201444,942703
2023-04-19 12:19,942711,255149,486118,201444,942711
2023-04-19 12:20,942720,255153,486122,201445,942720
2023-04-19 12:21,942728,255158,486122,201448,942728
2023-04-19 12:22,942737,255165,486124,201448,942737
2023-04-19 12:23,942747,255175,486124,201448,942747
2023-04-19 12:24,942755,255179,486126,201450,942755
2023-04-19 12:25,942764,255186,486126,201452,942764
2023-04-19 12:26,942773,255195,486124,201454,942773
2023-04-19 12:27,942781,255203,486124,201454,942781
2023-04-19 12:28,942790,255206,486128,201456,942790
2023-04-19 12:29,942800,255214,486128,201458,942800
2023-04-19 12:30,942808,255213,486134,201461,942808
2023-04-19 12:31,942817,255221,486134,201462,942817
2023-04-19 12:32,942827,255228,486135,201464,942827
2023-04-19 12:33,942835,255236,486135,201464,942835
2023-04-19 12:34,942844,255244,486135,201465,942844
2023-04-19 12:35,942852,255249,486137,201466,942852
2023-04-19 12:36,942860,255256,486137,201467,942860
2023-04-19 12:37,942869,255263,486139,201467,942869
2023-04-19 12:38,942878,255269,486139,201470,942878
2023-04-19 12:39,942887,255272,486144,201471,942887
2023-04-19 12:40,942895,255281,486144,201470,942895
2023-04-19 12:41,942903,255285,486148,201470,942903
2023-04-19 12:42,942912,255291,486148,201473,942912
2023-04-19 12:43,942922,255300,486149,201473,942922
2023-04-19 12:44,942932,255310,486149,201473,942932
2023-04-19 12:45,942940,255314,486153,201473,942940
2023-04-19 12:46,942949,255322,486153,201474,942949
2023-04-19 12:47,942958,255325,486155,201478,942958
2023-04-19 12:48,942966,255333,486155,201478,942966
2023-04-19 12:50,942976,255340,486158,201478,942976
2023-04-19 12:51,942984,255346,486158,201480,942984
2023-04-19 12:52,942993,255349,486162,201482,942993
2023-04-19 12:53,943002,255357,486162,201483,943002
2023-04-19 12:54,943010,255362,486165,201483,943010
2023-04-19 12:55,943019,255370,486165,201484,943019
2023-04-19 12:56,943027,255376,486166,201485,943027
2023-04-19 12:57,943036,255383,486166,201487,943036
2023-04-19 12:58,943045,255382,486171,201492,943045
2023-04-19 12:59,943053,255389,486171,201493,943053
2023-04-19 13:00,943064,255399,486172,201493,943064
2023-04-19 13:01,943075,255409,486172,201494,943075
2023-04-19 13:02,943085,255413,486176,201496,943085
2023-04-19 13:03,943097,255424,486176,201497,943097
2023-04-19 13:04,943108,255432,486178,201498,943108
2023-04-19 13:05,943119,255444,486178,201497,943119
2023-04-19 13:06,943131,255454,486179,201498,943131
2023-04-19 13:07,943142,255465,486179,201498,943142
2023-04-19 13:08,943153,255473,486181,201499,943153
2023-04-19 13:09,943163,255483,486181,201499,943163
2023-04-19 13:10,943174,255489,486183,201502,943174
2023-04-19 13:11,943185,255499,486183,201503,943185
2023-04-19 13:12,943197,255507,486183,201507,943197
2023-04-19 13:13,943208,255516,486183,201509,943208
2023-04-19 13:14,943219,255524,486183,201512,943219
2023-04-19 13:15,943232,255526,486192,201514,943232
2023-04-19 13:16,943243,255535,486192,201516,943243
2023-04-19 13:17,943254,255541,486194,201519,943254
2023-04-19 13:18,943265,255551,486194,201520,943265
2023-04-19 13:19,943276,255561,486195,201520,943276
2023-04-19 13:20,943286,255568,486195,201523,943286
2023-04-19 13:21,943297,255575,486198,201524,943297
2023-04-19 13:22,943309,255583,486198,201528,943309
2023-04-19 13:23,943320,255590,486202,201528,943320
2023-04-19 13:24,943332,255602,486202,201528,943332
2023-04-19 13:25,943342,255609,486204,201529,943342
2023-04-19 13:26,943353,255619,486204,201530,943353
2023-04-19 13:27,943364,255628,486205,201531,943364
2023-04-19 13:28,943375,255639,486205,201531,943375
2023-04-19 13:29,943386,255648,486206,201532,943386
2023-04-19 13:30,943396,255656,486206,201534,943396
2023-04-19 13:31,943408,255665,486207,201536,943408
2023-04-19 13:32,943420,255675,486207,201538,943420
2023-04-19 13:33,943430,255682,486209,201539,943430
2023-04-19 13:34,943441,255693,486209,201539,943441
2023-04-19 13:35,943453,255703,486210,201540,943453
2023-04-19 13:37,943465,255715,486210,201540,943465
2023-04-19 13:38,943476,255722,486211,201543,943476
2023-04-19 13:39,943488,255734,486211,201543,943488
2023-04-19 13:40,943500,255746,486212,201542,943500
2023-04-19 13:41,943511,255757,486212,201542,943511
2023-04-19 13:42,943522,255765,486215,201542,943522
2023-04-19 13:43,943533,255774,486216,201543,943533
2023-04-19 13:44,943543,255783,486216,201544,943543
2023-04-19 13:45,943555,255794,486217,201544,943555
2023-04-19 13:46,943566,255805,486217,201544,943566
2023-04-19 13:47,943577,255813,486220,201544,943577
2023-04-19 13:48,943587,255820,486221,201546,943587
2023-04-19 13:49,943598,255828,486223,201547,943598
2023-04-19 13:50,943609,255838,486223,201548,943609
2023-04-19 13:51,943620,255848,486224,201548,943620
2023-04-19 13:52,943632,255860,486224,201548,943632
2023-04-19 13:53,943643,255866,486227,201550,943643
2023-04-19 13:54,943654,255876,486227,201551,943654
2023-04-19 13:55,943665,255883,486230,201552,943665
2023-04-19 13:56,943676,255894,486230,201552,943676
2023-04-19 13:57,943686,255901,486232,201553,943686
2023-04-19 13:58,943698,255912,486232,201554,943698
2023-04-19 13:59,943709,255918,486236,201555,943709
2023-04-19 14:00,943717,255926,486236,201555,943717
2023-04-19 14:01,943722,255931,486236,201555,943722
2023-04-19 14:02,943727,255936,486236,201555,943727
2023-04-19 14:03,943733,255939,486238,201556,943733
2023-04-19 14:04,943738,255943,486238,201557,943738
2023-04-19 14:05,943743,255947,486238,201558,943743
2023-04-19 14:06,943748,255952,486238,201558,943748
2023-04-19 14:07,943754,255957,486238,201559,943754
2023-04-19 14:08,943759,255962,486238,201559,943759
2023-04-19 14:09,943764,255966,486238,201560,943764
2023-04-19 14:10,943769,255970,486238,201561,943769
2023-04-19 14:11,943774,255975,486238,201561,943774
2023-04-19 14:12,943780,255978,486238,201564,943780
2023-04-19 14:13,943785,255971,486249,201565,943785
2023-04-19 14:14,943790,255975,486249,201566,943790
2023-04-19 14:15,943796,255979,486249,201568,943796
2023-04-19 14:16,943801,255984,486249,201568,943801
2023-04-19 14:17,943807,255990,486249,201568,943807
2023-04-19 14:18,943812,255992,486249,201571,943812
2023-04-19 14:19,943817,255997,486249,201571,943817
2023-04-19 14:20,943823,256002,486249,201572,943823
2023-04-19 14:21,943828,256006,486249,201573,943828
2023-04-19 14:22,943834,256011,486249,201574,943834
2023-04-19 14:24,943839,256008,486256,201575,943839
2023-04-19 14:25,943844,256013,486256,201575,943844
2023-04-19 14:26,943850,256012,486260,201578,943850
2023-04-19 14:27,943855,256016,486261,201578,943855
2023-04-19 14:28,943860,256020,486261,201579,943860
2023-04-19 14:29,943865,256022,486264,201579,943865
2023-04-19 14:30,943870,256027,486264,201579,943870
2023-04-19 14:31,943876,256032,486264,201580,943876
2023-04-19 14:32,943881,256034,486264,201583,943881
2023-04-19 14:33,943886,256033,486268,201585,943886
2023-04-19 14:34,943891,256036,486269,201586,943891
2023-04-19 14:35,943896,256040,486269,201587,943896
2023-04-19 14:36,943902,256042,486271,201589,943902
2023-04-19 14:37,943907,256047,486271,201589,943907
2023-04-19 14:38,943912,256049,486272,201591,943912
2023-04-19 14:39,943918,256054,486272,201592,943918
2023-04-19 14:40,943924,256057,486273,201594,943924
2023-04-19 14:41,943930,256063,486273,201594,943930
2023-04-19 14:42,943935,256066,486274,201595,943935
2023-04-19 14:43,943940,256072,486274,201594,943940
2023-04-19 14:44,943946,256074,486277,201595,943946
2023-04-19 14:45,943951,256079,486277,201595,943951
2023-04-19 14:46,943956,256080,486280,201596,943956
2023-04-19 14:47,943961,256085,486281,201595,943961
2023-04-19 14:48,943966,256089,486281,201596,943966
2023-04-19 14:49,943972,256092,486282,201598,943972
2023-04-19 14:50,943977,256096,486282,201599,943977
2023-04-19 14:51,943982,256100,486284,201598,943982
2023-04-19 14:52,943987,256104,486284,201599,943987
2023-04-19 14:53,943992,256107,486286,201599,943992
2023-04-19 14:54,943998,256111,486286,201601,943998
2023-04-19 14:55,944003,256114,486287,201602,944003
2023-04-19 14:56,944008,256119,486287,201602,944008
2023-04-19 14:57,944014,256123,486289,201602,944014
2023-04-19 14:58,944018,256127,486289,201602,944018
2023-04-19 14:59,944024,256133,486289,201602,944024
2023-04-19 15:00,944033,256141,486289,201603,944033
2023-04-19 15:01,944044,256148,486292,201604,944044
2023-04-19 15:02,944058,256161,486292,201605,944058
2023-04-19 15:03,944068,256169,486294,201605,944068
2023-04-19 15:04,944080,256179,486294,201607,944080
2023-04-19 15:05,944091,256188,486295,201608,944091
2023-04-19 15:06,944102,256199,486295,201608,944102
2023-04-19 15:07,944113,256207,486297,201609,944113
2023-04-19 15:08,944124,256215,486297,201612,944124
2023-04-19 15:09,944135,256222,486301,201612,944135
2023-04-19 15:10,944147,256233,486302,201612,944147
2023-04-19 15:12,944158,256241,486303,201614,944158
2023-04-19 15:13,944169,256252,486303,201614,944169
2023-04-19 15:14,944179,256261,486303,201615,944179
2023-04-19 15:15,944191,256269,486305,201617,944191
2023-04-19 15:16,944202,256277,486305,201620,944202
2023-04-19 15:17,944213,256288,486305,201620,944213
2023-04-19 15:18,944224,256299,486305,201620,944224
2023-04-19 15:19,944236,256308,486307,201621,944236
2023-04-19 15:20,944247,256317,486307,201623,944247
2023-04-19 15:21,944258,256326,486308,201624,944258
2023-04-19 15:22,944268,256332,486310,201626,944268
2023-04-19 15:23,944280,256344,486310,201626,944280
2023-04-19 15:24,944291,256348,486313,201630,944291
2023-04-19 15:25,944302,256359,486313,201630,944302
2023-04-19 15:26,944313,256368,486314,201631,944313
2023-04-19 15:27,944325,256378,486314,201633,944325
2023-04-19 15:28,944335,256385,486313,201637,944335
2023-04-19 15:29,944346,256391,486316,201639,944346
2023-04-19 15:30,944357,256401,486316,201640,944357
2023-04-19 15:31,944369,256413,486316,201640,944369
2023-04-19 15:32,944380,256423,486316,201641,944380
2023-04-19 15:33,944392,256430,486318,201644,944392
2023-04-19 15:34,944403,256441,486318,201644,944403
2023-04-19 15:35,944416,256450,486321,201645,944416
2023-04-19 15:36,944426,256460,486321,201645,944426
2023-04-19 15:37,944438,256467,486325,201646,944438
2023-04-19 15:38,944450,256478,486325,201647,944450
2023-04-19 15:39,944461,256488,486326,201647,944461
2023-04-19 15:40,944472,256498,486326,201648,944472
2023-04-19 15:41,944483,256504,486328,201651,944483
2023-04-19 15:42,944495,256516,486328,201651,944495
2023-04-19 15:43,944507,256528,486328,201651,944507
2023-04-19 15:44,944517,256538,486328,201651,944517
2023-04-19 15:45,944529,256548,486328,201653,944529
2023-04-19 15:46,944540,256560,486328,201652,944540
2023-04-19 15:47,944551,256569,486330,201652,944551
2023-04-19 15:48,944564,256581,486330,201653,944564
2023-04-19 15:49,944575,256591,486330,201654,944575
2023-04-19 15:50,944586,256598,486332,201656,944586
2023-04-19 15:51,944597,256608,486332,201657,944597
2023-04-19 15:52,944609,256617,486333,201659,944609
2023-04-19 15:53,944619,256627,486333,201659,944619
2023-04-19 15:54,944632,256639,486334,201659,944632
2023-04-19 15:55,944643,256648,486337,201658,944643
2023-04-19 15:56,944653,256653,486337,201663,944653
2023-04-19 15:57,944664,256662,486339,201663,944664
2023-04-19 15:58,944676,256673,486339,201664,944676
2023-04-19 16:00,944687,256684,486339,201664,944687
2023-04-19 16:01,944690,256686,486339,201665,944690
2023-04-19 16:02,944692,256683,486344,201665,944692
2023-04-19 16:03,944695,256686,486344,201665,944695
2023-04-19 16:04,944698,256686,486346,201666,944698
2023-04-19 16:05,944700,256688,486346,201666,944700
2023-04-19 16:06,944702,256691,486345,201666,944702
2023-04-19 16:07,944705,256693,486345,201667,944705
2023-04-19 16:08,944707,256691,486348,201668,944707
2023-04-19 16:09,944709,256691,486348,201670,944709
2023-04-19 16:10,944712,256692,486349,201671,944712
2023-04-19 16:11,944714,256694,486349,201671,944714
2023-04-19 16:12,944716,256692,486351,201673,944716
2023-04-19 16:13,944719,256694,486351,201674,944719
2023-04-19 16:14,944721,256689,486355,201677,944721
2023-04-19 16:15,944724,256690,486355,201679,944724
2023-04-19 16:16,944727,256693,486356,201678,944727
2023-04-19 16:17,944730,256696,486356,201678,944730
2023-04-19 16:18,944732,256695,486357,201680,944732
2023-04-19 16:19,944734,256692,486360,201682,944734
2023-04-19 16:20,944737,256695,486360,201682,944737
2023-04-19 16:21,944739,256694,486362,201683,944739
2023-04-19 16:22,944741,256695,486362,201684,944741
2023-04-19 16:23,944744,256694,486364,201686,944744
2023-04-19 16:24,944746,256695,486364,201687,944746
2023-04-19 16:25,944748,256697,486364,201687,944748
2023-04-19 16:26,944751,256697,486364,201690,944751
2023-04-19 16:27,944753,256691,486370,201692,944753
2023-04-19 16:28,944755,256690,486370,201695,944755
2023-04-19 16:29,944758,256691,486372,201695,944758
2023-04-19 16:30,944760,256693,486372,201695,944760
2023-04-19 16:31,944762,256693,486373,201696,944762
2023-04-19 16:32,944765,256696,486373,201696,944765
2023-04-19 16:33,944767,256694,486374,201699,944767
2023-04-19 16:34,944769,256694,486374,201701,944769
2023-04-19 16:35,944772,256694,486376,201702,944772
2023-04-19 16:36,944774,256694,486376,201704,944774
2023-04-19 16:37,944776,256694,486377,201705,944776
2023-04-19 16:38,944778,256694,486377,201707,944778
2023-04-19 16:39,944781,256691,486382,201708,944781
2023-04-19 16:40,944783,256692,486382,201709,944783
2023-04-19 16:41,944785,256691,486385,201709,944785
2023-04-19 16:42,944788,256693,486385,201710,944788
2023-04-19 16:43,944790,256695,486386,201709,944790
2023-04-19 16:44,944792,256694,486386,201712,944792
2023-04-19 16:46,944795,256696,486387,201712,944795
2023-04-19 16:47,944797,256695,486389,201713,944797
2023-04-19 16:48,944799,256698,486388,201713,944799
2023-04-19 16:49,944802,256699,486388,201715,944802
2023-04-19 16:50,944804,256698,486390,201716,944804
2023-04-19 16:51,944807,256701,486390,201716,944807
2023-04-19 16:52,944810,256702,486393,201715,944810
2023-04-19 16:53,944812,256703,486393,201716,944812
2023-04-19 16:54,944814,256703,486394,201717,944814
2023-04-19 16:55,944818,256707,486394,201717,944818
2023-04-19 16:56,944821,256705,486399,201717,944821
2023-04-19 16:57,944823,256706,486400,201717,944823
2023-04-19 16:58,944825,256707,486400,201718,944825
2023-04-19 16:59,944828,256708,486400,201720,944828
2023-04-19 17:00,944830,256710,486400,201720,944830
2023-04-19 17:01,944833,256709,486402,201722,944833
2023-04-19 17:02,944836,256711,486402,201723,944836
2023-04-19 17:03,944838,256709,486406,201723,944838
2023-04-19 17:04,944841,256711,486407,201723,944841
2023-04-19 17:05,944844,256712,486407,201725,944844
2023-04-19 17:06,944848,256711,486409,201728,944848
2023-04-19 17:07,944850,256711,486409,201730,944850
2023-04-19 17:08,944853,256712,486411,201730,944853
2023-04-19 17:09,944856,256712,486413,201731,944856
2023-04-19 17:10,944858,256713,486413,201732,944858
2023-04-19 17:11,944861,256712,486415,201734,944861
2023-04-19 17:12,944864,256711,486417,201736,944864
2023-04-19 17:13,944866,256712,486417,201737,944866
2023-04-19 17:14,944869,256711,486420,201738,944869
2023-04-19 17:15,944872,256712,486420,201740,944872
2023-04-19 17:16,944875,256714,486420,201741,944875
2023-04-19 17:17,944878,256715,486420,201743,944878
2023-04-19 17:18,944881,256716,486420,201745,944881
2023-04-19 17:19,944884,256718,486420,201746,944884
2023-04-19 17:20,944887,256720,486420,201747,944887
2023-04-19 17:21,944889,256721,486420,201748,944889
2023-04-19 17:22,944892,256722,486420,201750,944892
2023-04-19 17:23,944896,256726,486420,201750,944896
2023-04-19 17:24,944899,256717,486431,201751,944899
2023-04-19 17:25,944901,256719,486431,201751,944901
2023-04-19 17:26,944904,256722,486431,201751,944904
2023-04-19 17:27,944907,256722,486431,201754,944907
2023-04-19 17:28,944911,256717,486440,201754,944911
2023-04-19 17:29,944913,256715,486442,201756,944913
2023-04-19 17:30,944916,256716,486442,201758,944916
2023-04-19 17:31,944919,256719,486442,201758,944919
2023-04-19 17:32,944921,256721,486442,201758,944921
2023-04-19 17:34,944924,256718,486446,201760,944924
2023-04-19 17:35,944927,256720,486446,201761,944927
2023-04-19 17:36,944929,256719,486449,201761,944929
2023-04-19 17:37,944933,256723,486449,201761,944933
2023-04-19 17:38,944936,256723,486450,201763,944936
2023-04-19 17:39,944939,256725,486450,201764,944939
2023-04-19 17:40,944942,256723,486455,201764,944942
2023-04-19 17:41,944946,256726,486455,201765,944946
2023-04-19 17:42,944949,256725,486456,201768,944949
2023-04-19 17:43,944952,256728,486456,201768,944952
2023-04-19 17:44,944954,256731,486456,201767,944954
2023-04-19 17:45,944957,256734,486456,201767,944957
2023-04-19 17:46,944960,256735,486459,201766,944960
2023-04-19 17:47,944962,256735,486459,201768,944962
2023-04-19 17:48,944965,256734,486462,201769,944965
2023-04-19 17:49,944968,256737,486462,201769,944968
2023-04-19 17:50,944971,256739,486463,201769,944971
2023-04-19 17:51,944974,256741,486463,201770,944974
2023-04-19 17:52,944977,256742,486465,201770,944977
2023-04-19 17:53,944980,256744,486465,201771,944980
2023-04-19 17:54,944983,256745,486467,201771,944983
2023-04-19 17:55,944986,256747,486467,201772,944986
2023-04-19 17:56,944989,256743,486471,201775,944989
2023-04-19 17:57,944992,256746,486471,201775,944992
2023-04-19 17:58,944994,256744,486474,201776,944994
2023-04-19 17:59,944997,256747,486474,201776,944997
2023-04-19 18:00,945000,256747,486475,201778,945000
2023-04-19 18:01,945005,256752,486475,201778,945005
2023-04-19 18:02,945009,256753,486476,201780,945009
2023-04-19 18:03,945013,256757,486476,201780,945013
2023-04-19 18:04,945017,256755,486480,201782,945017
2023-04-19 18:05,945021,256756,486482,201783,945021
2023-04-19 18:06,945025,256758,486482,201785,945025
2023-04-19 18:07,945029,256760,486484,201785,945029
2023-04-19 18:08,945033,256761,486484,201788,945033
2023-04-19 18:09,945037,256763,486485,201789,945037
2023-04-19 18:10,945041,256765,486485,201791,945041
2023-04-19 18:11,945045,256763,486488,201794,945045
2023-04-19 18:12,945050,256767,486488,201795,945050
2023-04-19 18:13,945054,256766,486492,201796,945054
2023-04-19 18:14,945058,256769,486492,201797,945058
2023-04-19 18:15,945062,256769,486494,201799,945062
2023-04-19 18:16,945066,256773,486494,201799,945066
2023-04-19 18:17,945070,256777,486494,201799,945070
2023-04-19 18:18,945074,256778,486495,201801,945074
2023-04-19 18:19,945078,256781,486495,201802,945078
2023-04-19 18:21,945082,256781,486497,201804,945082
2023-04-19 18:22,945086,256785,486497,201804,945086
2023-04-19 18:23,945090,256789,486496,201805,945090
2023-04-19 18:24,945095,256793,486497,201805,945095
2023-04-19 18:25,945099,256796,486497,201806,945099
2023-04-19 18:26,945103,256787,486507,201809,945103
2023-04-19 18:27,945107,256788,486507,201812,945107
2023-04-19 18:28,945111,256788,486509,201814,945111
2023-04-19 18:29,945117,256792,486509,201816,945117
2023-04-19 18:30,945121,256792,486513,201816,945121
2023-04-19 18:31,945126,256795,486513,201818,945126
2023-04-19 18:32,945130,256791,486518,201821,945130
2023-04-19 18:33,945134,256793,486518,201823,945134
2023-04-19 18:34,945138,256793,486522,201823,945138
2023-04-19 18:35,945142,256795,486522,201825,945142
2023-04-19 18:36,945146,256791,486530,201825,945146
2023-04-19 18:37,945150,256794,486530,201826,945150
2023-04-19 18:38,945155,256792,486536,201827,945155
2023-04-19 18:39,945160,256794,486536,201830,945160
2023-04-19 18:40,945164,256794,486538,201832,945164
2023-04-19 18:41,945170,256799,486538,201833,945170
2023-04-19 18:42,945174,256797,486544,201833,945174
2023-04-19 18:43,945178,256800,486544,201834,945178
2023-04-19 18:44,945182,256791,486556,201835,945182
2023-04-19 18:45,945186,256788,486562,201836,945186
2023-04-19 18:46,945190,256787,486566,201837,945190
2023-04-19 18:47,945194,256789,486566,201839,945194
2023-04-19 18:48,945198,256787,486570,201841,945198
2023-04-19 18:49,945204,256793,486570,201841,945204
2023-04-19 18:50,945209,256791,486577,201841,945209
2023-04-19 18:51,945213,256795,486577,201841,945213
2023-04-19 18:52,945217,256792,486584,201841,945217
2023-04-19 18:53,945221,256794,486584,201843,945221
2023-04-19 18:54,945226,256789,486594,201843,945226
2023-04-19 18:55,945232,256794,486594,201844,945232
2023-04-19 18:56,945240,256795,486600,201845,945240
2023-04-19 18:57,945244,256791,486603,201850,945244
2023-04-19 18:58,945249,256795,486603,201851,945249
2023-04-19 18:59,945253,256793,486608,201852,945253
2023-04-19 19:00,945262,256796,486614,201852,945262
2023-04-19 19:01,945271,256805,486614,201852,945271
2023-04-19 19:02,945282,256808,486622,201852,945282
2023-04-19 19:03,945292,256816,486624,201852,945292
2023-04-19 19:04,945302,256822,486628,201852,945302
2023-04-19 19:05,945311,256829,486628,201854,945311
2023-04-19 19:06,945321,256832,486634,201855,945321
2023-04-19 19:07,945333,256843,486634,201856,945333
2023-04-19 19:09,945343,256843,486643,201857,945343
2023-04-19 19:10,945352,256851,486643,201858,945352
2023-04-19 19:11,945362,256851,486650,201861,945362
2023-04-19 19:12,945371,256860,486650,201861,945371
2023-04-19 19:13,945381,256858,486661,201862,945381
2023-04-19 19:14,945390,256865,486663,201862,945390
2023-04-19 19:15,945401,256875,486663,201863,945401
2023-04-19 19:16,945411,256874,486672,201865,945411
2023-04-19 19:17,945421,256881,486674,201866,945421
2023-04-19 19:18,945432,256892,486674,201866,945432
2023-04-19 19:19,945442,256894,486681,201867,945442
2023-04-19 19:20,945453,256903,486681,201869,945453
2023-04-19 19:21,945463,256903,486690,201870,945463
2023-04-19 19:22,945474,256912,486690,201872,945474
2023-04-19 19:23,945483,256912,486697,201874,945483
2023-04-19 19:24,945493,256917,486702,201874,945493
2023-04-19 19:25,945502,256924,486702,201876,945502
2023-04-19 19:26,945512,256930,486705,201877,945512
2023-04-19 19:27,945522,256936,486707,201879,945522
2023-04-19 19:28,945533,256941,486711,201881,945533
2023-04-19 19:29,945542,256950,486711,201881,945542
2023-04-19 19:30,945552,256956,486715,201881,945552
2023-04-19 19:31,945563,256962,486720,201881,945563
2023-04-19 19:32,945574,256970,486723,201881,945574
2023-04-19 19:33,945583,256979,486723,201881,945583
2023-04-19 19:34,945593,256979,486732,201882,945593
2023-04-19 19:35,945603,256987,486732,201884,945603
2023-04-19 19:36,945613,256987,486741,201885,945613
2023-04-19 19:37,945625,256997,486741,201887,945625
2023-04-19 19:38,945634,257001,486744,201889,945634
2023-04-19 19:39,945647,257011,486745,201891,945647
2023-04-19 19:40,945657,257020,486745,201892,945657
2023-04-19 19:41,945668,257027,486748,201893,945668
2023-04-19 19:42,945678,257034,486748,201896,945678
2023-04-19 19:43,945687,257033,486757,201897,945687
2023-04-19 19:44,945698,257042,486757,201899,945698
2023-04-19 19:45,945708,257048,486760,201900,945708
2023-04-19 19:46,945718,257058,486760,201900,945718
2023-04-19 19:47,945727,257061,486763,201903,945727
2023-04-19 19:48,945739,257070,486763,201906,945739
2023-04-19 19:49,945748,257076,486764,201908,945748
2023-04-19 19:50,945758,257082,486768,201908,945758
2023-04-19 19:51,945768,257091,486768,201909,945768
2023-04-19 19:52,945777,257092,486776,201909,945777
2023-04-19 19:53,945787,257100,486776,201911,945787
2023-04-19 19:54,945798,257108,486778,201912,945798
2023-04-19 19:56,945808,257117,486778,201913,945808
2023-04-19 19:57,945818,257124,486780,201914,945818
2023-04-19 19:58,945828,257131,486783,201914,945828
2023-04-19 19:59,945838,257139,486783,201916,945838
2023-04-19 20:00,945849,257144,486789,201916,945849
2023-04-19 20:01,945858,257151,486789,201918,945858
2023-04-19 20:02,945869,257153,486797,201919,945869
2023-04-19 20:03,945878,257160,486799,201919,945878
2023-04-19 20:04,945888,257169,486799,201920,945888
2023-04-19 20:05,945898,257170,486808,201920,945898
2023-04-19 20:06,945907,257176,486808,201923,945907
2023-04-19 20:07,945917,257178,486815,201924,945917
2023-04-19 20:08,945927,257186,486817,201924,945927
2023-04-19 20:09,945937,257192,486817,201928,945937
2023-04-19 20:10,945947,257197,486819,201931,945947
2023-04-19 20:11,945956,257198,486822,201936,945956
2023-04-19 20:12,945967,257208,486822,201937,945967
2023-04-19 20:13,945976,257214,486824,201938,945976
2023-04-19 20:14,945986,257222,486824,201940,945986
2023-04-19 20:15,945996,257223,486833,201940,945996
2023-04-19 20:16,946006,257229,486836,201941,946006
2023-04-19 20:17,946016,257235,486836,201945,946016
2023-04-19 20:18,946025,257237,486841,201947,946025
2023-04-19 20:19,946035,257247,486841,201947,946035
2023-04-19 20:20,946046,257257,486842,201947,946046
2023-04-19 20:21,946057,257268,486842,201947,946057
2023-04-19 20:22,946066,257268,486850,201948,946066
2023-04-19 20:23,946078,257279,486850,201949,946078
2023-04-19 20:24,946087,257284,486852,201951,946087
2023-04-19 20:25,946098,257294,486852,201952,946098
2023-04-19 20:26,946108,257301,486854,201953,946108
2023-04-19 20:27,946117,257307,486856,201954,946117
2023-04-19 20:28,946126,257312,486859,201955,946126
2023-04-19 20:29,946136,257316,486864,201956,946136
2023-04-19 20:30,946146,257326,486864,201956,946146
2023-04-19 20:31,946156,257327,486870,201959,946156
2023-04-19 20:32,946166,257333,486873,201960,946166
2023-04-19 20:33,946175,257342,486873,201960,946175
2023-04-19 20:34,946185,257349,486876,201960,946185
2023-04-19 20:36,946198,257360,486876,201962,946198
2023-04-19 20:37,946208,257363,486881,201964,946208
2023-04-19 20:38,946221,257376,486881,201964,946221
2023-04-19 20:39,946231,257378,486888,201965,946231
2023-04-19 20:40,946241,257387,486889,201965,946241
2023-04-19 20:41,946252,257396,486889,201967,946252
2023-04-19 20:42,946262,257395,486898,201969,946262
2023-04-19 20:43,946271,257403,486898,201970,946271
2023-04-19 20:44,946280,257406,486903,201971,946280
2023-04-19 20:45,946291,257416,486903,201972,946291
2023-04-19 20:46,946301,257418,486910,201973,946301
2023-04-19 20:47,946310,257425,486911,201974,946310
2023-04-19 20:48,946321,257434,486911,201976,946321
2023-04-19 20:49,946330,257438,486914,201978,946330
2023-04-19 20:50,946342,257449,486914,201979,946342
2023-04-19 20:51,946351,257453,486917,201981,946351
2023-04-19 20:52,946361,257460,486917,201984,946361
2023-04-19 20:53,946371,257465,486920,201986,946371
2023-04-19 20:54,946382,257476,486920,201986,946382
2023-04-19 20:56,946399,257485,486925,201989,946399
2023-04-19 20:57,946408,257489,486929,201990,946408
2023-04-19 20:58,946418,257498,486929,201991,946418
2023-04-19 20:59,946427,257503,486931,201993,946427
2023-04-19 21:01,946437,257512,486931,201994,946437
2023-04-19 21:02,946444,257514,486931,201999,946444
2023-04-19 21:03,946450,257510,486939,202001,946450
2023-04-19 21:04,946456,257516,486939,202001,946456
2023-04-19 21:05,946461,257521,486938,202002,946461
2023-04-19 21:06,946468,257524,486938,202006,946468
2023-04-19 21:07,946474,257526,486940,202008,946474
2023-04-19 21:08,946480,257530,486940,202010,946480
2023-04-19 21:09,946485,257531,486944,202010,946485
2023-04-19 21:10,946492,257532,486948,202012,946492
2023-04-19 21:11,946498,257536,486948,202014,946498
2023-04-19 21:12,946504,257534,486954,202016,946504
2023-04-19 21:13,946511,257540,486954,202017,946511
2023-04-19 21:14,946518,257542,486957,202019,946518
2023-04-19 21:15,946523,257545,486957,202021,946523
2023-04-19 21:16,946530,257542,486963,202025,946530
2023-04-19 21:17,946537,257548,486963,202026,946537
2023-04-19 21:18,946543,257549,486968,202026,946543
2023-04-19 21:19,946549,257551,486968,202030,946549
2023-04-19 21:20,946555,257545,486977,202033,946555
2023-04-19 21:21,946560,257545,486977,202038,946560
2023-04-19 21:22,946566,257544,486984,202038,946566
2023-04-19 21:23,946572,257550,486984,202038,946572
2023-04-19 21:24,946578,257550,486989,202039,946578
2023-04-19 21:25,946584,257555,486989,202040,946584
2023-04-19 21:26,946590,257556,486993,202041,946590
2023-04-19 21:28,946595,257559,486993,202043,946595
2023-04-19 21:29,946601,257564,486994,202043,946601
2023-04-19 21:30,946608,257569,486994,202045,946608
2023-04-19 21:31,946614,257567,486999,202048,946614
2023-04-19 21:32,946619,257568,487001,202050,946619
2023-04-19 21:33,946626,257571,487004,202051,946626
2023-04-19 21:34,946633,257576,487004,202053,946633
2023-04-19 21:35,946639,257577,487008,202054,946639
2023-04-19 21:36,946646,257583,487008,202055,946646
2023-04-19 21:37,946655,257589,487011,202055,946655
2023-04-19 21:38,946661,257595,487011,202055,946661
2023-04-19 21:39,946667,257597,487015,202055,946667
2023-04-19 21:40,946673,257601,487015,202057,946673
2023-04-19 21:41,946678,257601,487019,202058,946678
2023-04-19 21:42,946684,257607,487019,202058,946684
2023-04-19 21:43,946690,257610,487019,202061,946690
2023-04-19 21:44,946698,257615,487019,202064,946698
2023-04-19 21:45,946703,257618,487019,202066,946703
2023-04-19 21:46,946709,257617,487026,202066,946709
2023-04-19 21:47,946714,257618,487028,202068,946714
2023-04-19 21:48,946720,257621,487028,202071,946720
2023-04-19 21:49,946727,257625,487030,202072,946727
2023-04-19 21:50,946737,257634,487030,202073,946737
2023-04-19 21:51,946745,257634,487038,202073,946745
2023-04-19 21:52,946750,257634,487042,202074,946750
2023-04-19 21:53,946758,257640,487042,202076,946758
2023-04-19 21:54,946767,257643,487047,202077,946767
2023-04-19 21:55,946772,257645,487047,202080,946772
2023-04-19 21:56,946779,257649,487048,202082,946779
2023-04-19 21:57,946785,257653,487048,202084,946785
2023-04-19 21:58,946791,257650,487055,202086,946791
2023-04-19 21:59,946797,257656,487055,202086,946797
2023-04-19 22:00,946800,257655,487057,202088,946800
2023-04-19 22:01,946803,257652,487060,202091,946803
2023-04-19 22:02,946806,257651,487060,202095,946806
2023-04-19 22:03,946809,257649,487065,202095,946809
2023-04-19 22:04,946812,257650,487065,202097,946812
2023-04-19 22:05,946815,257653,487065,202097,946815
2023-04-19 22:06,946818,257647,487072,202099,946818
2023-04-19 22:07,946821,257650,487072,202099,946821
2023-04-19 22:08,946824,257650,487074,202100,946824
2023-04-19 22:09,946829,257653,487075,202101,946829
2023-04-19 22:10,946831,257647,487080,202104,946831
2023-04-19 22:11,946834,257649,487080,202105,946834
2023-04-19 22:12,946837,257646,487085,202106,946837
2023-04-19 22:14,946839,257645,487086,202108,946839
2023-04-19 22:15,946842,257641,487092,202109,946842
2023-04-19 22:16,946845,257642,487092,202111,946845
2023-04-19 22:17,946847,257638,487096,202113,946847
2023-04-19 22:18,946851,257637,487100,202114,946851
2023-04-19 22:19,946854,257640,487100,202114,946854
2023-04-19 22:20,946857,257633,487109,202115,946857
2023-04-19 22:21,946859,257634,487109,202116,946859
2023-04-19 22:22,946862,257631,487113,202118,946862
2023-04-19 22:23,946865,257632,487113,202120,946865
2023-04-19 22:24,946869,257625,487121,202123,946869
2023-04-19 22:25,946871,257625,487121,202125,946871
2023-04-19 22:26,946874,257618,487129,202127,946874
2023-04-19 22:27,946878,257614,487134,202130,946878
2023-04-19 22:28,946880,257614,487134,202132,946880
2023-04-19 22:29,946884,257610,487140,202134,946884
2023-04-19 22:30,946888,257612,487140,202136,946888
2023-04-19 22:31,946890,257609,487145,202136,946890
2023-04-19 22:32,946893,257611,487145,202137,946893
2023-04-19 22:33,946897,257608,487150,202139,946897
2023-04-19 22:34,946900,257609,487150,202141,946900
2023-04-19 22:35,946902,257601,487158,202143,946902
2023-04-19 22:36,946907,257605,487158,202144,946907
2023-04-19 22:37,946910,257600,487163,202147,946910
2023-04-19 22:38,946913,257598,487163,202152,946913
2023-04-19 22:39,946915,257597,487165,202153,946915
2023-04-19 22:40,946918,257598,487165,202155,946918
2023-04-19 22:41,946921,257590,487173,202158,946921
2023-04-19 22:42,946923,257591,487173,202159,946923
2023-04-19 22:43,946927,257592,487175,202160,946927
2023-04-19 22:44,946930,257595,487175,202160,946930
2023-04-19 22:45,946933,257595,487178,202160,946933
2023-04-19 22:46,946937,257597,487178,202162,946937
2023-04-19 22:47,946940,257594,487183,202163,946940
2023-04-19 22:48,946943,257591,487189,202163,946943
2023-04-19 22:49,946945,257591,487189,202165,946945
2023-04-19 22:50,946948,257585,487196,202167,946948
2023-04-19 22:51,946951,257588,487196,202167,946951
2023-04-19 22:52,946953,257579,487204,202170,946953
2023-04-19 22:53,946956,257581,487204,202171,946956
2023-04-19 22:54,946960,257584,487204,202172,946960
2023-04-19 22:55,946962,257586,487204,202172,946962
2023-04-19 22:56,946967,257588,487204,202175,946967
2023-04-19 22:57,946972,257590,487204,202178,946972
2023-04-19 22:58,946975,257591,487204,202180,946975
2023-04-19 22:59,946977,257593,487204,202180,946977
2023-04-19 23:01,946984,257595,487204,202185,946984
2023-04-19 23:02,946990,257598,487204,202188,946990
2023-04-19 23:03,946997,257581,487227,202189,946997
2023-04-19 23:04,947004,257586,487227,202191,947004
2023-04-19 23:05,947012,257590,487231,202191,947012
2023-04-19 23:06,947018,257596,487231,202191,947018
2023-04-19 23:07,947026,257599,487234,202193,947026
2023-04-19 23:08,947032,257603,487234,202195,947032
2023-04-19 23:09,947039,257604,487238,202197,947039
2023-04-19 23:10,947047,257611,487238,202198,947047
2023-04-19 23:11,947053,257608,487245,202200,947053
2023-04-19 23:12,947061,257615,487245,202201,947061
2023-04-19 23:13,947069,257615,487251,202203,947069
2023-04-19 23:14,947075,257618,487251,202206,947075
2023-04-19 23:15,947082,257619,487254,202209,947082
2023-04-19 23:16,947089,257627,487254,202208,947089
2023-04-19 23:17,947095,257627,487258,202210,947095
2023-04-19 23:18,947102,257634,487258,202210,947102
2023-04-19 23:19,947109,257632,487266,202211,947109
2023-04-19 23:20,947115,257636,487266,202213,947115
2023-04-19 23:21,947122,257637,487271,202214,947122
2023-04-19 23:22,947129,257641,487271,202217,947129
2023-04-19 23:23,947135,257642,487276,202217,947135
2023-04-19 23:24,947143,257649,487276,202218,947143
2023-04-19 23:25,947151,257651,487280,202220,947151
2023-04-19 23:26,947157,257655,487280,202222,947157
2023-04-19 23:27,947164,257653,487288,202223,947164
2023-04-19 23:28,947171,257659,487288,202224,947171
2023-04-19 23:29,947177,257663,487290,202224,947177
2023-04-19 23:30,947184,257669,487290,202225,947184
2023-04-19 23:31,947191,257667,487297,202227,947191
2023-04-19 23:32,947198,257671,487297,202230,947198
2023-04-19 23:33,947205,257670,487301,202234,947205
2023-04-19 23:34,947212,257676,487301,202235,947212
2023-04-19 23:35,947220,257680,487303,202237,947220
2023-04-19 23:36,947228,257685,487303,202240,947228
2023-04-19 23:37,947236,257690,487303,202243,947236
2023-04-19 23:38,947243,257694,487303,202246,947243
2023-04-19 23:39,947252,257701,487303,202248,947252
2023-04-19 23:40,947260,257708,487303,202249,947260
2023-04-19 23:41,947266,257715,487303,202248,947266
2023-04-19 23:42,947273,257705,487318,202250,947273
2023-04-19 23:43,947280,257712,487318,202250,947280
2023-04-19 23:44,947286,257711,487323,202252,947286
2023-04-19 23:45,947293,257717,487323,202253,947293
2023-04-19 23:47,947299,257716,487329,202254,947299
2023-04-19 23:48,947306,257723,487329,202254,947306
2023-04-19 23:49,947314,257727,487330,202257,947314
2023-04-19 23:50,947321,257732,487330,202259,947321
2023-04-19 23:51,947327,257733,487333,202261,947327
2023-04-19 23:52,947334,257738,487333,202263,947334
2023-04-19 23:53,947340,257736,487340,202264,947340
2023-04-19 23:54,947347,257741,487340,202266,947347
2023-04-19 23:55,947354,257744,487343,202267,947354
2023-04-19 23:56,947360,257749,487343,202268,947360
2023-04-19 23:57,947368,257750,487347,202271,947368
2023-04-19 23:58,947375,257754,487347,202274,947375
2023-04-19 23:59,947381,257753,487351,202277,947381
2023-04-20 00:00,947387,257754,487354,202279,947387
2023-04-20 00:01,947387,257753,487354,202280,947387
2023-04-20 00:02,947388,257749,487358,202281,947388
2023-04-20 00:03,947388,257748,487358,202282,947388
2023-04-20 00:04,947388,257742,487360,202286,947388
2023-04-20 00:05,947388,257742,487360,202286,947388
2023-04-20 00:06,947388,257738,487363,202287,947388
2023-04-20 00:07,947389,257739,487363,202287,947389
2023-04-20 00:08,947389,257732,487367,202290,947389
2023-04-20 00:09,947389,257728,487367,202294,947389
2023-04-20 00:10,947390,257725,487371,202294,947390
2023-04-20 00:11,947390,257724,487371,202295,947390
2023-04-20 00:12,947391,257721,487374,202296,947391
2023-04-20 00:13,947391,257720,487374,202297,947391
2023-04-20 00:14,947391,257717,487375,202299,947391
2023-04-20 00:15,947391,257716,487375,202300,947391
2023-04-20 00:16,947392,257713,487378,202301,947392
2023-04-20 00:17,947392,257712,487378,202302,947392
2023-04-20 00:18,947393,257706,487383,202304,947393
2023-04-20 00:19,947393,257705,487383,202305,947393
2023-04-20 00:20,947393,257700,487387,202306,947393
2023-04-20 00:21,947393,257700,487387,202306,947393
2023-04-20 00:22,947393,257697,487389,202307,947393
2023-04-20 00:23,947393,257696,487389,202308,947393
2023-04-20 00:24,947393,257691,487394,202308,947393
2023-04-20 00:25,947394,257692,487394,202308,947394
2023-04-20 00:26,947394,257682,487403,202309,947394
2023-04-20 00:27,947394,257681,487403,202310,947394
2023-04-20 00:28,947394,257676,487407,202311,947394
2023-04-20 00:29,947394,257673,487407,202314,947394
2023-04-20 00:30,947394,257667,487412,202315,947394
2023-04-20 00:31,947394,257662,487416,202316,947394
2023-04-20 00:32,947394,257661,487416,202317,947394
2023-04-20 00:34,947395,257657,487420,202318,947395
2023-04-20 00:35,947396,257657,487420,202319,947396
2023-04-20 00:36,947396,257654,487423,202319,947396
2023-04-20 00:37,947396,257652,487423,202321,947396
2023-04-20 00:38,947396,257646,487428,202322,947396
2023-04-20 00:39,947396,257646,487428,202322,947396
2023-04-20 00:40,947396,257641,487432,202323,947396
2023-04-20 00:41,947396,257640,487432,202324,947396
2023-04-20 00:42,947397,257636,487436,202325,947397
2023-04-20 00:43,947397,257632,487436,202329,947397
2023-04-20 00:44,947397,257627,487439,202331,947397
2023-04-20 00:45,947397,257627,487439,202331,947397
2023-04-20 00:46,947397,257620,487445,202332,947397
2023-04-20 00:47,947397,257616,487446,202335,947397
2023-04-20 00:48,947397,257615,487446,202336,947397
2023-04-20 00:49,947397,257611,487450,202336,947397
2023-04-20 00:50,947397,257609,487450,202338,947397
2023-04-20 00:51,947397,257606,487452,202339,947397
2023-04-20 00:52,947398,257608,487452,202338,947398
2023-04-20 00:53,947398,257601,487457,202340,947398
2023-04-20 00:54,947398,257600,487457,202341,947398
2023-04-20 00:55,947398,257595,487462,202341,947398
2023-04-20 00:56,947398,257593,487462,202343,947398
2023-04-20 00:57,947398,257589,487464,202345,947398
2023-04-20 00:58,947398,257588,487464,202346,947398
2023-04-20 00:59,947399,257582,487470,202347,947399
2023-04-20 01:00,947399,257581,487470,202348,947399
2023-04-20 01:01,947399,257581,487470,202348,947399
2023-04-20 01:02,947399,257579,487470,202350,947399
2023-04-20 01:03,947399,257578,487470,202351,947399
2023-04-20 01:04,947399,257575,487470,202354,947399
2023-04-20 01:05,947399,257566,487477,202356,947399
2023-04-20 01:06,947399,257565,487478,202356,947399
2023-04-20 01:07,947399,257565,487478,202356,947399
2023-04-20 01:08,947399,257560,487481,202358,947399
2023-04-20 01:09,947399,257559,487481,202359,947399
2023-04-20 01:10,947399,257559,487482,202358,947399
2023-04-20 01:11,947399,257557,487482,202360,947399
2023-04-20 01:12,947399,257558,487482,202359,947399
2023-04-20 01:13,947399,257558,487482,202359,947399
2023-04-20 01:14,947399,257556,487484,202359,947399
2023-04-20 01:15,947399,257555,487484,202360,947399
2023-04-20 01:16,947399,257550,487486,202363,947399
2023-04-20 01:17,947399,257550,487486,202363,947399
2023-04-20 01:18,947399,257544,487491,202364,947399
2023-04-20 01:19,947399,257543,487491,202365,947399
2023-04-20 01:20,947399,257541,487492,202366,947399
2023-04-20 01:21,947399,257541,487492,202366,947399
2023-04-20 01:23,947399,257535,487497,202367,947399
2023-04-20 01:24,947399,257533,487497,202369,947399
2023-04-20 01:25,947399,257529,487501,202369,947399
2023-04-20 01:26,947399,257527,487501,202371,947399
2023-04-20 01:27,947399,257523,487504,202372,947399
2023-04-20 01:28,947399,257523,487504,202372,947399
2023-04-20 01:29,947399,257522,487505,202372,947399
2023-04-20 01:30,947400,257522,487505,202373,947400
2023-04-20 01:31,947400,257521,487506,202373,947400
2023-04-20 01:32,947400,257520,487506,202374,947400
2023-04-20 01:33,947400,257516,487509,202375,947400
2023-04-20 01:34,947400,257516,487509,202375,947400
2023-04-20 01:35,947400,257515,487509,202376,947400
2023-04-20 01:36,947401,257516,487509,202376,947401
2023-04-20 01:37,947402,257516,487510,202376,947402
2023-04-20 01:38,947402,257515,487510,202377,947402
2023-04-20 01:39,947402,257514,487511,202377,947402
2023-04-20 01:40,947402,257513,487511,202378,947402
2023-04-20 01:41,947402,257508,487514,202380,947402
2023-04-20 01:42,947402,257508,487514,202380,947402
2023-04-20 01:43,947402,257505,487515,202382,947402
2023-04-20 01:44,947402,257504,487515,202383,947402
2023-04-20 01:45,947402,257501,487518,202383,947402
2023-04-20 01:46,947402,257498,487521,202383,947402
2023-04-20 01:47,947402,257498,487521,202383,947402
2023-04-20 01:48,947402,257497,487521,202384,947402
2023-04-20 01:49,947403,257498,487521,202384,947403
2023-04-20 01:50,947404,257498,487521,202385,947404
2023-04-20 01:51,947404,257496,487521,202387,947404
2023-04-20 01:52,947404,257495,487521,202388,947404
2023-04-20 01:53,947404,257495,487521,202388,947404
2023-04-20 01:54,947404,257494,487521,202389,947404
2023-04-20 01:55,947404,257494,487521,202389,947404
2023-04-20 01:56,947404,257482,487533,202389,947404
2023-04-20 01:57,947404,257482,487533,202389,947404
2023-04-20 01:58,947404,257481,487533,202390,947404
2023-04-20 01:59,947404,257481,487533,202390,947404
2023-04-20 02:00,947407,257484,487533,202390,947407
2023-04-20 02:01,947413,257488,487533,202392,947413
2023-04-20 02:02,947419,257494,487533,202392,947419
2023-04-20 02:03,947424,257499,487533,202392,947424
2023-04-20 02:04,947429,257504,487533,202392,947429
2023-04-20 02:05,947435,257510,487533,202392,947435
2023-04-20 02:06,947441,257508,487540,202393,947441
2023-04-20 02:07,947446,257513,487540,202393,947446
2023-04-20 02:08,947451,257518,487540,202393,947451
2023-04-20 02:09,947457,257523,487540,202394,947457
2023-04-20 02:10,947462,257528,487540,202394,947462
2023-04-20 02:12,947467,257533,487540,202394,947467
2023-04-20 02:13,947473,257539,487540,202394,947473
2023-04-20 02:14,947478,257544,487540,202394,947478
2023-04-20 02:15,947483,257549,487540,202394,947483
2023-04-20 02:16,947489,257555,487540,202394,947489
2023-04-20 02:17,947494,257555,487545,202394,947494
2023-04-20 02:18,947500,257559,487547,202394,947500
2023-04-20 02:19,947505,257564,487547,202394,947505
2023-04-20 02:20,947510,257568,487548,202394,947510
2023-04-20 02:21,947516,257574,487548,202394,947516
2023-04-20 02:22,947521,257577,487548,202396,947521
2023-04-20 02:23,947526,257582,487548,202396,947526
2023-04-20 02:24,947531,257586,487548,202397,947531
2023-04-20 02:25,947536,257590,487548,202398,947536
2023-04-20 02:26,947542,257594,487549,202399,947542
2023-04-20 02:27,947547,257598,487549,202400,947547
2023-04-20 02:28,947552,257601,487551,202400,947552
2023-04-20 02:29,947557,257605,487551,202401,947557
2023-04-20 02:30,947563,257610,487552,202401,947563
2023-04-20 02:31,947568,257615,487552,202401,947568
2023-04-20 02:32,947573,257620,487552,202401,947573
2023-04-20 02:33,947579,257625,487552,202402,947579
2023-04-20 02:34,947584,257628,487554,202402,947584
2023-04-20 02:35,947589,257632,487554,202403,947589
2023-04-20 02:36,947594,257637,487554,202403,947594
2023-04-20 02:37,947600,257643,487554,202403,947600
2023-04-20 02:38,947605,257647,487555,202403,947605
2023-04-20 02:39,947610,257652,487555,202403,947610
2023-04-20 02:40,947616,257656,487557,202403,947616
2023-04-20 02:41,947621,257661,487557,202403,947621
2023-04-20 02:42,947627,257664,487558,202405,947627
2023-04-20 02:43,947633,257668,487558,202407,947633
2023-04-20 02:44,947639,257673,487559,202407,947639
2023-04-20 02:45,947644,257678,487559,202407,947644
2023-04-20 02:46,947650,257682,487560,202408,947650
2023-04-20 02:47,947655,257687,487560,202408,947655
2023-04-20 02:48,947661,257692,487560,202409,947661
2023-04-20 02:49,947666,257697,487560,202409,947666
2023-04-20 02:50,947671,257701,487561,202409,947671
2023-04-20 02:51,947676,257706,487561,202409,947676
2023-04-20 02:52,947682,257711,487562,202409,947682
2023-04-20 02:53,947687,257716,487562,202409,947687
2023-04-20 02:54,947692,257720,487563,202409,947692
2023-04-20 02:55,947697,257725,487563,202409,947697
2023-04-20 02:56,947703,257731,487563,202409,947703
2023-04-20 02:58,947708,257736,487563,202409,947708
2023-04-20 02:59,947713,257741,487563,202409,947713
2023-04-20 03:00,947719,257746,487563,202410,947719
2023-04-20 03:01,947722,257748,487564,202410,947722
2023-04-20 03:02,947725,257751,487564,202410,947725
2023-04-20 03:03,947728,257752,487566,202410,947728
2023-04-20 03:04,947732,257756,487566,202410,947732
2023-04-20 03:05,947735,257758,487566,202411,947735
2023-04-20 03:06,947738,257761,487566,202411,947738
2023-04-20 03:07,947742,257765,487566,202411,947742
2023-04-20 03:08,947745,257768,487566,202411,947745
2023-04-20 03:09,947748,257771,487566,202411,947748
2023-04-20 03:10,947752,257775,487566,202411,947752
2023-04-20 03:11,947755,257777,487567,202411,947755
2023-04-20 03:12,947758,257780,487567,202411,947758
2023-04-20 03:13,947761,257783,487567,202411,947761
2023-04-20 03:14,947765,257787,487567,202411,947765
2023-04-20 03:15,947768,257789,487568,202411,947768
2023-04-20 03:16,947771,257792,487568,202411,947771
2023-04-20 03:17,947775,257793,487569,202413,947775
2023-04-20 03:18,947778,257796,487569,202413,947778
2023-04-20 03:19,947781,257798,487570,202413,947781
2023-04-20 03:20,947785,257801,487570,202414,947785
2023-04-20 03:21,947789,257805,487570,202414,947789
2023-04-20 03:22,947792,257808,487570,202414,947792
2023-04-20 03:23,947795,257811,487570,202414,947795
2023-04-20 03:24,947799,257815,487570,202414,947799
2023-04-20 03:25,947802,257818,487570,202414,947802
2023-04-20 03:26,947806,257821,487570,202415,947806
2023-04-20 03:27,947809,257823,487571,202415,947809
2023-04-20 03:28,947812,257825,487571,202416,947812
2023-04-20 03:29,947815,257828,487571,202416,947815
2023-04-20 03:30,947819,257832,487571,202416,947819
2023-04-20 03:31,947822,257835,487571,202416,947822
2023-04-20 03:32,947825,257838,487571,202416,947825
2023-04-20 03:33,947829,257841,487572,202416,947829
2023-04-20 03:34,947832,257844,487572,202416,947832
2023-04-20 03:35,947835,257845,487574,202416,947835
2023-04-20 03:36,947838,257848,487574,202416,947838
2023-04-20 03:37,947842,257851,487575,202416,947842
2023-04-20 03:38,947845,257853,487575,202417,947845
2023-04-20 03:39,947848,257852,487577,202419,947848
2023-04-20 03:40,947852,257856,487577,202419,947852
2023-04-20 03:41,947856,257859,487578,202419,947856
2023-04-20 03:42,947859,257862,487578,202419,947859
2023-04-20 03:43,947862,257863,487580,202419,947862
2023-04-20 03:45,947866,257866,487580,202420,947866
2023-04-20 03:46,947870,257869,487580,202421,947870
2023-04-20 03:47,947874,257873,487580,202421,947874
2023-04-20 03:48,947877,257876,487580,202421,947877
2023-04-20 03:49,947880,257879,487580,202421,947880
2023-04-20 03:50,947883,257882,487580,202421,947883
2023-04-20 03:51,947887,257885,487580,202422,947887
2023-04-20 03:52,947890,257887,487581,202422,947890
2023-04-20 03:53,947893,257890,487581,202422,947893
2023-04-20 03:54,947897,257891,487583,202423,947897
2023-04-20 03:55,947900,257894,487583,202423,947900
2023-04-20 03:56,947903,257897,487583,202423,947903
2023-04-20 03:57,947906,257900,487583,202423,947906
2023-04-20 03:58,947910,257904,487583,202423,947910
2023-04-20 03:59,947913,257907,487583,202423,947913
2023-04-20 04:00,947919,257910,487584,202425,947919
2023-04-20 04:01,947931,257921,487584,202426,947931
2023-04-20 04:02,947942,257931,487585,202426,947942
2023-04-20 04:03,947953,257942,487585,202426,947953
2023-04-20 04:04,947965,257953,487586,202426,947965
2023-04-20 04:05,947977,257965,487586,202426,947977
2023-04-20 04:06,947989,257975,487587,202427,947989
2023-04-20 04:07,948000,257986,487587,202427,948000
2023-04-20 04:08,948012,257998,487587,202427,948012
2023-04-20 04:09,948025,258011,487587,202427,948025
2023-04-20 04:10,948035,258020,487588,202427,948035
2023-04-20 04:11,948047,258032,487588,202427,948047
2023-04-20 04:12,948059,258043,487588,202428,948059
2023-04-20 04:13,948071,258055,487588,202428,948071
2023-04-20 04:14,948083,258067,487588,202428,948083
2023-04-20 04:15,948094,258078,487588,202428,948094
2023-04-20 04:16,948106,258090,487588,202428,948106
2023-04-20 04:17,948118,258102,487588,202428,948118
2023-04-20 04:18,948131,258115,487588,202428,948131
2023-04-20 04:19,948142,258126,487588,202428,948142
2023-04-20 04:20,948154,258137,487589,202428,948154
2023-04-20 04:21,948166,258148,487589,202429,948166
2023-04-20 04:22,948177,258157,487590,202430,948177
2023-04-20 04:23,948189,258168,487590,202431,948189
2023-04-20 04:24,948200,258179,487590,202431,948200
2023-04-20 04:25,948212,258191,487590,202431,948212
2023-04-20 04:26,948223,258202,487590,202431,948223
2023-04-20 04:27,948235,258214,487590,202431,948235
2023-04-20 04:28,948247,258225,487591,202431,948247
2023-04-20 04:29,948258,258236,487591,202431,948258
2023-04-20 04:31,948270,258248,487591,202431,948270
2023-04-20 04:32,948282,258260,487591,202431,948282
2023-04-20 04:33,948293,258271,487591,202431,948293
2023-04-20 04:34,948305,258283,487591,202431,948305
2023-04-20 04:35,948316,258294,487592,202430,948316
2023-04-20 04:36,948327,258305,487592,202430,948327
2023-04-20 04:37,948339,258317,487592,202430,948339
2023-04-20 04:38,948351,258329,487592,202430,948351
2023-04-20 04:39,948362,258340,487592,202430,948362
2023-04-20 04:40,948374,258352,487592,202430,948374
2023-04-20 04:41,948385,258363,487592,202430,948385
2023-04-20 04:42,948398,258376,487592,202430,948398
2023-04-20 04:43,948410,258388,487592,202430,948410
2023-04-20 04:44,948422,258400,487592,202430,948422
2023-04-20 04:45,948433,258411,487592,202430,948433
2023-04-20 04:46,948444,258422,487592,202430,948444
2023-04-20 04:47,948456,258432,487592,202432,948456
2023-04-20 04:48,948468,258443,487593,202432,948468
2023-04-20 04:49,948479,258454,487593,202432,948479
2023-04-20 04:50,948491,258466,487593,202432,948491
2023-04-20 04:51,948502,258477,487593,202432,948502
2023-04-20 04:52,948515,258489,487593,202433,948515
2023-04-20 04:53,948526,258500,487593,202433,948526
2023-04-20 04:54,948537,258510,487594,202433,948537
2023-04-20 04:55,948549,258521,487594,202434,948549
2023-04-20 04:56,948561,258533,487594,202434,948561
2023-04-20 04:57,948572,258544,487594,202434,948572
2023-04-20 04:58,948584,258555,487595,202434,948584
2023-04-20 04:59,948595,258566,487595,202434,948595
2023-04-20 05:00,948604,258575,487595,202434,948604
2023-04-20 05:01,948611,258581,487595,202435,948611
2023-04-20 05:02,948617,258587,487595,202435,948617
2023-04-20 05:03,948624,258594,487595,202435,948624
2023-04-20 05:04,948631,258600,487596,202435,948631
2023-04-20 05:05,948637,258606,487596,202435,948637
2023-04-20 05:06,948644,258613,487596,202435,948644
2023-04-20 05:07,948650,258619,487596,202435,948650
2023-04-20 05:08,948657,258626,487596,202435,948657
2023-04-20 05:09,948664,258633,487596,202435,948664
2023-04-20 05:10,948670,258639,487596,202435,948670
2023-04-20 05:11,948677,258646,487596,202435,948677
2023-04-20 05:12,948683,258652,487596,202435,948683
2023-04-20 05:13,948690,258659,487596,202435,948690
2023-04-20 05:14,948696,258665,487596,202435,948696
2023-04-20 05:15,948703,258672,487596,202435,948703
2023-04-20 05:17,948709,258678,487596,202435,948709
2023-04-20 05:18,948716,258685,487596,202435,948716
2023-04-20 05:19,948722,258691,487596,202435,948722
2023-04-20 05:20,948729,258698,487596,202435,948729
2023-04-20 05:21,948735,258704,487596,202435,948735
2023-04-20 05:22,948742,258711,487596,202435,948742
2023-04-20 05:23,948748,258716,487597,202435,948748
2023-04-20 05:24,948755,258723,487597,202435,948755
2023-04-20 05:25,948762,258728,487598,202436,948762
2023-04-20 05:26,948768,258733,487598,202437,948768
2023-04-20 05:27,948775,258737,487600,202438,948775
2023-04-20 05:28,948781,258743,487600,202438,948781
2023-04-20 05:29,948788,258748,487601,202439,948788
2023-04-20 05:30,948794,258753,487601,202440,948794
2023-04-20 05:31,948801,258760,487601,202440,948801
2023-04-20 05:32,948807,258766,487601,202440,948807
2023-04-20 05:33,948814,258771,487602,202441,948814
2023-04-20 05:34,948821,258777,487602,202442,948821
2023-04-20 05:35,948827,258784,487601,202442,948827
2023-04-20 05:36,948834,258791,487601,202442,948834
2023-04-20 05:37,948840,258798,487600,202442,948840
2023-04-20 05:38,948847,258805,487600,202442,948847
2023-04-20 05:39,948854,258812,487600,202442,948854
2023-04-20 05:40,948860,258818,487600,202442,948860
2023-04-20 05:41,948866,258823,487600,202443,948866
2023-04-20 05:42,948874,258831,487600,202443,948874
2023-04-20 05:43,948881,258837,487601,202443,948881
2023-04-20 05:44,948888,258843,487601,202444,948888
2023-04-20 05:45,948894,258848,487601,202445,948894
2023-04-20 05:46,948900,258854,487601,202445,948900
2023-04-20 05:47,948907,258861,487601,202445,948907
2023-04-20 05:48,948914,258868,487601,202445,948914
2023-04-20 05:49,948920,258873,487602,202445,948920
2023-04-20 05:50,948926,258879,487602,202445,948926
2023-04-20 05:51,948933,258886,487602,202445,948933
2023-04-20 05:52,948940,258893,487602,202445,948940
2023-04-20 05:53,948946,258895,487604,202447,948946
2023-04-20 05:54,948953,258902,487604,202447,948953
2023-04-20 05:55,948959,258908,487604,202447,948959
2023-04-20 05:56,948966,258915,487604,202447,948966
2023-04-20 05:57,948973,258921,487605,202447,948973
2023-04-20 05:58,948979,258927,487605,202447,948979
2023-04-20 05:59,948985,258934,487604,202447,948985
2023-04-20 06:00,948989,258937,487604,202448,948989
2023-04-20 06:01,948992,258940,487604,202448,948992
2023-04-20 06:02,948995,258942,487604,202449,948995
2023-04-20 06:04,948998,258943,487606,202449,948998
2023-04-20 06:05,949001,258946,487606,202449,949001
2023-04-20 06:06,949004,258944,487610,202450,949004
2023-04-20 06:07,949007,258947,487610,202450,949007
2023-04-20 06:08,949010,258949,487611,202450,949010
2023-04-20 06:09,949013,258952,487611,202450,949013
2023-04-20 06:10,949016,258955,487611,202450,949016
2023-04-20 06:11,949019,258957,487611,202451,949019
2023-04-20 06:12,949022,258956,487615,202451,949022
2023-04-20 06:13,949025,258959,487615,202451,949025
2023-04-20 06:14,949028,258962,487615,202451,949028
2023-04-20 06:15,949031,258965,487615,202451,949031
2023-04-20 06:16,949034,258965,487616,202453,949034
2023-04-20 06:17,949037,258968,487616,202453,949037
2023-04-20 06:18,949040,258971,487616,202453,949040
2023-04-20 06:19,949043,258974,487616,202453,949043
2023-04-20 06:20,949046,258977,487616,202453,949046
2023-04-20 06:21,949049,258980,487616,202453,949049
2023-04-20 06:22,949052,258983,487615,202454,949052
2023-04-20 06:23,949055,258986,487615,202454,949055
2023-04-20 06:24,949058,258989,487615,202454,949058
2023-04-20 06:25,949061,258992,487615,202454,949061
2023-04-20 06:26,949064,258995,487615,202454,949064
2023-04-20 06:27,949067,258998,487615,202454,949067
2023-04-20 06:28,949070,259001,487615,202454,949070
2023-04-20 06:29,949073,259004,487615,202454,949073
2023-04-20 06:30,949076,259006,487616,202454,949076
2023-04-20 06:31,949079,259007,487616,202456,949079
2023-04-20 06:32,949082,259009,487617,202456,949082
2023-04-20 06:33,949085,259011,487617,202457,949085
2023-04-20 06:34,949088,259011,487620,202457,949088
2023-04-20 06:35,949091,259014,487620,202457,949091
2023-04-20 06:36,949094,259013,487621,202460,949094
2023-04-20 06:37,949097,259016,487621,202460,949097
2023-04-20 06:38,949100,259019,487621,202460,949100
2023-04-20 06:39,949103,259021,487621,202461,949103
2023-04-20 06:40,949106,259021,487621,202464,949106
2023-04-20 06:41,949109,259024,487621,202464,949109
2023-04-20 06:42,949112,259027,487621,202464,949112
2023-04-20 06:43,949115,259030,487621,202464,949115
2023-04-20 06:44,949118,259032,487621,202465,949118
2023-04-20 06:45,949121,259034,487621,202466,949121
2023-04-20 06:46,949124,259039,487619,202466,949124
2023-04-20 06:47,949127,259041,487619,202467,949127
2023-04-20 06:48,949131,259043,487620,202468,949131
2023-04-20 06:49,949134,259044,487620,202470,949134
2023-04-20 06:51,949137,259047,487620,202470,949137
2023-04-20 06:52,949141,259050,487620,202471,949141
2023-04-20 06:53,949144,259052,487621,202471,949144
2023-04-20 06:54,949147,259055,487621,202471,949147
2023-04-20 06:55,949150,259058,487621,202471,949150
2023-04-20 06:56,949153,259060,487621,202472,949153
2023-04-20 06:57,949156,259060,487623,202473,949156
2023-04-20 06:58,949159,259062,487623,202474,949159
2023-04-20 06:59,949162,259063,487625,202474,949162
2023-04-20 07:00,949166,259064,487625,202477,949166
2023-04-20 07:01,949174,259070,487625,202479,949174
2023-04-20 07:02,949183,259077,487625,202481,949183
2023-04-20 07:03,949191,259083,487626,202482,949191
2023-04-20 07:04,949200,259092,487626,202482,949200
2023-04-20 07:05,949209,259098,487627,202484,949209
2023-04-20 07:06,949217,259105,487627,202485,949217
2023-04-20 07:07,949227,259114,487627,202486,949227
2023-04-20 07:08,949235,259121,487627,202487,949235
2023-04-20 07:09,949244,259130,487627,202487,949244
2023-04-20 07:10,949252,259138,487627,202487,949252
2023-04-20 07:11,949260,259146,487627,202487,949260
2023-04-20 07:12,949269,259153,487627,202489,949269
2023-04-20 07:13,949278,259162,487627,202489,949278
2023-04-20 07:14,949286,259170,487627,202489,949286
2023-04-20 07:15,949294,259175,487629,202490,949294
2023-04-20 07:16,949303,259183,487629,202491,949303
2023-04-20 07:17,949312,259190,487631,202491,949312
2023-04-20 07:18,949320,259198,487631,202491,949320
2023-04-20 07:19,949329,259206,487632,202491,949329
2023-04-20 07:20,949337,259213,487632,202492,949337
2023-04-20 07:21,949346,259220,487634,202492,949346
2023-04-20 07:22,949354,259228,487634,202492,949354
2023-04-20 07:23,949363,259234,487637,202492,949363
2023-04-20 07:24,949372,259242,487637,202493,949372
2023-04-20 07:25,949381,259247,487640,202494,949381
2023-04-20 07:26,949389,259255,487640,202494,949389
2023-04-20 07:27,949397,259265,487639,202493,949397
2023-04-20 07:28,949406,259273,487639,202494,949406
2023-04-20 07:29,949416,259281,487640,202495,949416
2023-04-20 07:30,949424,259288,487641,202495,949424
2023-04-20 07:31,949433,259296,487641,202496,949433
2023-04-20 07:32,949441,259301,487643,202497,949441
2023-04-20 07:33,949450,259308,487643,202499,949450
2023-04-20 07:34,949459,259315,487645,202499,949459
2023-04-20 07:35,949467,259323,487645,202499,949467
2023-04-20 07:36,949476,259331,487646,202499,949476
2023-04-20 07:37,949484,259339,487646,202499,949484
2023-04-20 07:39,949493,259347,487647,202499,949493
2023-04-20 07:40,949501,259355,487647,202499,949501
2023-04-20 07:41,949511,259359,487650,202502,949511
2023-04-20 07:42,949519,259366,487650,202503,949519
2023-04-20 07:43,949527,259371,487651,202505,949527
2023-04-20 07:44,949536,259379,487651,202506,949536
2023-04-20 07:45,949544,259384,487653,202507,949544
2023-04-20 07:46,949554,259393,487653,202508,949554
2023-04-20 07:47,949562,259397,487656,202509,949562
2023-04-20 07:48,949571,259406,487656,202509,949571
2023-04-20 07:49,949579,259411,487658,202510,949579
2023-04-20 07:50,949588,259419,487658,202511,949588
2023-04-20 07:51,949596,259423,487661,202512,949596
2023-04-20 07:52,949605,259431,487661,202513,949605
2023-04-20 07:53,949613,259435,487664,202514,949613
2023-04-20 07:54,949623,259443,487664,202516,949623
2023-04-20 07:55,949631,259449,487666,202516,949631
2023-04-20 07:56,949640,259459,487666,202515,949640
2023-04-20 07:57,949648,259462,487669,202517,949648
2023-04-20 07:58,949657,259471,487669,202517,949657
2023-04-20 07:59,949666,259479,487669,202518,949666
2023-04-20 08:00,949672,259485,487669,202518,949672
2023-04-20 08:01,949675,259485,487671,202519,949675
2023-04-20 08:02,949679,259487,487671,202521,949679
2023-04-20 08:03,949683,259490,487671,202522,949683
2023-04-20 08:04,949686,259492,487671,202523,949686
2023-04-20 08:05,949692,259496,487673,202523,949692
2023-04-20 08:06,949695,259498,487673,202524,949695
2023-04-20 08:07,949699,259501,487673,202525,949699
2023-04-20 08:08,949703,259503,487674,202526,949703
2023-04-20 08:09,949707,259505,487676,202526,949707
2023-04-20 08:10,949710,259507,487677,202526,949710
2023-04-20 08:11,949714,259511,487677,202526,949714
2023-04-20 08:12,949718,259508,487683,202527,949718
2023-04-20 08:13,949721,259511,487683,202527,949721
2023-04-20 08:14,949727,259515,487685,202527,949727
2023-04-20 08:15,949731,259517,487685,202529,949731
2023-04-20 08:16,949736,259520,487685,202531,949736
2023-04-20 08:17,949740,259523,487685,202532,949740
2023-04-20 08:18,949746,259529,487685,202532,949746
2023-04-20 08:19,949749,259532,487685,202532,949749
2023-04-20 08:20,949753,259535,487685,202533,949753
2023-04-20 08:21,949756,259537,487685,202534,949756
2023-04-20 08:22,949760,259541,487685,202534,949760
2023-04-20 08:23,949763,259544,487685,202534,949763
2023-04-20 08:24,949767,259536,487694,202537,949767
2023-04-20 08:26,949770,259538,487694,202538,949770
2023-04-20 08:27,949774,259540,487694,202540,949774
2023-04-20 08:28,949777,259542,487694,202541,949777
2023-04-20 08:29,949782,259547,487694,202541,949782
2023-04-20 08:30,949786,259550,487694,202542,949786
2023-04-20 08:31,949789,259547,487698,202544,949789
2023-04-20 08:32,949793,259550,487698,202545,949793
2023-04-20 08:33,949796,259551,487699,202546,949796
2023-04-20 08:34,949801,259555,487699,202547,949801
2023-04-20 08:35,949804,259553,487703,202548,949804
2023-04-20 08:36,949810,259559,487703,202548,949810
2023-04-20 08:37,949814,259561,487703,202550,949814
2023-04-20 08:38,949817,259564,487703,202550,949817
2023-04-20 08:39,949820,259567,487703,202550,949820
2023-04-20 08:40,949824,259571,487703,202550,949824
2023-04-20 08:41,949827,259570,487704,202553,949827
2023-04-20 08:42,949832,259572,487704,202556,949832
2023-04-20 08:43,949836,259570,487709,202557,949836
2023-04-20 08:44,949839,259573,487709,202557,949839
2023-04-20 08:45,949844,259574,487711,202559,949844
2023-04-20 08:46,949847,259576,487711,202560,949847
2023-04-20 08:47,949851,259577,487712,202562,949851
2023-04-20 08:48,949854,259580,487712,202562,949854
2023-04-20 08:49,949858,259580,487714,202564,949858
2023-04-20 08:50,949861,259582,487714,202565,949861
2023-04-20 08:51,949865,259583,487716,202566,949865
2023-04-20 08:52,949869,259586,487716,202567,949869
2023-04-20 08:53,949872,259584,487718,202570,949872
2023-04-20 08:54,949877,259589,487718,202570,949877
2023-04-20 08:55,949880,259590,487720,202570,949880
2023-04-20 08:56,949885,259593,487720,202572,949885
2023-04-20 08:57,949888,259595,487720,202573,949888
2023-04-20 08:58,949892,259598,487720,202574,949892
2023-04-20 08:59,949895,259597,487722,202576,949895
2023-04-20 09:00,949902,259600,487722,202580,949902
2023-04-20 09:01,949909,259606,487723,202580,949909
2023-04-20 09:02,949917,259611,487723,202583,949917
2023-04-20 09:03,949925,259616,487725,202584,949925
2023-04-20 09:04,949933,259624,487725,202584,949933
2023-04-20 09:05,949941,259632,487725,202584,949941
2023-04-20 09:06,949949,259638,487725,202586,949949
2023-04-20 09:07,949957,259645,487726,202586,949957
2023-04-20 09:08,949965,259652,487726,202587,949965
2023-04-20 09:09,949973,259658,487727,202588,949973
2023-04-20 09:10,949980,259663,487727,202590,949980
2023-04-20 09:11,949990,259672,487727,202591,949990
2023-04-20 09:13,949997,259678,487727,202592,949997
2023-04-20 09:14,950005,259676,487731,202598,950005
2023-04-20 09:15,950013,259682,487732,202599,950013
2023-04-20 09:16,950021,259689,487732,202600,950021
2023-04-20 09:17,950032,259697,487734,202601,950032
2023-04-20 09:18,950040,259700,487739,202601,950040
2023-04-20 09:19,950047,259707,487739,202601,950047
2023-04-20 09:20,950056,259714,487740,202602,950056
2023-04-20 09:21,950063,259721,487740,202602,950063
2023-04-20 09:22,950072,259729,487741,202602,950072
2023-04-20 09:23,950079,259735,487741,202603,950079
2023-04-20 09:24,950087,259742,487741,202604,950087
2023-04-20 09:25,950095,259749,487741,202605,950095
2023-04-20 09:26,950103,259753,487743,202607,950103
2023-04-20 09:27,950112,259759,487743,202610,950112
2023-04-20 09:28,950120,259764,487744,202612,950120
2023-04-20 09:29,950128,259772,487744,202612,950128
2023-04-20 09:30,950137,259780,487744,202613,950137
2023-04-20 09:31,950145,259786,487744,202615,950145
2023-04-20 09:32,950153,259790,487748,202615,950153
2023-04-20 09:33,950162,259797,487748,202617,950162
2023-04-20 09:34,950170,259801,487749,202620,950170
2023-04-20 09:35,950179,259809,487749,202621,950179
2023-04-20 09:36,950186,259812,487751,202623,950186
2023-04-20 09:37,950195,259821,487751,202623,950195
2023-04-20 09:38,950202,259826,487752,202624,950202
2023-04-20 09:39,950211,259834,487752,202625,950211
2023-04-20 09:40,950219,259839,487752,202628,950219
2023-04-20 09:41,950227,259847,487752,202628,950227
2023-04-20 09:42,950235,259853,487752,202630,950235
2023-04-20 09:43,950243,259861,487752,202630,950243
2023-04-20 09:44,950252,259870,487752,202630,950252
2023-04-20 09:45,950259,259877,487752,202630,950259
2023-04-20 09:46,950268,259880,487756,202632,950268
2023-04-20 09:47,950277,259889,487756,202632,950277
2023-04-20 09:48,950284,259893,487758,202633,950284
2023-04-20 09:49,950293,259901,487758,202634,950293
2023-04-20 09:50,950301,259907,487760,202634,950301
2023-04-20 09:51,950309,259912,487760,202637,950309
2023-04-20 09:52,950317,259916,487760,202641,950317
2023-04-20 09:53,950325,259922,487760,202643,950325
2023-04-20 09:54,950334,259929,487760,202645,950334
2023-04-20 09:55,950343,259937,487760,202646,950343
2023-04-20 09:56,950352,259941,487762,202649,950352
2023-04-20 09:57,950359,259946,487762,202651,950359
2023-04-20 09:58,950367,259953,487762,202652,950367
2023-04-20 09:59,950375,259959,487762,202654,950375
2023-04-20 10:01,950388,259968,487763,202657,950388
2023-04-20 10:02,950400,259978,487764,202658,950400
2023-04-20 10:03,950412,259988,487764,202660,950412
2023-04-20 10:04,950425,259998,487765,202662,950425
2023-04-20 10:05,950437,260010,487765,202662,950437
2023-04-20 10:06,950450,260022,487765,202663,950450
2023-04-20 10:07,950461,260031,487765,202665,950461
2023-04-20 10:08,950474,260043,487765,202666,950474
2023-04-20 10:09,950487,260054,487765,202668,950487
2023-04-20 10:10,950499,260064,487765,202670,950499
2023-04-20 10:11,950511,260075,487765,202671,950511
2023-04-20 10:12,950523,260085,487765,202673,950523
2023-04-20 10:13,950536,260094,487765,202677,950536
2023-04-20 10:14,950547,260087,487782,202678,950547
2023-04-20 10:15,950562,260099,487782,202681,950562
2023-04-20 10:16,950573,260110,487782,202681,950573
2023-04-20 10:17,950586,260123,487782,202681,950586
2023-04-20 10:18,950598,260133,487782,202683,950598
2023-04-20 10:19,950610,260142,487782,202686,950610
2023-04-20 10:20,950623,260154,487782,202687,950623
2023-04-20 10:21,950636,260166,487782,202688,950636
2023-04-20 10:22,950649,260177,487782,202690,950649
2023-04-20 10:23,950662,260190,487782,202690,950662
2023-04-20 10:24,950674,260189,487792,202693,950674
2023-04-20 10:25,950686,260201,487792,202693,950686
2023-04-20 10:26,950698,260212,487792,202694,950698
2023-04-20 10:27,950710,260222,487794,202694,950710
2023-04-20 10:28,950723,260233,487794,202696,950723
2023-04-20 10:29,950736,260245,487794,202697,950736
2023-04-20 10:30,950749,260257,487794,202698,950749
2023-04-20 10:31,950761,260265,487797,202699,950761
2023-04-20 10:32,950773,260276,487797,202700,950773
2023-04-20 10:33,950786,260286,487798,202702,950786
2023-04-20 10:34,950798,260297,487798,202703,950798
2023-04-20 10:35,950811,260307,487798,202706,950811
2023-04-20 10:36,950823,260318,487798,202707,950823
2023-04-20 10:37,950837,260326,487803,202708,950837
2023-04-20 10:38,950849,260338,487803,202708,950849
2023-04-20 10:39,950861,260345,487808,202708,950861
2023-04-20 10:40,950875,260357,487808,202710,950875
2023-04-20 10:41,950887,260366,487810,202711,950887
2023-04-20 10:42,950901,260379,487810,202712,950901
2023-04-20 10:43,950914,260387,487813,202714,950914
2023-04-20 10:44,950926,260397,487813,202716,950926
2023-04-20 10:45,950939,260409,487813,202717,950939
2023-04-20 10:46,950951,260421,487813,202717,950951
2023-04-20 10:48,950963,260428,487815,202720,950963
2023-04-20 10:49,950975,260439,487815,202721,950975
2023-04-20 10:50,950988,260446,487818,202724,950988
2023-04-20 10:51,951001,260456,487818,202727,951001
2023-04-20 10:52,951013,260462,487822,202729,951013
2023-04-20 10:53,951025,260472,487822,202731,951025
2023-04-20 10:54,951038,260480,487826,202732,951038
2023-04-20 10:55,951051,260489,487826,202736,951051
2023-04-20 10:56,951063,260498,487828,202737,951063
2023-04-20 10:57,951077,260509,487828,202740,951077
2023-04-20 10:58,951088,260518,487830,202740,951088
2023-04-20 10:59,951101,260527,487830,202744,951101
2023-04-20 11:00,951112,260533,487833,202746,951112
2023-04-20 11:01,951121,260539,487833,202749,951121
2023-04-20 11:02,951130,260540,487840,202750,951130
2023-04-20 11:03,951139,260546,487840,202753,951139
2023-04-20 11:04,951147,260550,487843,202754,951147
2023-04-20 11:05,951156,260557,487843,202756,951156
2023-04-20 11:06,951164,260559,487848,202757,951164
2023-04-20 11:07,951175,260567,487851,202757,951175
2023-04-20 11:08,951183,260575,487851,202757,951183
2023-04-20 11:09,951192,260578,487857,202757,951192
2023-04-20 11:10,951200,260585,487857,202758,951200
2023-04-20 11:11,951209,260588,487859,202762,951209
2023-04-20 11:12,951218,260595,487859,202764,951218
2023-04-20 11:13,951228,260600,487862,202766,951228
2023-04-20 11:14,951236,260606,487862,202768,951236
2023-04-20 11:15,951245,260616,487861,202768,951245
2023-04-20 11:16,951254,260625,487861,202768,951254
2023-04-20 11:17,951262,260626,487866,202770,951262
2023-04-20 11:18,951271,260631,487867,202773,951271
2023-04-20 11:19,951280,260636,487867,202777,951280
2023-04-20 11:20,951290,260645,487866,202779,951290
2023-04-20 11:21,951299,260651,487866,202782,951299
2023-04-20 11:22,951307,260651,487872,202784,951307
2023-04-20 11:23,951316,260654,487874,202788,951316
2023-04-20 11:24,951325,260663,487874,202788,951325
2023-04-20 11:25,951333,260670,487874,202789,951333
2023-04-20 11:26,951343,260678,487874,202791,951343
2023-04-20 11:27,951352,260679,487878,202795,951352
2023-04-20 11:28,951361,260687,487878,202796,951361
2023-04-20 11:29,951370,260692,487880,202798,951370
2023-04-20 11:30,951379,260701,487880,202798,951379
2023-04-20 11:31,951388,260706,487882,202800,951388
2023-04-20 11:32,951398,260715,487882,202801,951398
2023-04-20 11:33,951406,260721,487883,202802,951406
2023-04-20 11:35,951415,260724,487883,202808,951415
2023-04-20 11:36,951423,260726,487889,202808,951423
2023-04-20 11:37,951432,260734,487889,202809,951432
2023-04-20 11:38,951441,260742,487889,202810,951441
2023-04-20 11:39,951450,260749,487891,202810,951450
2023-04-20 11:40,951458,260757,487891,202810,951458
2023-04-20 11:41,951468,260763,487894,202811,951468
2023-04-20 11:42,951478,260771,487894,202813,951478
2023-04-20 11:43,951486,260774,487897,202815,951486
2023-04-20 11:44,951495,260782,487897,202816,951495
2023-04-20 11:45,951504,260785,487904,202815,951504
2023-04-20 11:46,951512,260788,487904,202820,951512
2023-04-20 11:47,951522,260794,487907,202821,951522
2023-04-20 11:48,951531,260803,487907,202821,951531
2023-04-20 11:49,951542,260814,487907,202821,951542
2023-04-20 11:50,951550,260821,487907,202822,951550
2023-04-20 11:51,951560,260825,487910,202825,951560
2023-04-20 11:52,951570,260835,487910,202825,951570
2023-04-20 11:53,951578,260840,487910,202828,951578
2023-04-20 11:54,951587,260841,487916,202830,951587
2023-04-20 11:55,951596,260848,487916,202832,951596
2023-04-20 11:56,951605,260855,487918,202832,951605
2023-04-20 11:57,951614,260863,487918,202833,951614
2023-04-20 11:58,951623,260871,487919,202833,951623
2023-04-20 11:59,951632,260878,487919,202835,951632
2023-04-20 12:00,951638,260879,487922,202837,951638
2023-04-20 12:01,951642,260883,487922,202837,951642
2023-04-20 12:02,951646,260882,487926,202838,951646
2023-04-20 12:03,951650,260883,487926,202841,951650
2023-04-20 12:04,951655,260882,487931,202842,951655
2023-04-20 12:05,951660,260883,487933,202844,951660
2023-04-20 12:06,951664,260886,487933,202845,951664
2023-04-20 12:07,951668,260884,487938,202846,951668
2023-04-20 12:08,951672,260888,487938,202846,951672
2023-04-20 12:09,951676,260884,487945,202847,951676
2023-04-20 12:10,951680,260887,487945,202848,951680
2023-04-20 12:11,951685,260890,487945,202850,951685
2023-04-20 12:12,951689,260894,487945,202850,951689
2023-04-20 12:13,951693,260889,487952,202852,951693
2023-04-20 12:14,951697,260889,487952,202856,951697
2023-04-20 12:15,951702,260888,487958,202856,951702
2023-04-20 12:16,951705,260890,487958,202857,951705
2023-04-20 12:17,951709,260886,487966,202857,951709
2023-04-20 12:18,951715,260892,487966,202857,951715
2023-04-20 12:19,951719,260884,487975,202860,951719
2023-04-20 12:20,951724,260887,487975,202862,951724
2023-04-20 12:21,951729,260889,487977,202863,951729
2023-04-20 12:23,951734,260894,487977,202863,951734
2023-04-20 12:24,951738,260894,487980,202864,951738
2023-04-20 12:25,951742,260897,487980,202865,951742
2023-04-20 12:26,951746,260895,487984,202867,951746
2023-04-20 12:27,951750,260898,487984,202868,951750
2023-04-20 12:28,951754,260895,487988,202871,951754
2023-04-20 12:29,951758,260893,487989,202876,951758
2023-04-20 12:30,951763,260894,487989,202880,951763
2023-04-20 12:31,951768,260889,487997,202882,951768
2023-04-20 12:32,951772,260891,487997,202884,951772
2023-04-20 12:33,951777,260885,488006,202886,951777
2023-04-20 12:34,951782,260890,488006,202886,951782
2023-04-20 12:35,951786,260885,488011,202890,951786
2023-04-20 12:36,951792,260890,488011,202891,951792
2023-04-20 12:37,951797,260892,488012,202893,951797
2023-04-20 12:38,951801,260896,488012,202893,951801
2023-04-20 12:39,951805,260896,488013,202896,951805
2023-04-20 12:40,951810,260901,488013,202896,951810
2023-04-20 12:41,951814,260897,488016,202901,951814
2023-04-20 12:42,951818,260900,488016,202902,951818
2023-04-20 12:43,951823,260900,488019,202904,951823
2023-04-20 12:44,951827,260903,488019,202905,951827
2023-04-20 12:45,951831,260899,488024,202908,951831
2023-04-20 12:46,951836,260901,488024,202911,951836
2023-04-20 12:47,951840,260900,488026,202914,951840
2023-04-20 12:48,951844,260901,488026,202917,951844
2023-04-20 12:49,951848,260899,488030,202919,951848
2023-04-20 12:50,951852,260900,488030,202922,951852
2023-04-20 12:51,951857,260899,488034,202924,951857
2023-04-20 12:52,951861,260903,488034,202924,951861
2023-04-20 12:53,951867,260905,488037,202925,951867
2023-04-20 12:54,951871,260907,488037,202927,951871
2023-04-20 12:55,951875,260902,488045,202928,951875
2023-04-20 12:56,951879,260904,488047,202928,951879
2023-04-20 12:57,951883,260896,488053,202934,951883
2023-04-20 12:58,951887,260896,488056,202935,951887
2023-04-20 12:59,951891,260900,488056,202935,951891
2023-04-20 13:00,951902,260906,488059,202937,951902
2023-04-20 13:01,951916,260919,488059,202938,951916
2023-04-20 13:02,951930,260927,488062,202941,951930
2023-04-20 13:03,951943,260939,488062,202942,951943
2023-04-20 13:04,951957,260948,488067,202942,951957
2023-04-20 13:05,951970,260959,488067,202944,951970
2023-04-20 13:06,951983,260967,488071,202945,951983
2023-04-20 13:07,951996,260979,488071,202946,951996
2023-04-20 13:08,952009,260983,488078,202948,952009
2023-04-20 13:10,952023,260995,488078,202950,952023
2023-04-20 13:11,952036,261000,488083,202953,952036
2023-04-20 13:12,952050,261013,488083,202954,952050
2023-04-20 13:13,952064,261021,488088,202955,952064
2023-04-20 13:14,952078,261033,488088,202957,952078
2023-04-20 13:15,952090,261037,488093,202960,952090
2023-04-20 13:16,952104,261051,488093,202960,952104
2023-04-20 13:17,952118,261058,488098,202962,952118
2023-04-20 13:18,952130,261067,488098,202965,952130
2023-04-20 13:19,952144,261076,488101,202967,952144
2023-04-20 13:20,952156,261088,488101,202967,952156
2023-04-20 13:21,952170,261098,488104,202968,952170
2023-04-20 13:22,952184,261109,488104,202971,952184
2023-04-20 13:23,952197,261117,488108,202972,952197
2023-04-20 13:24,952210,261129,488108,202973,952210
2023-04-20 13:25,952224,261134,488116,202974,952224
2023-04-20 13:26,952237,261146,488116,202975,952237
2023-04-20 13:27,952250,261152,488120,202978,952250
2023-04-20 13:28,952263,261163,488120,202980,952263
2023-04-20 13:29,952276,261167,488125,202984,952276
2023-04-20 13:30,952289,261177,488125,202987,952289
2023-04-20 13:31,952302,261180,488132,202990,952302
2023-04-20 13:32,952315,261192,488132,202991,952315
2023-04-20 13:33,952328,261200,488135,202993,952328
2023-04-20 13:34,952341,261213,488135,202993,952341
2023-04-20 13:35,952355,261224,488136,202995,952355
2023-04-20 13:36,952368,261236,488136,202996,952368
2023-04-20 13:37,952382,261242,488141,202999,952382
2023-04-20 13:38,952396,261252,488146,202998,952396
2023-04-20 13:39,952409,261263,488146,203000,952409
2023-04-20 13:40,952422,261273,488148,203001,952422
2023-04-20 13:41,952435,261286,488148,203001,952435
2023-04-20 13:42,952448,261293,488151,203004,952448
2023-04-20 13:43,952462,261306,488151,203005,952462
2023-04-20 13:44,952475,261314,488154,203007,952475
2023-04-20 13:45,952488,261326,488154,203008,952488
2023-04-20 13:46,952501,261333,488157,203011,952501
2023-04-20 13:47,952514,261344,488157,203013,952514
2023-04-20 13:48,952528,261351,488162,203015,952528
2023-04-20 13:49,952541,261363,488162,203016,952541
2023-04-20 13:50,952554,261375,488163,203016,952554
2023-04-20 13:51,952567,261387,488163,203017,952567
2023-04-20 13:52,952579,261394,488165,203020,952579
2023-04-20 13:53,952593,261407,488165,203021,952593
2023-04-20 13:54,952607,261417,488169,203021,952607
2023-04-20 13:56,952620,261429,488169,203022,952620
2023-04-20 13:57,952633,261440,488170,203023,952633
2023-04-20 13:58,952646,261452,488170,203024,952646
2023-04-20 13:59,952659,261461,488174,203024,952659
2023-04-20 14:00,952672,261473,488174,203025,952672
2023-04-20 14:01,952677,261476,488175,203026,952677
2023-04-20 14:02,952683,261481,488175,203027,952683
2023-04-20 14:03,952689,261485,488176,203028,952689
2023-04-20 14:04,952695,261489,488176,203030,952695
2023-04-20 14:05,952700,261491,488178,203031,952700
2023-04-20 14:06,952707,261497,488178,203032,952707
2023-04-20 14:07,952713,261501,488179,203033,952713
2023-04-20 14:08,952718,261506,488179,203033,952718
2023-04-20 14:09,952724,261507,488180,203037,952724
2023-04-20 14:10,952730,261511,488180,203039,952730
2023-04-20 14:11,952735,261513,488182,203040,952735
2023-04-20 14:12,952741,261519,488182,203040,952741
2023-04-20 14:13,952748,261526,488182,203040,952748
2023-04-20 14:14,952754,261532,488182,203040,952754
2023-04-20 14:15,952759,261533,488186,203040,952759
2023-04-20 14:16,952765,261538,488186,203041,952765
2023-04-20 14:17,952772,261540,488189,203043,952772
2023-04-20 14:18,952778,261545,488189,203044,952778
2023-04-20 14:19,952783,261540,488196,203047,952783
2023-04-20 14:20,952789,261545,488196,203048,952789
2023-04-20 14:21,952795,261549,488197,203049,952795
2023-04-20 14:22,952801,261552,488197,203052,952801
2023-04-20 14:23,952806,261553,488201,203052,952806
2023-04-20 14:24,952814,261560,488201,203053,952814
2023-04-20 14:25,952820,261561,488204,203055,952820
2023-04-20 14:26,952825,261566,488204,203055,952825
2023-04-20 14:27,952833,261571,488207,203055,952833
2023-04-20 14:28,952840,261578,488207,203055,952840
2023-04-20 14:29,952846,261580,488210,203056,952846
2023-04-20 14:30,952851,261585,488210,203056,952851
2023-04-20 14:31,952857,261585,488213,203059,952857
2023-04-20 14:32,952863,261590,488213,203060,952863
2023-04-20 14:33,952868,261592,488215,203061,952868
2023-04-20 14:34,952874,261596,488216,203062,952874
2023-04-20 14:35,952880,261602,488216,203062,952880
2023-04-20 14:36,952886,261604,488219,203063,952886
2023-04-20 14:37,952891,261607,488219,203065,952891
2023-04-20 14:38,952897,261608,488223,203066,952897
2023-04-20 14:39,952903,261612,488223,203068,952903
2023-04-20 14:40,952909,261614,488227,203068,952909
2023-04-20 14:41,952914,261617,488227,203070,952914
2023-04-20 14:42,952920,261617,488233,203070,952920
2023-04-20 14:44,952926,261621,488233,203072,952926
2023-04-20 14:45,952931,261626,488233,203072,952931
2023-04-20 14:46,952937,261630,488233,203074,952937
2023-04-20 14:47,952944,261634,488235,203075,952944
2023-04-20 14:48,952950,261639,488235,203076,952950
2023-04-20 14:49,952955,261642,488236,203077,952955
2023-04-20 14:50,952961,261648,488236,203077,952961
2023-04-20 14:51,952967,261653,488237,203077,952967
2023-04-20 14:52,952972,261656,488237,203079,952972
2023-04-20 14:53,952978,261660,488239,203079,952978
2023-04-20 14:54,952985,261665,488241,203079,952985
2023-04-20 14:55,952991,261667,488244,203080,952991
2023-04-20 14:56,952997,261673,488244,203080,952997
2023-04-20 14:57,953003,261673,488247,203083,953003
2023-04-20 14:58,953009,261676,488247,203086,953009
2023-04-20 14:59,953015,261680,488248,203087,953015
2023-04-20 15:00,953023,261689,488248,203086,953023
2023-04-20 15:01,953035,261692,488256,203087,953035
2023-04-20 15:02,953048,261704,488256,203088,953048
2023-04-20 15:03,953060,261714,488258,203088,953060
2023-04-20 15:04,953073,261720,488262,203091,953073
2023-04-20 15:05,953085,261730,488264,203091,953085
2023-04-20 15:06,953098,261740,488266,203092,953098
2023-04-20 15:07,953111,261753,488266,203092,953111
2023-04-20 15:08,953125,261765,488267,203093,953125
2023-04-20 15:09,953138,261777,488267,203094,953138
2023-04-20 15:10,953150,261782,488274,203094,953150
2023-04-20 15:11,953163,261793,488274,203096,953163
2023-04-20 15:12,953177,261803,488274,203100,953177
2023-04-20 15:13,953190,261815,488274,203101,953190
2023-04-20 15:14,953203,261827,488276,203100,953203
2023-04-20 15:15,953217,261840,488276,203101,953217
2023-04-20 15:16,953229,261847,488281,203101,953229
2023-04-20 15:17,953242,261855,488283,203104,953242
2023-04-20 15:18,953255,261864,488286,203105,953255
2023-04-20 15:19,953268,261874,488286,203108,953268
2023-04-20 15:20,953280,261881,488290,203109,953280
2023-04-20 15:21,953292,261892,488290,203110,953292
2023-04-20 15:22,953305,261900,488294,203111,953305
2023-04-20 15:23,953319,261913,488294,203112,953319
2023-04-20 15:24,953333,261922,488298,203113,953333
2023-04-20 15:25,953345,261933,488298,203114,953345
2023-04-20 15:26,953357,261942,488301,203114,953357
2023-04-20 15:27,953370,261954,488301,203115,953370
2023-04-20 15:28,953383,261964,488303,203116,953383
2023-04-20 15:30,953396,261975,488303,203118,953396
2023-04-20 15:31,953409,261980,488307,203122,953409
2023-04-20 15:32,953422,261992,488307,203123,953422
2023-04-20 15:33,953434,262003,488308,203123,953434
2023-04-20 15:34,953447,262016,488308,203123,953447
2023-04-20 15:35,953459,262025,488310,203124,953459
2023-04-20 15:36,953472,262037,488310,203125,953472
2023-04-20 15:37,953486,262050,488311,203125,953486
2023-04-20 15:38,953498,262062,488311,203125,953498
2023-04-20 15:39,953512,262071,488314,203127,953512
2023-04-20 15:40,953524,262080,488314,203130,953524
2023-04-20 15:41,953539,262090,488319,203130,953539
2023-04-20 15:42,953553,262104,488319,203130,953553
2023-04-20 15:43,953565,262115,488320,203130,953565
2023-04-20 15:44,953578,262126,488320,203132,953578
2023-04-20 15:45,953590,262133,488323,203134,953590
2023-04-20 15:46,953603,262145,488323,203135,953603
2023-04-20 15:47,953615,262156,488323,203136,953615
2023-04-20 15:48,953628,262168,488323,203137,953628
2023-04-20 15:49,953641,262171,488333,203137,953641
2023-04-20 15:50,953654,262184,488333,203137,953654
2023-04-20 15:51,953667,262194,488336,203137,953667
2023-04-20 15:52,953681,262208,488336,203137,953681
2023-04-20 15:53,953693,262215,488339,203139,953693
2023-04-20 15:54,953707,262229,488339,203139,953707
2023-04-20 15:55,953720,262235,488345,203140,953720
2023-04-20 15:56,953732,262246,488345,203141,953732
2023-04-20 15:57,953745,262254,488350,203141,953745
2023-04-20 15:58,953758,262265,488350,203143,953758
2023-04-20 15:59,953770,262272,488353,203145,953770
2023-04-20 16:00,953782,262282,488353,203147,953782
2023-04-20 16:01,953792,262286,488356,203150,953792
2023-04-20 16:02,953803,262296,488356,203151,953803
2023-04-20 16:03,953814,262299,488360,203155,953814
2023-04-20 16:04,953825,262307,488360,203158,953825
2023-04-20 16:05,953837,262314,488362,203161,953837
2023-04-20 16:06,953847,262323,488362,203162,953847
2023-04-20 16:07,953858,262329,488365,203164,953858
2023-04-20 16:08,953868,262334,488365,203169,953868
2023-04-20 16:09,953878,262338,488369,203171,953878
2023-04-20 16:10,953889,262349,488369,203171,953889
2023-04-20 16:11,953899,262354,488372,203173,953899
2023-04-20 16:12,953910,262364,488372,203174,953910
2023-04-20 16:13,953920,262371,488374,203175,953920
2023-04-20 16:14,953930,262379,488374,203177,953930
2023-04-20 16:15,953941,262387,488377,203177,953941
2023-04-20 16:17,953951,262395,488378,203178,953951
2023-04-20 16:18,953963,262406,488378,203179,953963
2023-04-20 16:19,953974,262414,488380,203180,953974
2023-04-20 16:20,953984,262424,488380,203180,953984
2023-04-20 16:21,953996,262431,488384,203181,953996
2023-04-20 16:22,954006,262441,488384,203181,954006
2023-04-20 16:23,954016,262444,488387,203185,954016
2023-04-20 16:24,954027,262453,488387,203187,954027
2023-04-20 16:25,954038,262461,488388,203189,954038
2023-04-20 16:26,954048,262470,488388,203190,954048
2023-04-20 16:27,954059,262480,488389,203190,954059
2023-04-20 16:28,954069,262489,488390,203190,954069
2023-04-20 16:29,954081,262501,488390,203190,954081
2023-04-20 16:30,954093,262509,488394,203190,954093
2023-04-20 16:31,954105,262520,488394,203191,954105
2023-04-20 16:32,954115,262527,488396,203192,954115
2023-04-20 16:33,954126,262536,488396,203194,954126
2023-04-20 16:34,954136,262543,488398,203195,954136
2023-04-20 16:35,954148,262554,488398,203196,954148
2023-04-20 16:36,954158,262562,488399,203197,954158
2023-04-20 16:37,954169,262572,488399,203198,954169
2023-04-20 16:38,954180,262582,488400,203198,954180
2023-04-20 16:39,954190,262591,488400,203199,954190
2023-04-20 16:40,954200,262596,488404,203200,954200
2023-04-20 16:41,954211,262607,488404,203200,954211
2023-04-20 16:42,954221,262614,488406,203201,954221
2023-04-20 16:43,954232,262625,488406,203201,954232
2023-04-20 16:44,954242,262628,488411,203203,954242
2023-04-20 16:45,954253,262638,488411,203204,954253
2023-04-20 16:46,954263,262642,488416,203205,954263
2023-04-20 16:47,954273,262651,488416,203206,954273
2023-04-20 16:48,954283,262655,488420,203208,954283
2023-04-20 16:49,954294,262665,488420,203209,954294
2023-04-20 16:50,954304,262674,488421,203209,954304
2023-04-20 16:51,954316,262685,488421,203210,954316
2023-04-20 16:52,954327,262686,488427,203214,954327
2023-04-20 16:53,954338,262694,488427,203217,954338
2023-04-20 16:54,954348,262699,488431,203218,954348
2023-04-20 16:55,954359,262707,488432,203220,954359
2023-04-20 16:56,954369,262715,488432,203222,954369
2023-04-20 16:57,954379,262721,488434,203224,954379
2023-04-20 16:58,954390,262731,488434,203225,954390
2023-04-20 16:59,954400,262740,488436,203224,954400
2023-04-20 17:00,954410,262747,488436,203227,954410
2023-04-20 17:01,954419,262751,488441,203227,954419
2023-04-20 17:02,954429,262761,488441,203227,954429
2023-04-20 17:03,954439,262765,488443,203231,954439
2023-04-20 17:05,954448,262770,488443,203235,954448
2023-04-20 17:06,954459,262776,488448,203235,954459
2023-04-20 17:07,954470,262786,488448,203236,954470
2023-04-20 17:08,954479,262792,488450,203237,954479
2023-04-20 17:09,954489,262800,488450,203239,954489
2023-04-20 17:10,954498,262803,488456,203239,954498
2023-04-20 17:11,954508,262811,488456,203241,954508
2023-04-20 17:12,954517,262818,488457,203242,954517
2023-04-20 17:13,954527,262826,488457,203244,954527
2023-04-20 17:14,954537,262835,488457,203245,954537
2023-04-20 17:15,954546,262844,488457,203245,954546
2023-04-20 17:16,954556,262849,488460,203247,954556
2023-04-20 17:17,954565,262854,488460,203251,954565
2023-04-20 17:18,954575,262861,488460,203254,954575
2023-04-20 17:19,954584,262869,488460,203255,954584
2023-04-20 17:20,954594,262874,488463,203257,954594
2023-04-20 17:21,954605,262883,488463,203259,954605
2023-04-20 17:22,954614,262884,488468,203262,954614
2023-04-20 17:23,954624,262894,488468,203262,954624
2023-04-20 17:24,954634,262900,488470,203264,954634
2023-04-20 17:25,954643,262905,488472,203266,954643
2023-04-20 17:26,954653,262914,488472,203267,954653
2023-04-20 17:27,954663,262920,488475,203268,954663
2023-04-20 17:28,954672,262928,488475,203269,954672
2023-04-20 17:29,954681,262930,488479,203272,954681
2023-04-20 17:30,954691,262940,488479,203272,954691
2023-04-20 17:31,954701,262945,488482,203274,954701
2023-04-20 17:32,954710,262952,488483,203275,954710
2023-04-20 17:33,954720,262961,488483,203276,954720
2023-04-20 17:34,954730,262966,488486,203278,954730
2023-04-20 17:35,954741,262977,488486,203278,954741
2023-04-20 17:36,954750,262979,488491,203280,954750
2023-04-20 17:37,954760,262987,488491,203282,954760
2023-04-20 17:38,954770,262992,488494,203284,954770
2023-04-20 17:39,954780,262999,488494,203287,954780
2023-04-20 17:40,954790,263001,488497,203292,954790
2023-04-20 17:41,954799,263007,488497,203295,954799
2023-04-20 17:42,954810,263011,488503,203296,954810
2023-04-20 17:43,954819,263015,488505,203299,954819
2023-04-20 17:44,954829,263024,488505,203300,954829
2023-04-20 17:45,954838,263025,488512,203301,954838
2023-04-20 17:46,954848,263033,488512,203303,954848
2023-04-20 17:47,954857,263035,488517,203305,954857
2023-04-20 17:48,954867,263043,488518,203306,954867
2023-04-20 17:49,954876,263051,488518,203307,954876
2023-04-20 17:50,954886,263058,488521,203307,954886
2023-04-20 17:52,954897,263066,488521,203310,954897
2023-04-20 17:53,954906,263069,488525,203312,954906
2023-04-20 17:54,954916,263079,488525,203312,954916
2023-04-20 17:55,954926,263086,488527,203313,954926
2023-04-20 17:56,954936,263093,488527,203316,954936
2023-04-20 17:57,954945,263094,488533,203318,954945
2023-04-20 17:58,954954,263100,488533,203321,954954
2023-04-20 17:59,954964,263107,488536,203321,954964
2023-04-20 18:00,954976,263116,488538,203322,954976
2023-04-20 18:01,954990,263128,488538,203324,954990
2023-04-20 18:02,955004,263137,488542,203325,955004
2023-04-20 18:03,955018,263149,488542,203327,955018
2023-04-20 18:04,955032,263159,488545,203328,955032
2023-04-20 18:05,955045,263167,488545,203333,955045
2023-04-20 18:06,955059,263176,488545,203338,955059
2023-04-20 18:07,955073,263190,488545,203338,955073
2023-04-20 18:08,955087,263197,488548,203342,955087
2023-04-20 18:09,955101,263210,488548,203343,955101
2023-04-20 18:10,955114,263217,488553,203344,955114
2023-04-20 18:11,955128,263228,488553,203347,955128
2023-04-20 18:12,955142,263236,488556,203350,955142
2023-04-20 18:13,955157,263249,488556,203352,955157
2023-04-20 18:14,955170,263254,488562,203354,955170
2023-04-20 18:15,955186,263267,488562,203357,955186
2023-04-20 18:16,955200,263275,488567,203358,955200
2023-04-20 18:17,955213,263285,488567,203361,955213
2023-04-20 18:18,955227,263293,488573,203361,955227
2023-04-20 18:19,955241,263306,488573,203362,955241
2023-04-20 18:20,955255,263312,488578,203365,955255
2023-04-20 18:21,955269,263325,488578,203366,955269
2023-04-20 18:22,955283,263333,488582,203368,955283
2023-04-20 18:23,955297,263346,488582,203369,955297
2023-04-20 18:24,955312,263352,488589,203371,955312
2023-04-20 18:25,955328,263368,488589,203371,955328
2023-04-20 18:26,955341,263377,488592,203372,955341
2023-04-20 18:27,955355,263387,488593,203375,955355
2023-04-20 18:28,955370,263402,488593,203375,955370
2023-04-20 18:29,955384,263407,488602,203375,955384
2023-04-20 18:30,955397,263419,488602,203376,955397
2023-04-20 18:31,955411,263425,488609,203377,955411
2023-04-20 18:32,955426,263439,488609,203378,955426
2023-04-20 18:33,955440,263449,488611,203380,955440
2023-04-20 18:34,955453,263462,488611,203380,955453
2023-04-20 18:35,955467,263470,488615,203382,955467
2023-04-20 18:36,955482,263483,488615,203384,955482
2023-04-20 18:37,955495,263490,488619,203386,955495
2023-04-20 18:39,955509,263498,488623,203388,955509
2023-04-20 18:40,955524,263513,488623,203388,955524
2023-04-20 18:41,955538,263518,488628,203392,955538
2023-04-20 18:42,955551,263531,488628,203392,955551
2023-04-20 18:43,955565,263541,488632,203392,955565
2023-04-20 18:44,955579,263555,488632,203392,955579
2023-04-20 18:45,955593,263564,488636,203393,955593
2023-04-20 18:46,955606,263575,488636,203395,955606
2023-04-20 18:47,955620,263583,488641,203396,955620
2023-04-20 18:48,955635,263596,488641,203398,955635
2023-04-20 18:49,955650,263605,488645,203400,955650
2023-04-20 18:50,955665,263620,488645,203400,955665
2023-04-20 18:51,955679,263626,488651,203402,955679
2023-04-20 18:52,955693,263637,488651,203405,955693
2023-04-20 18:53,955706,263644,488654,203408,955706
2023-04-20 18:54,955720,263658,488654,203408,955720
2023-04-20 18:55,955734,263663,488660,203411,955734
2023-04-20 18:56,955748,263675,488660,203413,955748
2023-04-20 18:57,955761,263680,488666,203415,955761
2023-04-20 18:58,955776,263694,488666,203416,955776
2023-04-20 18:59,955791,263705,488668,203418,955791
2023-04-20 19:00,955805,263719,488668,203418,955805
2023-04-20 19:01,955815,263727,488670,203418,955815
2023-04-20 19:02,955825,263735,488670,203420,955825
2023-04-20 19:03,955835,263743,488671,203421,955835
2023-04-20 19:04,955846,263751,488671,203424,955846
2023-04-20 19:05,955857,263762,488671,203424,955857
2023-04-20 19:06,955866,263770,488671,203425,955866
2023-04-20 19:07,955877,263774,488678,203425,955877
2023-04-20 19:08,955887,263781,488678,203428,955887
2023-04-20 19:09,955899,263787,488681,203431,955899
2023-04-20 19:10,955909,263791,488683,203435,955909
2023-04-20 19:11,955919,263800,488683,203436,955919
2023-04-20 19:12,955930,263803,488691,203436,955930
2023-04-20 19:13,955940,263813,488691,203436,955940
2023-04-20 19:14,955951,263815,488697,203439,955951
2023-04-20 19:15,955961,263825,488697,203439,955961
2023-04-20 19:16,955973,263834,488700,203439,955973
2023-04-20 19:17,955986,263845,488700,203441,955986
2023-04-20 19:18,955996,263852,488701,203443,955996
2023-04-20 19:19,956006,263861,488701,203444,956006
2023-04-20 19:20,956017,263866,488705,203446,956017
2023-04-20 19:21,956027,263873,488705,203449,956027
2023-04-20 19:22,956037,263878,488709,203450,956037
2023-04-20 19:23,956048,263887,488709,203452,956048
2023-04-20 19:24,956058,263896,488709,203453,956058
2023-04-20 19:26,956070,263904,488709,203457,956070
2023-04-20 19:27,956080,263898,488723,203459,956080
2023-04-20 19:28,956092,263906,488723,203463,956092
2023-04-20 19:29,956103,263915,488725,203463,956103
2023-04-20 19:30,956113,263922,488725,203466,956113
2023-04-20 19:31,956124,263926,488729,203469,956124
2023-04-20 19:32,956134,263931,488733,203470,956134
2023-04-20 19:33,956144,263939,488733,203472,956144
2023-04-20 19:34,956155,263947,488735,203473,956155
2023-04-20 19:35,956166,263957,488735,203474,956166
2023-04-20 19:36,956176,263961,488740,203475,956176
2023-04-20 19:37,956187,263966,488740,203481,956187
2023-04-20 19:38,956197,263974,488740,203483,956197
2023-04-20 19:39,956209,263983,488740,203486,956209
2023-04-20 19:40,956219,263986,488747,203486,956219
2023-04-20 19:41,956229,263989,488751,203489,956229
2023-04-20 19:42,956239,263998,488751,203490,956239
2023-04-20 19:43,956250,264004,488753,203493,956250
2023-04-20 19:44,956260,264011,488753,203496,956260
2023-04-20 19:45,956270,264020,488754,203496,956270
2023-04-20 19:46,956281,264029,488754,203498,956281
2023-04-20 19:47,956294,264039,488756,203499,956294
2023-04-20 19:48,956304,264044,488758,203502,956304
2023-04-20 19:49,956315,264053,488758,203504,956315
2023-04-20 19:50,956325,264052,488763,203510,956325
2023-04-20 19:51,956335,264061,488763,203511,956335
2023-04-20 19:52,956346,264068,488766,203512,956346
2023-04-20 19:53,956356,264076,488766,203514,956356
2023-04-20 19:54,956367,264080,488770,203517,956367
2023-04-20 19:55,956378,264087,488770,203521,956378
2023-04-20 19:56,956388,264092,488775,203521,956388
2023-04-20 19:57,956399,264098,488777,203524,956399
2023-04-20 19:58,956410,264109,488777,203524,956410
2023-04-20 19:59,956420,264108,488784,203528,956420
2023-04-20 20:00,956429,264116,488784,203529,956429
2023-04-20 20:01,956438,264119,488789,203530,956438
2023-04-20 20:02,956447,264123,488789,203535,956447
2023-04-20 20:03,956457,264125,488795,203537,956457
2023-04-20 20:04,956466,264132,488796,203538,956466
2023-04-20 20:05,956475,264139,488796,203540,956475
2023-04-20 20:06,956484,264141,488801,203542,956484
2023-04-20 20:07,956493,264147,488801,203545,956493
2023-04-20 20:08,956502,264151,488803,203548,956502
2023-04-20 20:09,956511,264158,488803,203550,956511
2023-04-20 20:10,956520,264162,488808,203550,956520
2023-04-20 20:11,956529,264170,488808,203551,956529
2023-04-20 20:12,956538,264175,488811,203552,956538
2023-04-20 20:14,956547,264183,488811,203553,956547
2023-04-20 20:15,956556,264185,488816,203555,956556
2023-04-20 20:16,956565,264193,488816,203556,956565
2023-04-20 20:17,956575,264198,488819,203558,956575
2023-04-20 20:18,956584,264204,488819,203561,956584
2023-04-20 20:19,956592,264203,488826,203563,956592
2023-04-20 20:20,956602,264210,488826,203566,956602
2023-04-20 20:21,956611,264213,488829,203569,956611
2023-04-20 20:22,956620,264221,488829,203570,956620
2023-04-20 20:23,956628,264226,488832,203570,956628
2023-04-20 20:24,956637,264231,488832,203574,956637
2023-04-20 20:25,956647,264238,488835,203574,956647
2023-04-20 20:26,956656,264247,488835,203574,956656
2023-04-20 20:27,956665,264252,488837,203576,956665
2023-04-20 20:28,956673,264258,488837,203578,956673
2023-04-20 20:29,956682,264264,488840,203578,956682
2023-04-20 20:30,956692,264273,488840,203579,956692
2023-04-20 20:31,956701,264278,488842,203581,956701
2023-04-20 20:32,956709,264283,488842,203584,956709
2023-04-20 20:33,956718,264282,488849,203587,956718
2023-04-20 20:34,956727,264287,488852,203588,956727
2023-04-20 20:35,956736,264296,488852,203588,956736
2023-04-20 20:36,956746,264298,488858,203590,956746
2023-04-20 20:37,956756,264305,488858,203593,956756
2023-04-20 20:38,956765,264308,488860,203597,956765
2023-04-20 20:39,956774,264315,488860,203599,956774
2023-04-20 20:40,956783,264318,488862,203603,956783
2023-04-20 20:41,956794,264327,488862,203605,956794
2023-04-20 20:42,956803,264330,488866,203607,956803
2023-04-20 20:43,956811,264337,488866,203608,956811
2023-04-20 20:44,956820,264341,488869,203610,956820
2023-04-20 20:45,956829,264346,488869,203614,956829
2023-04-20 20:46,956841,264354,488873,203614,956841
2023-04-20 20:47,956851,264363,488873,203615,956851
2023-04-20 20:48,956860,264368,488876,203616,956860
2023-04-20 20:49,956870,264369,488880,203621,956870
2023-04-20 20:50,956879,264374,488880,203625,956879
2023-04-20 20:51,956888,264371,488890,203627,956888
2023-04-20 20:52,956897,264379,488890,203628,956897
2023-04-20 20:53,956906,264387,488890,203629,956906
2023-04-20 20:54,956915,264393,488890,203632,956915
2023-04-20 20:55,956925,264397,488894,203634,956925
2023-04-20 20:56,956934,264406,488894,203634,956934
2023-04-20 20:57,956943,264411,488897,203635,956943
2023-04-20 20:58,956952,264417,488897,203638,956952
2023-04-20 20:59,956961,264419,488902,203640,956961
2023-04-20 21:01,956968,264425,488902,203641,956968
2023-04-20 21:02,956974,264416,488911,203647,956974
2023-04-20 21:03,956981,264420,488911,203650,956981
2023-04-20 21:04,956988,264418,488915,203655,956988
2023-04-20 21:05,956995,264425,488915,203655,956995
2023-04-20 21:06,957002,264428,488919,203655,957002
2023-04-20 21:07,957008,264432,488919,203657,957008
2023-04-20 21:08,957015,264432,488925,203658,957015
2023-04-20 21:09,957022,264435,488925,203662,957022
2023-04-20 21:10,957029,264435,488932,203662,957029
2023-04-20 21:11,957036,264441,488932,203663,957036
2023-04-20 21:12,957043,264437,488938,203668,957043
2023-04-20 21:13,957049,264441,488938,203670,957049
2023-04-20 21:14,957056,264443,488943,203670,957056
2023-04-20 21:15,957063,264448,488943,203672,957063
2023-04-20 21:16,957069,264446,488948,203675,957069
2023-04-20 21:17,957076,264449,488951,203676,957076
2023-04-20 21:18,957083,264455,488951,203677,957083
2023-04-20 21:19,957090,264458,488954,203678,957090
2023-04-20 21:20,957096,264463,488954,203679,957096
2023-04-20 21:21,957103,264467,488957,203679,957103
2023-04-20 21:22,957110,264471,488957,203682,957110
2023-04-20 21:23,957117,264471,488964,203682,957117
2023-04-20 21:24,957124,264475,488964,203685,957124
2023-04-20 21:25,957130,264475,488970,203685,957130
2023-04-20 21:26,957137,264479,488970,203688,957137
2023-04-20 21:27,957144,264481,488970,203693,957144
2023-04-20 21:28,957152,264490,488970,203692,957152
2023-04-20 21:29,957159,264487,488977,203695,957159
2023-04-20 21:30,957167,264489,488981,203697,957167
2023-04-20 21:31,957173,264492,488981,203700,957173
2023-04-20 21:32,957180,264492,488987,203701,957180
2023-04-20 21:33,957187,264499,488987,203701,957187
2023-04-20 21:34,957194,264500,488992,203702,957194
2023-04-20 21:35,957200,264503,488992,203705,957200
2023-04-20 21:36,957207,264502,488995,203710,957207
2023-04-20 21:37,957214,264508,488995,203711,957214
2023-04-20 21:38,957221,264512,488998,203711,957221
2023-04-20 21:39,957227,264517,488998,203712,957227
2023-04-20 21:40,957234,264515,489006,203713,957234
2023-04-20 21:41,957241,264522,489006,203713,957241
2023-04-20 21:42,957248,264522,489010,203716,957248
2023-04-20 21:43,957256,264528,489010,203718,957256
2023-04-20 21:44,957262,264527,489014,203721,957262
2023-04-20 21:45,957269,264532,489014,203723,957269
2023-04-20 21:46,957276,264532,489020,203724,957276
2023-04-20 21:48,957282,264536,489020,203726,957282
2023-04-20 21:49,957290,264535,489027,203728,957290
2023-04-20 21:50,957297,264539,489027,203731,957297
2023-04-20 21:51,957307,264543,489031,203733,957307
2023-04-20 21:52,957314,264550,489031,203733,957314
2023-04-20 21:53,957321,264549,489035,203737,957321
2023-04-20 21:54,957327,264552,489035,203740,957327
2023-04-20 21:55,957334,264552,489040,203742,957334
2023-04-20 21:56,957341,264556,489040,203745,957341
2023-04-20 21:57,957348,264555,489045,203748,957348
2023-04-20 21:58,957354,264558,489045,203751,957354
2023-04-20 21:59,957361,264561,489049,203751,957361
2023-04-20 22:00,957367,264566,489049,203752,957367
2023-04-20 22:01,957372,264563,489055,203754,957372
2023-04-20 22:02,957376,264566,489055,203755,957376
2023-04-20 22:03,957382,264565,489061,203756,957382
2023-04-20 22:04,957386,264568,489061,203757,957386
2023-04-20 22:05,957391,264566,489066,203759,957391
2023-04-20 22:06,957395,264571,489066,203758,957395
2023-04-20 22:07,957399,264568,489072,203759,957399
2023-04-20 22:08,957404,264569,489072,203763,957404
2023-04-20 22:09,957409,264567,489077,203765,957409
2023-04-20 22:10,957413,264569,489077,203767,957413
2023-04-20 22:11,957417,264568,489080,203769,957417
2023-04-20 22:12,957422,264569,489080,203773,957422
2023-04-20 22:13,957426,264567,489083,203776,957426
2023-04-20 22:14,957431,264569,489083,203779,957431
2023-04-20 22:15,957435,264566,489089,203780,957435
2023-04-20 22:16,957440,264568,489089,203783,957440
2023-04-20 22:17,957444,264563,489093,203788,957444
2023-04-20 22:18,957449,264565,489093,203791,957449
2023-04-20 22:19,957453,264559,489101,203793,957453
2023-04-20 22:20,957457,264562,489101,203794,957457
2023-04-20 22:21,957462,264564,489102,203796,957462
2023-04-20 22:22,957466,264566,489102,203798,957466
2023-04-20 22:23,957472,264564,489108,203800,957472
2023-04-20 22:24,957476,264567,489108,203801,957476
2023-04-20 22:25,957481,264563,489114,203804,957481
2023-04-20 22:26,957485,264564,489115,203806,957485
2023-04-20 22:27,957490,264560,489123,203807,957490
2023-04-20 22:28,957494,264561,489123,203810,957494
2023-04-20 22:29,957501,264561,489129,203811,957501
2023-04-20 22:30,957505,264562,489129,203814,957505
2023-04-20 22:31,957510,264562,489132,203816,957510
2023-04-20 22:32,957515,264566,489132,203817,957515
2023-04-20 22:33,957520,264565,489135,203820,957520
2023-04-20 22:35,957524,264565,489135,203824,957524
2023-04-20 22:36,957528,264549,489148,203831,957528
2023-04-20 22:37,957533,264552,489148,203833,957533
2023-04-20 22:38,957538,264548,489154,203836,957538
2023-04-20 22:39,957542,264549,489154,203839,957542
2023-04-20 22:40,957546,264545,489159,203842,957546
2023-04-20 22:41,957551,264548,489159,203844,957551
2023-04-20 22:42,957555,264540,489165,203850,957555
2023-04-20 22:43,957560,264541,489165,203854,957560
2023-04-20 22:44,957564,264537,489171,203856,957564
2023-04-20 22:45,957569,264539,489171,203859,957569
2023-04-20 22:46,957575,264536,489178,203861,957575
2023-04-20 22:47,957580,264532,489180,203868,957580
2023-04-20 22:48,957584,264533,489180,203871,957584
2023-04-20 22:49,957588,264530,489186,203872,957588
2023-04-20 22:50,957593,264529,489191,203873,957593
2023-04-20 22:51,957598,264533,489191,203874,957598
2023-04-20 22:52,957602,264530,489194,203878,957602
2023-04-20 22:53,957607,264531,489194,203882,957607
2023-04-20 22:54,957612,264523,489202,203887,957612
2023-04-20 22:55,957616,264524,489202,203890,957616
2023-04-20 22:56,957622,264526,489204,203892,957622
2023-04-20 22:57,957626,264527,489204,203895,957626
2023-04-20 22:58,957631,264516,489217,203898,957631
2023-04-20 22:59,957635,264517,489217,203901,957635
2023-04-20 23:00,957644,264520,489221,203903,957644
2023-04-20 23:01,957654,264527,489223,203904,957654
2023-04-20 23:02,957667,264539,489223,203905,957667
2023-04-20 23:03,957679,264546,489226,203907,957679
2023-04-20 23:04,957691,264556,489226,203909,957691
2023-04-20 23:05,957703,264562,489229,203912,957703
2023-04-20 23:06,957715,264574,489229,203912,957715
2023-04-20 23:07,957726,264574,489236,203916,957726
2023-04-20 23:08,957738,264580,489239,203919,957738
2023-04-20 23:09,957750,264592,489239,203919,957750
2023-04-20 23:10,957761,264594,489246,203921,957761
2023-04-20 23:11,957773,264601,489250,203922,957773
2023-04-20 23:12,957784,264611,489250,203923,957784
2023-04-20 23:13,957796,264610,489258,203928,957796
2023-04-20 23:14,957808,264618,489258,203932,957808
2023-04-20 23:15,957821,264620,489265,203936,957821
2023-04-20 23:16,957833,264631,489265,203937,957833
2023-04-20 23:17,957844,264641,489265,203938,957844
2023-04-20 23:18,957856,264648,489265,203943,957856
2023-04-20 23:19,957867,264655,489265,203947,957867
2023-04-20 23:20,957879,264661,489265,203953,957879
2023-04-20 23:22,957892,264665,489265,203962,957892
2023-04-20 23:23,957904,264671,489265,203968,957904
2023-04-20 23:24,957915,264680,489265,203970,957915
2023-04-20 23:25,957927,264674,489281,203972,957927
2023-04-20 23:26,957940,264681,489281,203978,957940
2023-04-20 23:27,957953,264688,489283,203982,957953
2023-04-20 23:28,957965,264697,489283,203985,957965
2023-04-20 23:29,957977,264699,489290,203988,957977
2023-04-20 23:30,957989,264706,489290,203993,957989
2023-04-20 23:31,958002,264713,489293,203996,958002
2023-04-20 23:32,958014,264723,489293,203998,958014
2023-04-20 23:33,958026,264726,489300,204000,958026
2023-04-20 23:34,958039,264738,489300,204001,958039
2023-04-20 23:35,958050,264744,489304,204002,958050
2023-04-20 23:36,958063,264755,489304,204004,958063
2023-04-20 23:37,958076,264760,489311,204005,958076
2023-04-20 23:38,958087,264768,489311,204008,958087
2023-04-20 23:39,958099,264773,489316,204010,958099
2023-04-20 23:40,958111,264784,489316,204011,958111
2023-04-20 23:41,958123,264786,489321,204016,958123
2023-04-20 23:42,958136,264798,489321,204017,958136
2023-04-20 23:43,958148,264806,489324,204018,958148
2023-04-20 23:44,958159,264815,489324,204020,958159
2023-04-20 23:45,958170,264817,489329,204024,958170
2023-04-20 23:46,958182,264825,489329,204028,958182
2023-04-20 23:47,958194,264832,489332,204030,958194
2023-04-20 23:48,958207,264842,489332,204033,958207
2023-04-20 23:49,958219,264846,489338,204035,958219
2023-04-20 23:50,958231,264856,489338,204037,958231
2023-04-20 23:51,958243,264864,489339,204040,958243
2023-04-20 23:52,958255,264875,489339,204041,958255
2023-04-20 23:53,958267,264882,489340,204045,958267
2023-04-20 23:54,958279,264891,489340,204048,958279
2023-04-20 23:55,958291,264897,489340,204054,958291
2023-04-20 23:56,958303,264908,489340,204055,958303
2023-04-20 23:57,958314,264914,489343,204057,958314
2023-04-20 23:58,958325,264923,489343,204059,958325
2023-04-20 23:59,958337,264930,489345,204062,958337
2023-04-21 00:00,958354,264946,489345,204063,958354
2023-04-21 00:01,958372,264958,489350,204064,958372
2023-04-21 00:02,958391,264976,489350,204065,958391
2023-04-21 00:03,958410,264988,489353,204069,958410
2023-04-21 00:04,958426,265001,489353,204072,958426
2023-04-21 00:05,958444,265014,489358,204072,958444
2023-04-21 00:06,958461,265027,489358,204076,958461
2023-04-21 00:07,958479,265039,489362,204078,958479
2023-04-21 00:08,958497,265055,489362,204080,958497
2023-04-21 00:10,958515,265067,489365,204083,958515
2023-04-21 00:11,958533,265084,489365,204084,958533
2023-04-21 00:12,958551,265100,489367,204084,958551
2023-04-21 00:13,958567,265110,489367,204090,958567
2023-04-21 00:14,958587,265126,489369,204092,958587
2023-04-21 00:15,958605,265140,489369,204096,958605
2023-04-21 00:16,958622,265156,489370,204096,958622
2023-04-21 00:17,958639,265172,489370,204097,958639
2023-04-21 00:18,958656,265186,489373,204097,958656
2023-04-21 00:19,958674,265201,489373,204100,958674
2023-04-21 00:20,958692,265216,489376,204100,958692
2023-04-21 00:21,958708,265229,489376,204103,958708
2023-04-21 00:22,958726,265238,489385,204103,958726
2023-04-21 00:23,958744,265254,489385,204105,958744
2023-04-21 00:24,958762,265264,489386,204112,958762
2023-04-21 00:25,958778,265278,489386,204114,958778
2023-04-21 00:26,958795,265293,489388,204114,958795
2023-04-21 00:27,958813,265308,489388,204117,958813
2023-04-21 00:28,958829,265320,489391,204118,958829
2023-04-21 00:29,958849,265335,489391,204123,958849
2023-04-21 00:30,958866,265349,489394,204123,958866
2023-04-21 00:31,958883,265365,489394,204124,958883
2023-04-21 00:32,958901,265379,489396,204126,958901
2023-04-21 00:33,958918,265390,489400,204128,958918
2023-04-21 00:34,958936,265403,489404,204129,958936
2023-04-21 00:35,958953,265420,489403,204130,958953
2023-04-21 00:36,958970,265436,489403,204131,958970
2023-04-21 00:37,958987,265448,489406,204133,958987
2023-04-21 00:38,959005,265464,489406,204135,959005
2023-04-21 00:39,959023,265475,489409,204139,959023
2023-04-21 00:40,959039,265490,489409,204140,959039
2023-04-21 00:41,959057,265504,489412,204141,959057
2023-04-21 00:42,959077,265524,489412,204141,959077
2023-04-21 00:43,959095,265536,489417,204142,959095
2023-04-21 00:44,959112,265550,489417,204145,959112
2023-04-21 00:45,959130,265567,489418,204145,959130
2023-04-21 00:46,959148,265582,489418,204148,959148
2023-04-21 00:47,959165,265598,489418,204149,959165
2023-04-21 00:48,959182,265612,489418,204152,959182
2023-04-21 00:49,959199,265628,489418,204153,959199
2023-04-21 00:50,959217,265646,489418,204153,959217
2023-04-21 00:51,959235,265659,489422,204154,959235
2023-04-21 00:52,959251,265674,489422,204155,959251
2023-04-21 00:53,959269,265689,489423,204157,959269
2023-04-21 00:54,959287,265705,489423,204159,959287
2023-04-21 00:55,959304,265716,489427,204161,959304
2023-04-21 00:57,959322,265729,489427,204166,959322
2023-04-21 00:58,959340,265744,489428,204168,959340
2023-04-21 00:59,959357,265759,489428,204170,959357
2023-04-21 01:00,959375,265775,489429,204171,959375
2023-04-21 01:01,959394,265793,489429,204172,959394
2023-04-21 01:02,959413,265809,489432,204172,959413
2023-04-21 01:03,959433,265826,489432,204175,959433
2023-04-21 01:04,959451,265839,489436,204176,959451
2023-04-21 01:05,959471,265856,489436,204179,959471
2023-04-21 01:06,959489,265873,489437,204179,959489
2023-04-21 01:07,959508,265889,489437,204182,959508
2023-04-21 01:08,959528,265907,489438,204183,959528
2023-04-21 01:09,959546,265925,489438,204183,959546
2023-04-21 01:10,959566,265939,489442,204185,959566
2023-04-21 01:11,959584,265957,489442,204185,959584
2023-04-21 01:12,959604,265971,489445,204188,959604
2023-04-21 01:13,959623,265988,489445,204190,959623
2023-04-21 01:14,959642,266004,489446,204192,959642
2023-04-21 01:15,959660,266017,489448,204195,959660
2023-04-21 01:16,959680,266035,489448,204197,959680
2023-04-21 01:17,959699,266050,489450,204199,959699
2023-04-21 01:18,959719,266070,489450,204199,959719
2023-04-21 01:19,959738,266087,489452,204199,959738
2023-04-21 01:20,959758,266106,489452,204200,959758
2023-04-21 01:21,959776,266118,489456,204202,959776
2023-04-21 01:22,959795,266136,489456,204203,959795
2023-04-21 01:23,959814,266148,489461,204205,959814
2023-04-21 01:24,959833,266167,489461,204205,959833
2023-04-21 01:25,959852,266182,489465,204205,959852
2023-04-21 01:26,959871,266200,489465,204206,959871
2023-04-21 01:27,959890,266215,489468,204207,959890
2023-04-21 01:28,959910,266232,489468,204210,959910
2023-04-21 01:29,959928,266246,489469,204213,959928
2023-04-21 01:30,959948,266265,489469,204214,959948
2023-04-21 01:31,959967,266281,489469,204217,959967
2023-04-21 01:32,959986,266300,489469,204217,959986
2023-04-21 01:33,960005,266317,489470,204218,960005
2023-04-21 01:34,960024,266335,489470,204219,960024
2023-04-21 01:35,960043,266351,489471,204221,960043
2023-04-21 01:36,960062,266370,489471,204221,960062
2023-04-21 01:37,960082,266386,489473,204223,960082
2023-04-21 01:38,960101,266402,489476,204223,960101
2023-04-21 01:39,960119,266420,489476,204223,960119
2023-04-21 01:40,960137,266437,489476,204224,960137
2023-04-21 01:41,960157,266457,489476,204224,960157
2023-04-21 01:42,960176,266472,489478,204226,960176
2023-04-21 01:44,960196,266491,489478,204227,960196
2023-04-21 01:45,960214,266506,489480,204228,960214
2023-04-21 01:46,960234,266526,489480,204228,960234
2023-04-21 01:47,960252,266542,489480,204230,960252
2023-04-21 01:48,960272,266562,489480,204230,960272
2023-04-21 01:49,960291,266579,489480,204232,960291
2023-04-21 01:50,960309,266597,489480,204232,960309
2023-04-21 01:51,960329,266616,489481,204232,960329
2023-04-21 01:52,960348,266633,489481,204234,960348
2023-04-21 01:53,960367,266651,489481,204235,960367
2023-04-21 01:54,960386,266669,489481,204236,960386
2023-04-21 01:55,960406,266687,489481,204238,960406
2023-04-21 01:56,960424,266702,489481,204241,960424
2023-04-21 01:57,960443,266718,489483,204242,960443
2023-04-21 01:58,960462,266736,489483,204243,960462
2023-04-21 01:59,960482,266749,489489,204244,960482
2023-04-21 02:00,960499,266765,489489,204245,960499
2023-04-21 02:01,960507,266771,489490,204246,960507
2023-04-21 02:02,960515,266775,489490,204250,960515
2023-04-21 02:03,960523,266778,489495,204250,960523
2023-04-21 02:04,960531,266785,489495,204251,960531
2023-04-21 02:05,960539,266791,489496,204252,960539
2023-04-21 02:06,960547,266799,489496,204252,960547
2023-04-21 02:07,960555,266801,489502,204252,960555
2023-04-21 02:08,960563,266809,489502,204252,960563
2023-04-21 02:09,960571,266816,489502,204253,960571
2023-04-21 02:10,960580,266823,489502,204255,960580
2023-04-21 02:11,960589,266824,489506,204259,960589
2023-04-21 02:12,960597,266831,489506,204260,960597
2023-04-21 02:13,960605,266839,489506,204260,960605
2023-04-21 02:14,960612,266845,489506,204261,960612
2023-04-21 02:15,960620,266853,489506,204261,960620
2023-04-21 02:16,960628,266861,489506,204261,960628
2023-04-21 02:17,960637,266869,489507,204261,960637
2023-04-21 02:18,960645,266877,489507,204261,960645
2023-04-21 02:19,960653,266882,489508,204263,960653
2023-04-21 02:20,960661,266889,489508,204264,960661
2023-04-21 02:21,960669,266897,489508,204264,960669
2023-04-21 02:22,960677,266905,489508,204264,960677
2023-04-21 02:23,960685,266908,489513,204264,960685
2023-04-21 02:24,960693,266914,489515,204264,960693
2023-04-21 02:25,960702,266923,489515,204264,960702
2023-04-21 02:26,960710,266931,489515,204264,960710
2023-04-21 02:27,960719,266939,489515,204265,960719
2023-04-21 02:28,960727,266943,489517,204267,960727
2023-04-21 02:29,960735,266950,489517,204268,960735
2023-04-21 02:30,960744,266959,489517,204268,960744
2023-04-21 02:32,960752,266967,489517,204268,960752
2023-04-21 02:33,960760,266972,489518,204270,960760
2023-04-21 02:34,960767,266978,489518,204271,960767
2023-04-21 02:35,960776,266985,489520,204271,960776
2023-04-21 02:36,960784,266991,489520,204273,960784
2023-04-21 02:37,960792,266999,489519,204274,960792
2023-04-21 02:38,960799,267005,489519,204275,960799
2023-04-21 02:39,960809,267014,489520,204275,960809
2023-04-21 02:40,960817,267022,489520,204275,960817
2023-04-21 02:41,960825,267028,489521,204276,960825
2023-04-21 02:42,960833,267036,489521,204276,960833
2023-04-21 02:43,960841,267043,489522,204276,960841
2023-04-21 02:44,960849,267051,489522,204276,960849
2023-04-21 02:45,960857,267058,489523,204276,960857
2023-04-21 02:46,960865,267065,489523,204277,960865
2023-04-21 02:47,960874,267073,489523,204278,960874
2023-04-21 02:48,960881,267080,489523,204278,960881
2023-04-21 02:49,960890,267086,489524,204280,960890
2023-04-21 02:50,960898,267094,489524,204280,960898
2023-04-21 02:51,960907,267103,489524,204280,960907
2023-04-21 02:52,960915,267110,489524,204281,960915
2023-04-21 02:53,960923,267116,489525,204282,960923
2023-04-21 02:54,960932,267125,489525,204282,960932
2023-04-21 02:55,960940,267131,489526,204283,960940
2023-04-21 02:56,960947,267138,489526,204283,960947
2023-04-21 02:57,960957,267147,489527,204283,960957
2023-04-21 02:58,960965,267155,489527,204283,960965
2023-04-21 02:59,960973,267163,489527,204283,960973
2023-04-21 03:00,960982,267172,489527,204283,960982
2023-04-21 03:01,960993,267182,489527,204284,960993
2023-04-21 03:02,961004,267193,489527,204284,961004
2023-04-21 03:03,961014,267203,489527,204284,961014
2023-04-21 03:04,961025,267214,489527,204284,961025
2023-04-21 03:05,961036,267225,489527,204284,961036
2023-04-21 03:06,961047,267236,489527,204284,961047
2023-04-21 03:07,961059,267248,489527,204284,961059
2023-04-21 03:08,961069,267258,489527,204284,961069
2023-04-21 03:09,961080,267261,489534,204285,961080
2023-04-21 03:10,961090,267271,489534,204285,961090
2023-04-21 03:11,961101,267281,489535,204285,961101
2023-04-21 03:12,961112,267292,489535,204285,961112
2023-04-21 03:13,961122,267302,489535,204285,961122
2023-04-21 03:14,961133,267313,489535,204285,961133
2023-04-21 03:15,961143,267321,489536,204286,961143
2023-04-21 03:16,961154,267332,489536,204286,961154
2023-04-21 03:17,961165,267343,489536,204286,961165
2023-04-21 03:19,961175,267353,489536,204286,961175
2023-04-21 03:20,961186,267363,489536,204287,961186
2023-04-21 03:21,961196,267373,489536,204287,961196
2023-04-21 03:22,961207,267384,489536,204287,961207
2023-04-21 03:23,961218,267395,489536,204287,961218
2023-04-21 03:24,961228,267405,489536,204287,961228
2023-04-21 03:25,961239,267414,489536,204289,961239
2023-04-21 03:26,961250,267422,489538,204290,961250
2023-04-21 03:27,961261,267433,489538,204290,961261
2023-04-21 03:28,961271,267441,489539,204291,961271
2023-04-21 03:29,961283,267453,489539,204291,961283
2023-04-21 03:30,961293,267461,489540,204292,961293
2023-04-21 03:31,961304,267472,489540,204292,961304
2023-04-21 03:32,961315,267482,489540,204293,961315
2023-04-21 03:33,961325,267492,489540,204293,961325
2023-04-21 03:34,961336,267502,489541,204293,961336
2023-04-21 03:35,961346,267512,489541,204293,961346
2023-04-21 03:36,961356,267520,489543,204293,961356
2023-04-21 03:37,961367,267531,489543,204293,961367
2023-04-21 03:38,961378,267542,489543,204293,961378
2023-04-21 03:39,961389,267553,489543,204293,961389
2023-04-21 03:40,961399,267562,489544,204293,961399
2023-04-21 03:41,961410,267573,489544,204293,961410
2023-04-21 03:42,961420,267583,489544,204293,961420
2023-04-21 03:43,961431,267594,489544,204293,961431
2023-04-21 03:44,961442,267605,489544,204293,961442
2023-04-21 03:45,961452,267615,489544,204293,961452
2023-04-21 03:46,961463,267625,489545,204293,961463
2023-04-21 03:47,961473,267635,489545,204293,961473
2023-04-21 03:48,961484,267646,489545,204293,961484
2023-04-21 03:49,961495,267657,489545,204293,961495
2023-04-21 03:50,961505,267667,489545,204293,961505
2023-04-21 03:51,961516,267678,489545,204293,961516
2023-04-21 03:52,961527,267688,489545,204294,961527
2023-04-21 03:53,961537,267697,489545,204295,961537
2023-04-21 03:54,961548,267708,489545,204295,961548
2023-04-21 03:55,961559,267719,489545,204295,961559
2023-04-21 03:56,961569,267729,489546,204294,961569
2023-04-21 03:57,961579,267739,489546,204294,961579
2023-04-21 03:58,961590,267748,489547,204295,961590
2023-04-21 03:59,961600,267758,489547,204295,961600
2023-04-21 04:00,961616,267773,489548,204295,961616
2023-04-21 04:01,961631,267788,489548,204295,961631
2023-04-21 04:02,961647,267803,489548,204296,961647
2023-04-21 04:03,961663,267819,489548,204296,961663
2023-04-21 04:05,961678,267834,489548,204296,961678
2023-04-21 04:06,961694,267850,489548,204296,961694
2023-04-21 04:07,961710,267865,489549,204296,961710
2023-04-21 04:08,961726,267881,489549,204296,961726
2023-04-21 04:09,961742,267896,489549,204297,961742
2023-04-21 04:10,961757,267911,489549,204297,961757
2023-04-21 04:11,961773,267927,489549,204297,961773
2023-04-21 04:12,961789,267943,489549,204297,961789
2023-04-21 04:13,961805,267958,489549,204298,961805
2023-04-21 04:14,961820,267973,489549,204298,961820
2023-04-21 04:15,961836,267989,489549,204298,961836
2023-04-21 04:16,961851,268004,489549,204298,961851
2023-04-21 04:17,961868,268020,489550,204298,961868
2023-04-21 04:18,961883,268035,489550,204298,961883
2023-04-21 04:19,961899,268051,489550,204298,961899
2023-04-21 04:20,961915,268067,489550,204298,961915
2023-04-21 04:21,961930,268081,489550,204299,961930
2023-04-21 04:22,961947,268098,489550,204299,961947
2023-04-21 04:23,961961,268113,489549,204299,961961
2023-04-21 04:24,961977,268129,489549,204299,961977
2023-04-21 04:25,961994,268144,489551,204299,961994
2023-04-21 04:26,962009,268159,489551,204299,962009
2023-04-21 04:27,962025,268175,489551,204299,962025
2023-04-21 04:28,962040,268190,489551,204299,962040
2023-04-21 04:29,962056,268206,489551,204299,962056
2023-04-21 04:30,962072,268222,489551,204299,962072
2023-04-21 04:31,962089,268239,489551,204299,962089
2023-04-21 04:32,962105,268255,489551,204299,962105
2023-04-21 04:33,962121,268269,489553,204299,962121
2023-04-21 04:34,962137,268284,489553,204300,962137
2023-04-21 04:35,962153,268299,489553,204301,962153
2023-04-21 04:36,962169,268315,489553,204301,962169
2023-04-21 04:37,962184,268329,489554,204301,962184
2023-04-21 04:38,962200,268345,489554,204301,962200
2023-04-21 04:39,962216,268360,489555,204301,962216
2023-04-21 04:40,962232,268376,489555,204301,962232
2023-04-21 04:41,962248,268391,489556,204301,962248
2023-04-21 04:42,962264,268407,489556,204301,962264
2023-04-21 04:43,962279,268420,489557,204302,962279
2023-04-21 04:44,962296,268436,489557,204303,962296
2023-04-21 04:45,962311,268451,489557,204303,962311
2023-04-21 04:46,962326,268464,489557,204305,962326
2023-04-21 04:47,962342,268480,489557,204305,962342
2023-04-21 04:48,962359,268497,489557,204305,962359
2023-04-21 04:50,962374,268511,489557,204306,962374
2023-04-21 04:51,962390,268527,489557,204306,962390
2023-04-21 04:52,962406,268543,489557,204306,962406
2023-04-21 04:53,962421,268558,489557,204306,962421
2023-04-21 04:54,962437,268574,489557,204306,962437
2023-04-21 04:55,962452,268589,489557,204306,962452
2023-04-21 04:56,962468,268605,489557,204306,962468
2023-04-21 04:57,962484,268620,489557,204307,962484
2023-04-21 04:58,962500,268636,489557,204307,962500
2023-04-21 04:59,962515,268651,489557,204307,962515
2023-04-21 05:00,962530,268665,489558,204307,962530
2023-04-21 05:01,962538,268673,489558,204307,962538
2023-04-21 05:02,962547,268682,489558,204307,962547
2023-04-21 05:03,962556,268691,489558,204307,962556
2023-04-21 05:04,962564,268698,489559,204307,962564
2023-04-21 05:05,962573,268707,489559,204307,962573
2023-04-21 05:06,962582,268716,489559,204307,962582
2023-04-21 05:07,962590,268724,489559,204307,962590
2023-04-21 05:08,962599,268731,489560,204308,962599
2023-04-21 05:09,962607,268739,489560,204308,962607
2023-04-21 05:10,962616,268748,489560,204308,962616
2023-04-21 05:11,962625,268757,489560,204308,962625
2023-04-21 05:12,962633,268765,489560,204308,962633
2023-04-21 05:13,962642,268774,489560,204308,962642
2023-04-21 05:14,962650,268781,489560,204309,962650
2023-04-21 05:15,962660,268790,489560,204310,962660
2023-04-21 05:16,962668,268797,489560,204311,962668
2023-04-21 05:17,962676,268805,489560,204311,962676
2023-04-21 05:18,962685,268814,489560,204311,962685
2023-04-21 05:19,962694,268823,489560,204311,962694
2023-04-21 05:20,962703,268832,489560,204311,962703
2023-04-21 05:21,962711,268839,489560,204312,962711
2023-04-21 05:22,962720,268843,489565,204312,962720
2023-04-21 05:23,962728,268851,489565,204312,962728
2023-04-21 05:24,962737,268861,489564,204312,962737
2023-04-21 05:25,962746,268870,489564,204312,962746
2023-04-21 05:26,962754,268877,489565,204312,962754
2023-04-21 05:27,962763,268886,489565,204312,962763
2023-04-21 05:28,962772,268894,489566,204312,962772
2023-04-21 05:29,962780,268902,489566,204312,962780
2023-04-21 05:30,962789,268908,489567,204314,962789
2023-04-21 05:31,962797,268915,489567,204315,962797
2023-04-21 05:32,962806,268923,489567,204316,962806
2023-04-21 05:33,962815,268930,489567,204318,962815
2023-04-21 05:34,962823,268938,489567,204318,962823
2023-04-21 05:35,962832,268947,489567,204318,962832
2023-04-21 05:37,962841,268956,489567,204318,962841
2023-04-21 05:38,962849,268964,489567,204318,962849
2023-04-21 05:39,962858,268973,489567,204318,962858
2023-04-21 05:40,962867,268982,489567,204318,962867
2023-04-21 05:41,962876,268991,489567,204318,962876
2023-04-21 05:42,962884,268999,489567,204318,962884
2023-04-21 05:43,962893,269007,489567,204319,962893
2023-04-21 05:44,962901,269015,489567,204319,962901
2023-04-21 05:45,962910,269022,489568,204320,962910
2023-04-21 05:46,962919,269031,489568,204320,962919
2023-04-21 05:47,962927,269038,489568,204321,962927
2023-04-21 05:48,962936,269047,489568,204321,962936
2023-04-21 05:49,962944,269056,489567,204321,962944
2023-04-21 05:50,962953,269065,489567,204321,962953
2023-04-21 05:51,962961,269071,489568,204322,962961
2023-04-21 05:52,962970,269079,489568,204323,962970
2023-04-21 05:53,962979,269085,489571,204323,962979
2023-04-21 05:54,962987,269093,489571,204323,962987
2023-04-21 05:55,962996,269101,489572,204323,962996
2023-04-21 05:56,963005,269110,489572,204323,963005
2023-04-21 05:57,963013,269118,489572,204323,963013
2023-04-21 05:58,963022,269126,489572,204324,963022
2023-04-21 05:59,963031,269134,489572,204325,963031
2023-04-21 06:00,963040,269143,489572,204325,963040
2023-04-21 06:01,963052,269152,489574,204326,963052
2023-04-21 06:02,963063,269162,489574,204327,963063
2023-04-21 06:03,963073,269172,489574,204327,963073
2023-04-21 06:04,963084,269182,489574,204328,963084
2023-04-21 06:05,963096,269194,489574,204328,963096
2023-04-21 06:06,963106,269204,489574,204328,963106
2023-04-21 06:07,963117,269214,489575,204328,963117
2023-04-21 06:08,963128,269225,489575,204328,963128
2023-04-21 06:09,963139,269233,489577,204329,963139
2023-04-21 06:10,963149,269242,489578,204329,963149
2023-04-21 06:11,963160,269253,489578,204329,963160
2023-04-21 06:12,963171,269262,489580,204329,963171
2023-04-21 06:13,963182,269273,489580,204329,963182
2023-04-21 06:14,963192,269281,489582,204329,963192
2023-04-21 06:15,963203,269292,489582,204329,963203
2023-04-21 06:16,963215,269300,489585,204330,963215
2023-04-21 06:17,963226,269309,489585,204332,963226
2023-04-21 06:18,963237,269317,489587,204333,963237
2023-04-21 06:19,963248,269327,489587,204334,963248
2023-04-21 06:20,963258,269336,489588,204334,963258
2023-04-21 06:21,963269,269347,489588,204334,963269
2023-04-21 06:22,963280,269357,489588,204335,963280
2023-04-21 06:24,963291,269366,489588,204337,963291
2023-04-21 06:25,963302,269377,489588,204337,963302
2023-04-21 06:26,963313,269388,489588,204337,963313
2023-04-21 06:27,963324,269396,489590,204338,963324
2023-04-21 06:28,963334,269404,489590,204340,963334
2023-04-21 06:29,963345,269414,489591,204340,963345
2023-04-21 06:30,963356,269423,489591,204342,963356
2023-04-21 06:31,963367,269431,489593,204343,963367
2023-04-21 06:32,963378,269442,489593,204343,963378
2023-04-21 06:33,963388,269449,489596,204343,963388
2023-04-21 06:34,963399,269460,489596,204343,963399
2023-04-21 06:35,963410,269471,489596,204343,963410
2023-04-21 06:36,963421,269482,489596,204343,963421
2023-04-21 06:37,963431,269492,489596,204343,963431
2023-04-21 06:38,963442,269503,489596,204343,963442
2023-04-21 06:39,963453,269514,489596,204343,963453
2023-04-21 06:40,963463,269524,489596,204343,963463
2023-04-21 06:41,963475,269532,489599,204344,963475
2023-04-21 06:42,963486,269541,489599,204346,963486
2023-04-21 06:43,963496,269551,489599,204346,963496
2023-04-21 06:44,963507,269561,489599,204347,963507
2023-04-21 06:45,963518,269568,489601,204349,963518
2023-04-21 06:46,963529,269578,489601,204350,963529
2023-04-21 06:47,963540,269588,489602,204350,963540
2023-04-21 06:48,963550,269598,489602,204350,963550
2023-04-21 06:49,963562,269606,489605,204351,963562
2023-04-21 06:50,963572,269615,489606,204351,963572
2023-04-21 06:51,963583,269626,489606,204351,963583
2023-04-21 06:52,963593,269630,489610,204353,963593
2023-04-21 06:53,963604,269641,489610,204353,963604
2023-04-21 06:54,963615,269651,489610,204354,963615
2023-04-21 06:55,963627,269661,489610,204356,963627
2023-04-21 06:56,963638,269670,489612,204356,963638
2023-04-21 06:57,963649,269681,489612,204356,963649
2023-04-21 06:58,963659,269688,489615,204356,963659
2023-04-21 06:59,963670,269696,489615,204359,963670
2023-04-21 07:00,963685,269711,489615,204359,963685
2023-04-21 07:01,963701,269728,489615,204358,963701
2023-04-21 07:02,963716,269738,489618,204360,963716
2023-04-21 07:03,963732,269753,489618,204361,963732
2023-04-21 07:04,963748,269767,489619,204362,963748
2023-04-21 07:05,963765,269782,489619,204364,963765
2023-04-21 07:06,963782,269797,489620,204365,963782
2023-04-21 07:07,963797,269811,489620,204366,963797
2023-04-21 07:08,963813,269826,489620,204367,963813
2023-04-21 07:09,963829,269842,489620,204367,963829
2023-04-21 07:11,963844,269855,489621,204368,963844
2023-04-21 07:12,963860,269871,489621,204368,963860
2023-04-21 07:13,963876,269885,489622,204369,963876
2023-04-21 07:14,963892,269900,489622,204370,963892
2023-04-21 07:15,963907,269913,489624,204370,963907
2023-04-21 07:16,963923,269928,489624,204371,963923
2023-04-21 07:17,963938,269943,489624,204371,963938
2023-04-21 07:18,963955,269960,489624,204371,963955
2023-04-21 07:19,963970,269970,489627,204373,963970
2023-04-21 07:20,963985,269984,489627,204374,963985
2023-04-21 07:21,964001,270000,489627,204374,964001
2023-04-21 07:22,964017,270016,489627,204374,964017
2023-04-21 07:23,964032,270030,489628,204374,964032
2023-04-21 07:24,964048,270045,489628,204375,964048
2023-04-21 07:25,964064,270056,489631,204377,964064
2023-04-21 07:26,964080,270072,489631,204377,964080
2023-04-21 07:27,964095,270087,489631,204377,964095
2023-04-21 07:28,964111,270103,489631,204377,964111
2023-04-21 07:29,964126,270117,489632,204377,964126
2023-04-21 07:30,964143,270134,489632,204377,964143
2023-04-21 07:31,964158,270145,489636,204377,964158
2023-04-21 07:32,964174,270159,489636,204379,964174
2023-04-21 07:33,964189,270174,489636,204379,964189
2023-04-21 07:34,964205,270190,489636,204379,964205
2023-04-21 07:35,964221,270203,489637,204381,964221
2023-04-21 07:36,964236,270218,489637,204381,964236
2023-04-21 07:37,964252,270231,489638,204383,964252
2023-04-21 07:38,964267,270245,489638,204384,964267
2023-04-21 07:39,964284,270260,489640,204384,964284
2023-04-21 07:40,964299,270274,489640,204385,964299
2023-04-21 07:41,964314,270286,489642,204386,964314
2023-04-21 07:42,964331,270303,489642,204386,964331
2023-04-21 07:43,964347,270315,489645,204387,964347
2023-04-21 07:44,964362,270330,489645,204387,964362
2023-04-21 07:45,964378,270343,489647,204388,964378
2023-04-21 07:46,964395,270359,489647,204389,964395
2023-04-21 07:47,964410,270372,489649,204389,964410
2023-04-21 07:48,964425,270386,489649,204390,964425
2023-04-21 07:49,964442,270403,489648,204391,964442
2023-04-21 07:50,964457,270417,489648,204392,964457
2023-04-21 07:51,964472,270431,489649,204392,964472
2023-04-21 07:52,964489,270447,489649,204393,964489
2023-04-21 07:53,964504,270459,489651,204394,964504
2023-04-21 07:54,964520,270475,489651,204394,964520
2023-04-21 07:55,964536,270487,489652,204397,964536
2023-04-21 07:56,964551,270499,489652,204400,964551
2023-04-21 07:57,964567,270512,489655,204400,964567
2023-04-21 07:59,964583,270528,489655,204400,964583
2023-04-21 08:00,964599,270542,489656,204401,964599
2023-04-21 08:01,964614,270557,489656,204401,964614
2023-04-21 08:02,964630,270570,489657,204403,964630
2023-04-21 08:03,964644,270583,489657,204404,964644
2023-04-21 08:04,964660,270597,489658,204405,964660
2023-04-21 08:05,964675,270610,489658,204407,964675
2023-04-21 08:06,964690,270626,489658,204406,964690
2023-04-21 08:07,964705,270640,489658,204407,964705
2023-04-21 08:08,964721,270655,489659,204407,964721
2023-04-21 08:09,964736,270668,489659,204409,964736
2023-04-21 08:10,964751,270681,489659,204411,964751
2023-04-21 08:11,964766,270694,489659,204413,964766
2023-04-21 08:12,964781,270707,489661,204413,964781
2023-04-21 08:13,964796,270720,489661,204415,964796
2023-04-21 08:14,964811,270734,489661,204416,964811
2023-04-21 08:15,964826,270749,489661,204416,964826
2023-04-21 08:16,964843,270762,489664,204417,964843
2023-04-21 08:17,964858,270776,489664,204418,964858
2023-04-21 08:18,964873,270788,489665,204420,964873
2023-04-21 08:19,964888,270803,489665,204420,964888
2023-04-21 08:20,964903,270817,489665,204421,964903
2023-04-21 08:21,964920,270834,489665,204421,964920
2023-04-21 08:22,964935,270844,489667,204424,964935
2023-04-21 08:23,964950,270857,489667,204426,964950
2023-04-21 08:24,964964,270869,489669,204426,964964
2023-04-21 08:25,964979,270884,489669,204426,964979
2023-04-21 08:26,964995,270899,489670,204426,964995
2023-04-21 08:27,965010,270913,489670,204427,965010
2023-04-21 08:28,965025,270926,489671,204428,965025
2023-04-21 08:29,965041,270938,489671,204432,965041
2023-04-21 08:30,965055,270951,489672,204432,965055
2023-04-21 08:31,965070,270966,489672,204432,965070
2023-04-21 08:32,965087,270982,489673,204432,965087
2023-04-21 08:33,965102,270996,489673,204433,965102
2023-04-21 08:34,965117,271006,489675,204436,965117
2023-04-21 08:35,965132,271021,489675,204436,965132
2023-04-21 08:36,965147,271033,489677,204437,965147
2023-04-21 08:37,965163,271048,489677,204438,965163
2023-04-21 08:38,965177,271061,489678,204438,965177
2023-04-21 08:39,965193,271074,489678,204441,965193
2023-04-21 08:40,965208,271085,489681,204442,965208
2023-04-21 08:41,965223,271097,489681,204445,965223
2023-04-21 08:42,965238,271110,489683,204445,965238
2023-04-21 08:43,965253,271124,489683,204446,965253
2023-04-21 08:44,965269,271136,489685,204448,965269
2023-04-21 08:46,965284,271149,489685,204450,965284
2023-04-21 08:47,965298,271160,489686,204452,965298
2023-04-21 08:48,965314,271175,489686,204453,965314
2023-04-21 08:49,965329,271188,489687,204454,965329
2023-04-21 08:50,965344,271203,489687,204454,965344
2023-04-21 08:51,965359,271214,489690,204455,965359
2023-04-21 08:52,965374,271229,489690,204455,965374
2023-04-21 08:53,965390,271239,489695,204456,965390
2023-04-21 08:54,965404,271253,489695,204456,965404
2023-04-21 08:55,965420,271267,489696,204457,965420
2023-04-21 08:56,965434,271281,489695,204458,965434
2023-04-21 08:57,965450,271295,489695,204460,965450
2023-04-21 08:58,965466,271306,489699,204461,965466
2023-04-21 08:59,965480,271320,489699,204461,965480
2023-04-21 09:00,965492,271329,489700,204463,965492
2023-04-21 09:01,965498,271335,489700,204463,965498
2023-04-21 09:02,965503,271339,489700,204464,965503
2023-04-21 09:03,965508,271341,489700,204467,965508
2023-04-21 09:04,965513,271344,489702,204467,965513
2023-04-21 09:05,965517,271346,489702,204469,965517
2023-04-21 09:06,965522,271349,489704,204469,965522
2023-04-21 09:07,965526,271352,489704,204470,965526
2023-04-21 09:08,965531,271356,489704,204471,965531
2023-04-21 09:09,965535,271359,489704,204472,965535
2023-04-21 09:10,965540,271363,489705,204472,965540
2023-04-21 09:11,965544,271363,489705,204476,965544
2023-04-21 09:12,965549,271366,489706,204477,965549
2023-04-21 09:13,965553,271369,489706,204478,965553
2023-04-21 09:14,965558,271370,489707,204481,965558
2023-04-21 09:15,965562,271373,489707,204482,965562
2023-04-21 09:16,965567,271377,489708,204482,965567
2023-04-21 09:17,965571,271378,489708,204485,965571
2023-04-21 09:18,965576,271380,489710,204486,965576
2023-04-21 09:19,965580,271384,489710,204486,965580
2023-04-21 09:20,965584,271384,489711,204489,965584
2023-04-21 09:21,965590,271389,489711,204490,965590
2023-04-21 09:22,965595,271390,489713,204492,965595
2023-04-21 09:23,965599,271393,489713,204493,965599
2023-04-21 09:24,965604,271395,489715,204494,965604
2023-04-21 09:25,965608,271398,489715,204495,965608
2023-04-21 09:26,965613,271400,489718,204495,965613
2023-04-21 09:27,965618,271405,489718,204495,965618
2023-04-21 09:28,965623,271407,489718,204498,965623
2023-04-21 09:29,965627,271409,489719,204499,965627
2023-04-21 09:30,965632,271413,489719,204500,965632
2023-04-21 09:31,965636,271415,489719,204502,965636
2023-04-21 09:33,965640,271418,489720,204502,965640
2023-04-21 09:34,965645,271422,489720,204503,965645
2023-04-21 09:35,965650,271423,489724,204503,965650
2023-04-21 09:36,965654,271425,489724,204505,965654
2023-04-21 09:37,965659,271425,489726,204508,965659
2023-04-21 09:38,965665,271429,489726,204510,965665
2023-04-21 09:39,965670,271429,489726,204515,965670
2023-04-21 09:40,965674,271430,489729,204515,965674
2023-04-21 09:41,965679,271434,489729,204516,965679
2023-04-21 09:42,965684,271434,489733,204517,965684
2023-04-21 09:43,965688,271436,489733,204519,965688
2023-04-21 09:44,965694,271440,489734,204520,965694
2023-04-21 09:45,965699,271445,489734,204520,965699
2023-04-21 09:46,965703,271448,489734,204521,965703
2023-04-21 09:47,965708,271452,489734,204522,965708
2023-04-21 09:48,965712,271453,489735,204524,965712
2023-04-21 09:49,965716,271458,489735,204523,965716
2023-04-21 09:50,965721,271461,489735,204525,965721
2023-04-21 09:51,965725,271463,489735,204527,965725
2023-04-21 09:52,965731,271466,489738,204527,965731
2023-04-21 09:53,965735,271469,489738,204528,965735
2023-04-21 09:54,965740,271474,489738,204528,965740
2023-04-21 09:55,965744,271473,489742,204529,965744
2023-04-21 09:56,965749,271477,489742,204530,965749
2023-04-21 09:57,965753,271479,489743,204531,965753
2023-04-21 09:58,965758,271481,489743,204534,965758
2023-04-21 09:59,965763,271482,489747,204534,965763
2023-04-21 10:00,965771,271489,489747,204535,965771
2023-04-21 10:01,965780,271496,489750,204534,965780
2023-04-21 10:02,965789,271503,489750,204536,965789
2023-04-21 10:03,965798,271510,489749,204539,965798
2023-04-21 10:04,965806,271517,489750,204539,965806
2023-04-21 10:05,965816,271525,489750,204541,965816
2023-04-21 10:06,965825,271532,489751,204542,965825
2023-04-21 10:07,965834,271538,489751,204545,965834
2023-04-21 10:08,965843,271545,489752,204546,965843
2023-04-21 10:09,965852,271554,489752,204546,965852
2023-04-21 10:10,965861,271559,489755,204547,965861
2023-04-21 10:11,965869,271565,489755,204549,965869
2023-04-21 10:12,965878,271569,489757,204552,965878
2023-04-21 10:13,965887,271577,489757,204553,965887
2023-04-21 10:14,965896,271583,489758,204555,965896
2023-04-21 10:15,965905,271588,489758,204559,965905
2023-04-21 10:16,965913,271590,489762,204561,965913
2023-04-21 10:17,965923,271598,489762,204563,965923
2023-04-21 10:18,965933,271606,489764,204563,965933
2023-04-21 10:20,965942,271612,489764,204566,965942
2023-04-21 10:21,965950,271618,489765,204567,965950
2023-04-21 10:22,965959,271627,489765,204567,965959
2023-04-21 10:23,965968,271634,489765,204569,965968
2023-04-21 10:24,965978,271640,489765,204573,965978
2023-04-21 10:25,965987,271647,489766,204574,965987
2023-04-21 10:26,965996,271654,489766,204576,965996
2023-04-21 10:27,966005,271659,489770,204576,966005
2023-04-21 10:28,966015,271667,489770,204578,966015
2023-04-21 10:29,966024,271671,489773,204580,966024
2023-04-21 10:30,966033,271679,489773,204581,966033
2023-04-21 10:31,966042,271685,489775,204582,966042
2023-04-21 10:32,966051,271692,489775,204584,966051
2023-04-21 10:33,966059,271693,489782,204584,966059
2023-04-21 10:34,966068,271700,489782,204586,966068
2023-04-21 10:35,966078,271705,489784,204589,966078
2023-04-21 10:36,966086,271712,489784,204590,966086
2023-04-21 10:37,966095,271720,489784,204591,966095
2023-04-21 10:38,966104,271730,489784,204590,966104
2023-04-21 10:39,966113,271738,489785,204590,966113
2023-04-21 10:40,966121,271744,489786,204591,966121
2023-04-21 10:41,966130,271752,489786,204592,966130
2023-04-21 10:42,966139,271761,489786,204592,966139
2023-04-21 10:43,966148,271769,489786,204593,966148
2023-04-21 10:44,966156,271777,489785,204594,966156
2023-04-21 10:45,966165,271786,489785,204594,966165
2023-04-21 10:46,966174,271792,489787,204595,966174
2023-04-21 10:47,966184,271800,489787,204597,966184
2023-04-21 10:48,966193,271807,489789,204597,966193
2023-04-21 10:49,966202,271814,489789,204599,966202
2023-04-21 10:50,966210,271819,489791,204600,966210
2023-04-21 10:51,966220,271828,489791,204601,966220
2023-04-21 10:52,966229,271831,489792,204606,966229
2023-04-21 10:53,966238,271840,489792,204606,966238
2023-04-21 10:54,966248,271843,489795,204610,966248
2023-04-21 10:55,966256,271851,489795,204610,966256
2023-04-21 10:56,966265,271857,489796,204612,966265
2023-04-21 10:57,966274,271865,489796,204613,966274
2023-04-21 10:58,966283,271870,489797,204616,966283
2023-04-21 10:59,966292,271879,489797,204616,966292
2023-04-21 11:00,966301,271883,489799,204619,966301
2023-04-21 11:01,966310,271890,489799,204621,966310
2023-04-21 11:02,966319,271899,489799,204621,966319
2023-04-21 11:03,966330,271909,489799,204622,966330
2023-04-21 11:04,966339,271912,489805,204622,966339
2023-04-21 11:06,966348,271920,489805,204623,966348
2023-04-21 11:07,966358,271927,489805,204626,966358
2023-04-21 11:08,966366,271934,489804,204628,966366
2023-04-21 11:09,966376,271942,489804,204630,966376
2023-04-21 11:10,966385,271946,489806,204633,966385
2023-04-21 11:11,966394,271954,489806,204634,966394
2023-04-21 11:12,966404,271962,489806,204636,966404
2023-04-21 11:13,966414,271970,489806,204638,966414
2023-04-21 11:14,966423,271973,489809,204641,966423
2023-04-21 11:15,966432,271980,489809,204643,966432
2023-04-21 11:16,966441,271984,489810,204647,966441
2023-04-21 11:17,966450,271990,489810,204650,966450
2023-04-21 11:18,966459,271996,489813,204650,966459
2023-04-21 11:19,966468,272003,489813,204652,966468
2023-04-21 11:20,966478,272009,489817,204652,966478
2023-04-21 11:21,966487,272015,489817,204655,966487
2023-04-21 11:22,966496,272022,489818,204656,966496
2023-04-21 11:23,966505,272027,489818,204660,966505
2023-04-21 11:24,966514,272034,489820,204660,966514
2023-04-21 11:25,966523,272042,489820,204661,966523
2023-04-21 11:26,966532,272043,489826,204663,966532
2023-04-21 11:27,966541,272050,489826,204665,966541
2023-04-21 11:28,966550,272054,489831,204665,966550
2023-04-21 11:29,966560,272063,489831,204666,966560
2023-04-21 11:30,966570,272069,489833,204668,966570
2023-04-21 11:31,966581,272080,489833,204668,966581
2023-04-21 11:32,966590,272087,489835,204668,966590
2023-04-21 11:33,966599,272092,489837,204670,966599
2023-04-21 11:34,966608,272100,489837,204671,966608
2023-04-21 11:35,966617,272104,489840,204673,966617
2023-04-21 11:36,966626,272110,489840,204676,966626
2023-04-21 11:37,966635,272117,489841,204677,966635
2023-04-21 11:38,966644,272122,489841,204681,966644
2023-04-21 11:39,966654,272128,489843,204683,966654
2023-04-21 11:40,966664,272136,489843,204685,966664
2023-04-21 11:41,966673,272141,489846,204686,966673
2023-04-21 11:42,966682,272149,489846,204687,966682
2023-04-21 11:43,966691,272155,489849,204687,966691
2023-04-21 11:44,966701,272165,489849,204687,966701
2023-04-21 11:45,966709,272168,489852,204689,966709
2023-04-21 11:47,966719,272176,489852,204691,966719
2023-04-21 11:48,966731,272182,489856,204693,966731
2023-04-21 11:49,966740,272187,489856,204697,966740
2023-04-21 11:50,966749,272190,489858,204701,966749
2023-04-21 11:51,966758,272197,489858,204703,966758
2023-04-21 11:52,966768,272201,489864,204703,966768
2023-04-21 11:53,966777,272210,489864,204703,966777
2023-04-21 11:54,966786,272213,489867,204706,966786
2023-04-21 11:55,966795,272222,489867,204706,966795
2023-04-21 11:56,966804,272227,489869,204708,966804
2023-04-21 11:57,966813,272235,489869,204709,966813
2023-04-21 11:58,966822,272238,489874,204710,966822
2023-04-21 11:59,966832,272247,489874,204711,966832
2023-04-21 12:00,966840,272251,489878,204711,966840
2023-04-21 12:01,966848,272256,489878,204714,966848
2023-04-21 12:02,966857,272260,489881,204716,966857
2023-04-21 12:03,966864,272262,489881,204721,966864
2023-04-21 12:04,966872,272268,489882,204722,966872
2023-04-21 12:05,966883,272278,489882,204723,966883
2023-04-21 12:06,966890,272283,489882,204725,966890
2023-04-21 12:07,966898,272290,489882,204726,966898
2023-04-21 12:09,966906,272295,489882,204729,966906
2023-04-21 12:10,966914,272300,489882,204732,966914
2023-04-21 12:11,966922,272304,489882,204736,966922
2023-04-21 12:12,966930,272311,489882,204737,966930
2023-04-21 12:13,966938,272318,489882,204738,966938
2023-04-21 12:14,966946,272325,489882,204739,966946
2023-04-21 12:15,966955,272320,489896,204739,966955
2023-04-21 12:16,966963,272325,489896,204742,966963
2023-04-21 12:17,966970,272327,489900,204743,966970
2023-04-21 12:18,966978,272332,489900,204746,966978
2023-04-21 12:19,966986,272334,489905,204747,966986
2023-04-21 12:20,966994,272341,489905,204748,966994
2023-04-21 12:21,967001,272344,489907,204750,967001
2023-04-21 12:22,967009,272349,489907,204753,967009
2023-04-21 12:23,967017,272350,489910,204757,967017
2023-04-21 12:24,967025,272356,489910,204759,967025
2023-04-21 12:25,967032,272356,489917,204759,967032
2023-04-21 12:26,967040,272363,489917,204760,967040
2023-04-21 12:27,967048,272367,489919,204762,967048
2023-04-21 12:28,967057,272373,489919,204765,967057
2023-04-21 12:29,967065,272375,489919,204771,967065
2023-04-21 12:30,967073,272381,489919,204773,967073
2023-04-21 12:31,967082,272384,489923,204775,967082
2023-04-21 12:32,967090,272389,489923,204778,967090
2023-04-21 12:33,967098,272390,489928,204780,967098
2023-04-21 12:34,967106,272397,489928,204781,967106
2023-04-21 12:35,967113,272400,489930,204783,967113
2023-04-21 12:36,967121,272405,489930,204786,967121
2023-04-21 12:37,967129,272410,489933,204786,967129
2023-04-21 12:38,967137,272418,489933,204786,967137
2023-04-21 12:39,967145,272416,489939,204790,967145
2023-04-21 12:40,967152,272421,489939,204792,967152
2023-04-21 12:41,967160,272426,489942,204792,967160
2023-04-21 12:42,967168,272432,489942,204794,967168
2023-04-21 12:43,967176,272435,489946,204795,967176
2023-04-21 12:44,967183,272441,489946,204796,967183
2023-04-21 12:45,967192,272447,489946,204799,967192
2023-04-21 12:46,967199,272454,489946,204799,967199
2023-04-21 12:47,967207,272461,489947,204799,967207
2023-04-21 12:48,967215,272466,489947,204802,967215
2023-04-21 12:49,967223,272470,489950,204803,967223
2023-04-21 12:50,967230,272476,489950,204804,967230
2023-04-21 12:51,967238,272479,489952,204807,967238
2023-04-21 12:52,967247,272487,489952,204808,967247
2023-04-21 12:53,967256,272491,489955,204810,967256
2023-04-21 12:54,967264,272498,489955,204811,967264
2023-04-21 12:55,967272,272500,489960,204812,967272
2023-04-21 12:57,967280,272507,489960,204813,967280
2023-04-21 12:58,967287,272509,489963,204815,967287
2023-04-21 12:59,967295,272517,489963,204815,967295
2023-04-21 13:00,967302,272522,489963,204817,967302
2023-04-21 13:01,967316,272536,489963,204817,967316
2023-04-21 13:02,967330,272547,489963,204820,967330
2023-04-21 13:03,967343,272556,489963,204824,967343
2023-04-21 13:04,967356,272569,489963,204824,967356
2023-04-21 13:05,967369,272580,489963,204826,967369
2023-04-21 13:06,967383,272592,489963,204828,967383
2023-04-21 13:07,967396,272604,489963,204829,967396
2023-04-21 13:08,967410,272604,489976,204830,967410
2023-04-21 13:09,967423,272615,489976,204832,967423
2023-04-21 13:10,967436,272623,489978,204835,967436
2023-04-21 13:11,967449,272635,489978,204836,967449
2023-04-21 13:12,967463,272646,489980,204837,967463
2023-04-21 13:13,967479,272661,489980,204838,967479
2023-04-21 13:14,967492,272673,489981,204838,967492
2023-04-21 13:15,967505,272684,489981,204840,967505
2023-04-21 13:16,967519,272697,489982,204840,967519
2023-04-21 13:17,967532,272710,489982,204840,967532
2023-04-21 13:18,967546,272721,489985,204840,967546
2023-04-21 13:19,967560,272730,489985,204845,967560
2023-04-21 13:20,967573,272741,489986,204846,967573
2023-04-21 13:21,967586,272754,489986,204846,967586
2023-04-21 13:22,967600,272764,489988,204848,967600
2023-04-21 13:23,967613,272773,489988,204852,967613
2023-04-21 13:24,967626,272784,489990,204852,967626
2023-04-21 13:25,967640,272794,489991,204855,967640
2023-04-21 13:26,967654,272808,489991,204855,967654
2023-04-21 13:27,967667,272821,489991,204855,967667
2023-04-21 13:28,967680,272831,489991,204858,967680
2023-04-21 13:29,967694,272843,489992,204859,967694
2023-04-21 13:30,967707,272854,489992,204861,967707
2023-04-21 13:31,967721,272859,489998,204864,967721
2023-04-21 13:32,967733,272869,489998,204866,967733
2023-04-21 13:33,967747,272878,490000,204869,967747
2023-04-21 13:34,967760,272885,490000,204875,967760
2023-04-21 13:35,967773,272897,490001,204875,967773
2023-04-21 13:36,967787,272910,490001,204876,967787
2023-04-21 13:37,967801,272923,490001,204877,967801
2023-04-21 13:38,967814,272933,490001,204880,967814
2023-04-21 13:39,967828,272943,490004,204881,967828
2023-04-21 13:40,967841,272956,490004,204881,967841
2023-04-21 13:41,967854,272962,490009,204883,967854
2023-04-21 13:42,967867,272973,490009,204885,967867
2023-04-21 13:44,967881,272981,490013,204887,967881
2023-04-21 13:45,967895,272994,490013,204888,967895
2023-04-21 13:46,967908,273008,490012,204888,967908
2023-04-21 13:47,967921,273020,490012,204889,967921
2023-04-21 13:48,967934,273031,490013,204890,967934
2023-04-21 13:49,967948,273043,490013,204892,967948
2023-04-21 13:50,967961,273055,490013,204893,967961
2023-04-21 13:51,967977,273068,490014,204895,967977
2023-04-21 13:52,967992,273083,490014,204895,967992
2023-04-21 13:53,968005,273092,490016,204897,968005
2023-04-21 13:54,968019,273106,490016,204897,968019
2023-04-21 13:55,968032,273116,490017,204899,968032
2023-04-21 13:56,968045,273127,490019,204899,968045
2023-04-21 13:57,968059,273137,490019,204903,968059
2023-04-21 13:58,968072,273145,490020,204907,968072
2023-04-21 13:59,968085,273156,490020,204909,968085
2023-04-21 14:00,968097,273167,490021,204909,968097
2023-04-21 14:01,968106,273174,490023,204909,968106
2023-04-21 14:02,968116,273184,490023,204909,968116
2023-04-21 14:03,968125,273189,490026,204910,968125
2023-04-21 14:04,968134,273197,490026,204911,968134
2023-04-21 14:05,968143,273203,490028,204912,968143
2023-04-21 14:06,968153,273213,490028,204912,968153
2023-04-21 14:07,968162,273215,490032,204915,968162
2023-04-21 14:08,968172,273222,490032,204918,968172
2023-04-21 14:09,968180,273227,490033,204920,968180
2023-04-21 14:10,968190,273235,490033,204922,968190
2023-04-21 14:11,968199,273242,490034,204923,968199
2023-04-21 14:12,968210,273252,490034,204924,968210
2023-04-21 14:13,968219,273258,490035,204926,968219
2023-04-21 14:14,968228,273266,490035,204927,968228
2023-04-21 14:15,968238,273271,490039,204928,968238
2023-04-21 14:16,968247,273278,490039,204930,968247
2023-04-21 14:17,968256,273285,490040,204931,968256
2023-04-21 14:18,968265,273293,490041,204931,968265
2023-04-21 14:19,968274,273299,490041,204934,968274
2023-04-21 14:20,968284,273308,490042,204934,968284
2023-04-21 14:21,968294,273316,490043,204935,968294
2023-04-21 14:22,968303,273321,490046,204936,968303
2023-04-21 14:23,968312,273330,490046,204936,968312
2023-04-21 14:24,968322,273337,490048,204937,968322
2023-04-21 14:25,968330,273343,490048,204939,968330
2023-04-21 14:26,968341,273349,490052,204940,968341
2023-04-21 14:27,968351,273355,490052,204944,968351
2023-04-21 14:28,968360,273362,490054,204944,968360
2023-04-21 14:29,968369,273369,490055,204945,968369
2023-04-21 14:31,968379,273377,490055,204947,968379
2023-04-21 14:32,968388,273383,490055,204950,968388
2023-04-21 14:33,968397,273391,490055,204951,968397
2023-04-21 14:34,968407,273398,490058,204951,968407
2023-04-21 14:35,968416,273407,490058,204951,968416
2023-04-21 14:36,968426,273415,490060,204951,968426
2023-04-21 14:37,968434,273422,490060,204952,968434
2023-04-21 14:38,968444,273430,490061,204953,968444
2023-04-21 14:39,968453,273436,490061,204956,968453
2023-04-21 14:40,968463,273442,490064,204957,968463
2023-04-21 14:41,968472,273449,490064,204959,968472
2023-04-21 14:42,968481,273457,490065,204959,968481
2023-04-21 14:43,968490,273466,490065,204959,968490
2023-04-21 14:44,968499,273472,490066,204961,968499
2023-04-21 14:45,968509,273480,490066,204963,968509
2023-04-21 14:46,968518,273484,490070,204964,968518
2023-04-21 14:47,968528,273491,490070,204967,968528
2023-04-21 14:48,968537,273495,490074,204968,968537
2023-04-21 14:49,968546,273503,490074,204969,968546
2023-04-21 14:50,968555,273507,490078,204970,968555
2023-04-21 14:51,968565,273515,490078,204972,968565
2023-04-21 14:52,968574,273521,490079,204974,968574
2023-04-21 14:53,968584,273530,490079,204975,968584
2023-04-21 14:54,968592,273533,490082,204977,968592
2023-04-21 14:55,968602,273541,490082,204979,968602
2023-04-21 14:56,968611,273546,490085,204980,968611
2023-04-21 14:57,968621,273555,490085,204981,968621
2023-04-21 14:58,968630,273558,490090,204982,968630
2023-04-21 14:59,968640,273566,490090,204984,968640
2023-04-21 15:00,968646,273568,490095,204983,968646
2023-04-21 15:01,968651,273572,490095,204984,968651
2023-04-21 15:02,968657,273577,490095,204985,968657
2023-04-21 15:03,968663,273581,490095,204987,968663
2023-04-21 15:04,968669,273586,490096,204987,968669
2023-04-21 15:05,968674,273587,490096,204991,968674
2023-04-21 15:06,968679,273590,490097,204992,968679
2023-04-21 15:07,968684,273593,490097,204994,968684
2023-04-21 15:08,968690,273592,490100,204998,968690
2023-04-21 15:09,968695,273597,490100,204998,968695
2023-04-21 15:10,968700,273601,490101,204998,968700
2023-04-21 15:11,968704,273603,490101,205000,968704
2023-04-21 15:12,968710,273607,490102,205001,968710
2023-04-21 15:13,968715,273609,490102,205004,968715
2023-04-21 15:14,968721,273608,490106,205007,968721
2023-04-21 15:16,968726,273613,490106,205007,968726
2023-04-21 15:17,968732,273616,490109,205007,968732
2023-04-21 15:18,968737,273620,490109,205008,968737
2023-04-21 15:19,968742,273621,490111,205010,968742
2023-04-21 15:20,968746,273622,490111,205013,968746
2023-04-21 15:21,968751,273625,490113,205013,968751
2023-04-21 15:22,968756,273629,490113,205014,968756
2023-04-21 15:23,968761,273630,490116,205015,968761
2023-04-21 15:24,968766,273635,490116,205015,968766
2023-04-21 15:25,968771,273638,490116,205017,968771
2023-04-21 15:26,968776,273641,490117,205018,968776
2023-04-21 15:27,968781,273645,490117,205019,968781
2023-04-21 15:28,968786,273647,490121,205018,968786
2023-04-21 15:29,968792,273652,490121,205019,968792
2023-04-21 15:30,968797,273651,490126,205020,968797
2023-04-21 15:31,968801,273653,490126,205022,968801
2023-04-21 15:32,968806,273653,490128,205025,968806
2023-04-21 15:33,968811,273655,490128,205028,968811
2023-04-21 15:34,968816,273656,490130,205030,968816
2023-04-21 15:35,968821,273660,490130,205031,968821
2023-04-21 15:36,968825,273659,490131,205035,968825
2023-04-21 15:37,968830,273662,490132,205036,968830
2023-04-21 15:38,968835,273663,490132,205040,968835
2023-04-21 15:39,968841,273665,490134,205042,968841
2023-04-21 15:40,968846,273670,490134,205042,968846
2023-04-21 15:41,968851,273673,490135,205043,968851
2023-04-21 15:42,968855,273675,490135,205045,968855
2023-04-21 15:43,968860,273679,490135,205046,968860
2023-04-21 15:44,968865,273684,490135,205046,968865
2023-04-21 15:45,968870,273688,490135,205047,968870
2023-04-21 15:46,968875,273691,490135,205049,968875
2023-04-21 15:47,968879,273695,490135,205049,968879
2023-04-21 15:48,968884,273699,490135,205050,968884
2023-04-21 15:49,968889,273702,490135,205052,968889
2023-04-21 15:50,968894,273705,490135,205054,968894
2023-04-21 15:51,968898,273695,490148,205055,968898
2023-04-21 15:52,968903,273694,490153,205056,968903
2023-04-21 15:53,968908,273698,490153,205057,968908
2023-04-21 15:54,968914,273700,490156,205058,968914
2023-04-21 15:55,968919,273703,490156,205060,968919
2023-04-21 15:56,968924,273703,490158,205063,968924
2023-04-21 15:57,968928,273705,490158,205065,968928
2023-04-21 15:58,968933,273709,490157,205067,968933
2023-04-21 15:59,968938,273712,490157,205069,968938
2023-04-21 16:00,968948,273712,490164,205072,968948
2023-04-21 16:01,968958,273719,490164,205075,968958
2023-04-21 16:03,968970,273731,490164,205075,968970
2023-04-21 16:04,968981,273740,490164,205077,968981
2023-04-21 16:05,968992,273745,490168,205079,968992
2023-04-21 16:06,969002,273753,490168,205081,969002
2023-04-21 16:07,969013,273761,490169,205083,969013
2023-04-21 16:08,969023,273770,490169,205084,969023
2023-04-21 16:09,969034,273775,490170,205089,969034
2023-04-21 16:10,969045,273785,490170,205090,969045
2023-04-21 16:11,969055,273790,490175,205090,969055
2023-04-21 16:12,969066,273801,490175,205090,969066
2023-04-21 16:13,969078,273809,490178,205091,969078
2023-04-21 16:14,969090,273820,490178,205092,969090
2023-04-21 16:15,969101,273831,490178,205092,969101
2023-04-21 16:16,969111,273839,490178,205094,969111
2023-04-21 16:17,969122,273847,490179,205096,969122
2023-04-21 16:18,969133,273857,490179,205097,969133
2023-04-21 16:19,969143,273864,490181,205098,969143
2023-04-21 16:20,969154,273873,490181,205100,969154
2023-04-21 16:21,969166,273879,490182,205105,969166
2023-04-21 16:22,969176,273886,490182,205108,969176
2023-04-21 16:23,969187,273891,490185,205111,969187
2023-04-21 16:24,969197,273898,490185,205114,969197
2023-04-21 16:25,969209,273909,490186,205114,969209
2023-04-21 16:26,969219,273917,490188,205114,969219
2023-04-21 16:27,969230,273927,490188,205115,969230
2023-04-21 16:28,969240,273935,490190,205115,969240
2023-04-21 16:29,969252,273944,490192,205116,969252
2023-04-21 16:30,969262,273952,490192,205118,969262
2023-04-21 16:31,969273,273960,490195,205118,969273
2023-04-21 16:32,969284,273969,490195,205120,969284
2023-04-21 16:33,969294,273975,490197,205122,969294
2023-04-21 16:34,969305,273982,490199,205124,969305
2023-04-21 16:35,969316,273989,490199,205128,969316
2023-04-21 16:36,969326,273992,490203,205131,969326
2023-04-21 16:37,969337,274001,490203,205133,969337
2023-04-21 16:38,969348,274010,490205,205133,969348
2023-04-21 16:39,969359,274018,490205,205136,969359
2023-04-21 16:40,969371,274026,490207,205138,969371
2023-04-21 16:41,969382,274037,490207,205138,969382
2023-04-21 16:42,969393,274041,490209,205143,969393
2023-04-21 16:43,969404,274049,490209,205146,969404
2023-04-21 16:44,969415,274056,490213,205146,969415
2023-04-21 16:46,969425,274062,490216,205147,969425
2023-04-21 16:47,969443,274078,490216,205149,969443
2023-04-21 16:48,969456,274088,490217,205151,969456
2023-04-21 16:49,969466,274096,490217,205153,969466
2023-04-21 16:50,969477,274105,490217,205155,969477
2023-04-21 16:51,969488,274115,490217,205156,969488
2023-04-21 16:52,969500,274124,490217,205159,969500
2023-04-21 16:53,969510,274129,490217,205164,969510
2023-04-21 16:54,969521,274132,490225,205164,969521
2023-04-21 16:56,969531,274137,490225,205169,969531
2023-04-21 16:57,969543,274143,490227,205173,969543
2023-04-21 16:58,969553,274150,490227,205176,969553
2023-04-21 16:59,969565,274155,490230,205180,969565
2023-04-21 17:00,969576,274163,490230,205183,969576
2023-04-21 17:01,969579,274164,490229,205186,969579
2023-04-21 17:02,969583,274166,490229,205188,969583
2023-04-21 17:03,969587,274167,490230,205190,969587
2023-04-21 17:04,969590,274161,490230,205199,969590
2023-04-21 17:05,969594,274159,490233,205202,969594
2023-04-21 17:06,969598,274162,490233,205203,969598
2023-04-21 17:07,969603,274163,490235,205205,969603
2023-04-21 17:08,969607,274167,490235,205205,969607
2023-04-21 17:09,969611,274168,490235,205208,969611
2023-04-21 17:10,969614,274170,490235,205209,969614
2023-04-21 17:11,969618,274170,490238,205210,969618
2023-04-21 17:12,969621,274170,490238,205213,969621
2023-04-21 17:13,969626,274169,490239,205218,969626
2023-04-21 17:14,969630,274172,490239,205219,969630
2023-04-21 17:15,969634,274168,490245,205221,969634
2023-04-21 17:16,969637,274168,490245,205224,969637
2023-04-21 17:17,969641,274172,490245,205224,969641
2023-04-21 17:18,969646,274172,490249,205225,969646
2023-04-21 17:19,969649,274172,490249,205228,969649
2023-04-21 17:20,969654,274170,490252,205232,969654
2023-04-21 17:21,969658,274166,490252,205240,969658
2023-04-21 17:22,969661,274163,490257,205241,969661
2023-04-21 17:23,969665,274165,490257,205243,969665
2023-04-21 17:24,969669,274163,490260,205246,969669
2023-04-21 17:25,969672,274163,490260,205249,969672
2023-04-21 17:26,969676,274165,490262,205249,969676
2023-04-21 17:27,969680,274167,490262,205251,969680
2023-04-21 17:28,969683,274166,490264,205253,969683
2023-04-21 17:29,969688,274168,490264,205256,969688
2023-04-21 17:30,969692,274163,490266,205263,969692
2023-04-21 17:31,969696,274166,490266,205264,969696
2023-04-21 17:32,969700,274164,490269,205267,969700
2023-04-21 17:33,969704,274166,490269,205269,969704
2023-04-21 17:34,969707,274164,490272,205271,969707
2023-04-21 17:35,969711,274161,490274,205276,969711
2023-04-21 17:36,969714,274161,490277,205276,969714
2023-04-21 17:37,969718,274162,490277,205279,969718
2023-04-21 17:38,969722,274159,490281,205282,969722
2023-04-21 17:39,969725,274158,490281,205286,969725
2023-04-21 17:40,969729,274161,490281,205287,969729
2023-04-21 17:41,969733,274161,490281,205291,969733
2023-04-21 17:43,969736,274161,490281,205294,969736
2023-04-21 17:44,969740,274162,490281,205297,969740
2023-04-21 17:45,969744,274163,490282,205299,969744
2023-04-21 17:46,969747,274165,490282,205300,969747
2023-04-21 17:47,969751,274160,490287,205304,969751
2023-04-21 17:48,969755,274164,490287,205304,969755
2023-04-21 17:49,969758,274161,490291,205306,969758
2023-04-21 17:50,969762,274159,490291,205312,969762
2023-04-21 17:51,969766,274159,490294,205313,969766
2023-04-21 17:52,969769,274162,490294,205313,969769
2023-04-21 17:53,969774,274165,490296,205313,969774
2023-04-21 17:54,969778,274166,490296,205316,969778
2023-04-21 17:55,969782,274169,490297,205316,969782
2023-04-21 17:56,969786,274169,490297,205320,969786
2023-04-21 17:57,969790,274168,490302,205320,969790
2023-04-21 17:58,969793,274164,490307,205322,969793
2023-04-21 17:59,969798,274168,490307,205323,969798
2023-04-21 18:00,969805,274167,490313,205325,969805
2023-04-21 18:01,969820,274181,490313,205326,969820
2023-04-21 18:02,969833,274192,490312,205329,969833
2023-04-21 18:03,969847,274202,490312,205333,969847
2023-04-21 18:04,969861,274213,490314,205334,969861
2023-04-21 18:05,969877,274227,490314,205336,969877
2023-04-21 18:06,969891,274235,490318,205338,969891
2023-04-21 18:07,969905,274246,490318,205341,969905
2023-04-21 18:08,969920,274255,490323,205342,969920
2023-04-21 18:09,969933,274262,490323,205348,969933
2023-04-21 18:10,969947,274272,490324,205351,969947
2023-04-21 18:11,969961,274282,490325,205354,969961
2023-04-21 18:12,969975,274295,490325,205355,969975
2023-04-21 18:13,969991,274307,490328,205356,969991
2023-04-21 18:14,970006,274321,490328,205357,970006
2023-04-21 18:15,970021,274331,490333,205357,970021
2023-04-21 18:16,970034,274343,490333,205358,970034
2023-04-21 18:17,970048,274349,490339,205360,970048
2023-04-21 18:18,970064,274359,490342,205363,970064
2023-04-21 18:19,970080,274375,490342,205363,970080
2023-04-21 18:20,970094,274388,490342,205364,970094
2023-04-21 18:21,970108,274400,490342,205366,970108
2023-04-21 18:22,970122,274409,490342,205371,970122
2023-04-21 18:23,970136,274412,490351,205373,970136
2023-04-21 18:24,970151,274424,490351,205376,970151
2023-04-21 18:25,970165,274432,490352,205381,970165
2023-04-21 18:26,970179,274444,490352,205383,970179
2023-04-21 18:27,970193,274455,490354,205384,970193
2023-04-21 18:28,970207,274467,490354,205386,970207
2023-04-21 18:29,970221,274477,490358,205386,970221
2023-04-21 18:31,970236,274491,490358,205387,970236
2023-04-21 18:32,970251,274501,490361,205389,970251
2023-04-21 18:33,970265,274511,490361,205393,970265
2023-04-21 18:34,970278,274511,490372,205395,970278
2023-04-21 18:35,970292,274523,490372,205397,970292
2023-04-21 18:36,970306,274524,490381,205401,970306
2023-04-21 18:37,970321,274536,490383,205402,970321
2023-04-21 18:38,970335,274545,490383,205407,970335
2023-04-21 18:39,970351,274551,490389,205411,970351
2023-04-21 18:40,970366,274559,490394,205413,970366
2023-04-21 18:41,970380,274571,490394,205415,970380
2023-04-21 18:42,970394,274575,490404,205415,970394
2023-04-21 18:43,970407,274585,490404,205418,970407
2023-04-21 18:44,970421,274589,490413,205419,970421
2023-04-21 18:45,970436,274599,490415,205422,970436
2023-04-21 18:46,970451,274611,490415,205425,970451
2023-04-21 18:47,970466,274608,490427,205431,970466
2023-04-21 18:48,970480,274618,490427,205435,970480
2023-04-21 18:49,970495,274627,490432,205436,970495
2023-04-21 18:50,970510,274639,490432,205439,970510
2023-04-21 18:51,970525,274645,490440,205440,970525
2023-04-21 18:52,970542,274662,490440,205440,970542
2023-04-21 18:53,970556,274667,490447,205442,970556
2023-04-21 18:54,970571,274680,490447,205444,970571
2023-04-21 18:55,970585,274683,490454,205448,970585
2023-04-21 18:56,970600,274693,490454,205453,970600
2023-04-21 18:57,970613,274691,490467,205455,970613
2023-04-21 18:58,970627,274703,490467,205457,970627
2023-04-21 18:59,970641,274713,490467,205461,970641
2023-04-21 19:00,970651,274721,490467,205463,970651
2023-04-21 19:01,970658,274726,490467,205465,970658
2023-04-21 19:02,970664,274717,490482,205465,970664
2023-04-21 19:03,970672,274721,490482,205469,970672
2023-04-21 19:04,970679,274725,490482,205472,970679
2023-04-21 19:05,970686,274722,490490,205474,970686
2023-04-21 19:06,970693,274726,490490,205477,970693
2023-04-21 19:07,970700,274728,490494,205478,970700
2023-04-21 19:08,970708,274732,490494,205482,970708
2023-04-21 19:09,970715,274726,490503,205486,970715
2023-04-21 19:10,970722,274731,490503,205488,970722
2023-04-21 19:11,970730,274727,490514,205489,970730
2023-04-21 19:12,970737,274722,490520,205495,970737
2023-04-21 19:13,970743,274723,490520,205500,970743
2023-04-21 19:14,970751,274726,490523,205502,970751
2023-04-21 19:15,970759,274732,490523,205504,970759
2023-04-21 19:16,970766,274731,490531,205504,970766
2023-04-21 19:17,970772,274734,490531,205507,970772
2023-04-21 19:19,970780,274734,490536,205510,970780
2023-04-21 19:20,970787,274737,490539,205511,970787
2023-04-21 19:21,970794,274741,490539,205514,970794
2023-04-21 19:22,970802,274741,490545,205516,970802
2023-04-21 19:23,970810,274743,490545,205522,970810
2023-04-21 19:24,970817,274742,490553,205522,970817
2023-04-21 19:25,970825,274750,490553,205522,970825
2023-04-21 19:26,970833,274752,490557,205524,970833
2023-04-21 19:27,970841,274752,490561,205528,970841
2023-04-21 19:28,970848,274753,490566,205529,970848
2023-04-21 19:29,970856,274760,490566,205530,970856
2023-04-21 19:30,970864,274753,490575,205536,970864
2023-04-21 19:31,970870,274754,490575,205541,970870
2023-04-21 19:32,970877,274758,490576,205543,970877
2023-04-21 19:33,970883,274755,490580,205548,970883
2023-04-21 19:34,970890,274752,490585,205553,970890
2023-04-21 19:35,970898,274759,490585,205554,970898
2023-04-21 19:36,970907,274759,490589,205559,970907
2023-04-21 19:37,970913,274765,490589,205559,970913
2023-04-21 19:38,970921,274771,490589,205561,970921
2023-04-21 19:39,970929,274777,490589,205563,970929
2023-04-21 19:40,970936,274777,490594,205565,970936
2023-04-21 19:41,970943,274780,490594,205569,970943
2023-04-21 19:42,970952,274787,490596,205569,970952
2023-04-21 19:43,970959,274793,490596,205570,970959
2023-04-21 19:44,970968,274796,490600,205572,970968
2023-04-21 19:45,970974,274801,490600,205573,970974
2023-04-21 19:46,970982,274800,490606,205576,970982
2023-04-21 19:47,970989,274804,490606,205579,970989
2023-04-21 19:48,970997,274801,490613,205583,970997
2023-04-21 19:49,971005,274802,490616,205587,971005
2023-04-21 19:50,971012,274807,490616,205589,971012
2023-04-21 19:51,971019,274804,490625,205590,971019
2023-04-21 19:52,971026,274809,490625,205592,971026
2023-04-21 19:53,971033,274805,490634,205594,971033
2023-04-21 19:54,971040,274809,490634,205597,971040
2023-04-21 19:55,971047,274809,490640,205598,971047
2023-04-21 19:56,971054,274810,490640,205604,971054
2023-04-21 19:57,971060,274808,490645,205607,971060
2023-04-21 19:58,971067,274810,490645,205612,971067
2023-04-21 19:59,971076,274814,490647,205615,971076
2023-04-21 20:00,971086,274822,490647,205617,971086
2023-04-21 20:01,971097,274821,490655,205621,971097
2023-04-21 20:02,971109,274834,490655,205620,971109
2023-04-21 20:03,971119,274839,490657,205623,971119
2023-04-21 20:05,971130,274846,490657,205627,971130
2023-04-21 20:06,971141,274851,490661,205629,971141
2023-04-21 20:07,971152,274861,490661,205630,971152
2023-04-21 20:08,971163,274859,490670,205634,971163
2023-04-21 20:09,971173,274869,490670,205634,971173
2023-04-21 20:10,971184,274872,490674,205638,971184
2023-04-21 20:11,971196,274883,490674,205639,971196
2023-04-21 20:12,971208,274888,490679,205641,971208
2023-04-21 20:13,971220,274897,490679,205644,971220
2023-04-21 20:14,971231,274898,490685,205648,971231
2023-04-21 20:15,971242,274907,490685,205650,971242
2023-04-21 20:16,971253,274909,490689,205655,971253
2023-04-21 20:17,971264,274918,490689,205657,971264
2023-04-21 20:18,971275,274924,490693,205658,971275
2023-04-21 20:19,971286,274929,490694,205663,971286
2023-04-21 20:20,971297,274937,490693,205667,971297
2023-04-21 20:21,971309,274946,490695,205668,971309
2023-04-21 20:22,971321,274954,490695,205672,971321
2023-04-21 20:23,971332,274956,490701,205675,971332
2023-04-21 20:24,971343,274961,490704,205678,971343
2023-04-21 20:25,971353,274968,490707,205678,971353
2023-04-21 20:26,971364,274974,490710,205680,971364
2023-04-21 20:27,971375,274984,490710,205681,971375
2023-04-21 20:28,971386,274989,490712,205685,971386
2023-04-21 20:29,971399,275000,490712,205687,971399
2023-04-21 20:30,971410,275004,490719,205687,971410
2023-04-21 20:31,971421,275012,490719,205690,971421
2023-04-21 20:32,971431,275016,490724,205691,971431
2023-04-21 20:33,971442,275024,490724,205694,971442
2023-04-21 20:34,971453,275032,490727,205694,971453
2023-04-21 20:35,971465,275040,490727,205698,971465
2023-04-21 20:36,971476,275045,490728,205703,971476
2023-04-21 20:37,971487,275053,490728,205706,971487
2023-04-21 20:38,971499,275059,490733,205707,971499
2023-04-21 20:39,971511,275067,490733,205711,971511
2023-04-21 20:40,971522,275072,490737,205713,971522
2023-04-21 20:41,971533,275081,490737,205715,971533
2023-04-21 20:42,971544,275086,490741,205717,971544
2023-04-21 20:43,971554,275093,490741,205720,971554
2023-04-21 20:44,971566,275098,490749,205719,971566
2023-04-21 20:45,971578,275109,490749,205720,971578
2023-04-21 20:46,971589,275113,490755,205721,971589
2023-04-21 20:47,971600,275122,490755,205723,971600
2023-04-21 20:48,971611,275126,490759,205726,971611
2023-04-21 20:49,971621,275134,490759,205728,971621
2023-04-21 20:50,971634,275140,490764,205730,971634
2023-04-21 20:52,971645,275149,490764,205732,971645
2023-04-21 20:53,971655,275153,490770,205732,971655
2023-04-21 20:54,971666,275160,490770,205736,971666
2023-04-21 20:55,971678,275167,490774,205737,971678
2023-04-21 20:56,971689,275176,490774,205739,971689
2023-04-21 20:57,971701,275179,490776,205746,971701
2023-04-21 20:58,971711,275184,490776,205751,971711
2023-04-21 20:59,971723,275188,490781,205754,971723
2023-04-21 21:00,971733,275195,490781,205757,971733
2023-04-21 21:01,971740,275201,490781,205758,971740
2023-04-21 21:02,971746,275205,490781,205760,971746
2023-04-21 21:03,971753,275202,490789,205762,971753
2023-04-21 21:04,971761,275208,490789,205764,971761
2023-04-21 21:05,971767,275210,490792,205765,971767
2023-04-21 21:06,971773,275213,490792,205768,971773
2023-04-21 21:07,971780,275217,490793,205770,971780
2023-04-21 21:08,971787,275222,490793,205772,971787
2023-04-21 21:09,971795,275224,490798,205773,971795
2023-04-21 21:10,971802,275229,490798,205775,971802
2023-04-21 21:11,971808,275229,490800,205779,971808
2023-04-21 21:12,971814,275232,490802,205780,971814
2023-04-21 21:13,971823,275237,490802,205784,971823
2023-04-21 21:14,971829,275235,490806,205788,971829
2023-04-21 21:15,971836,275233,490812,205791,971836
2023-04-21 21:16,971842,275238,490812,205792,971842
2023-04-21 21:17,971849,275239,490815,205795,971849
2023-04-21 21:18,971856,275244,490815,205797,971856
2023-04-21 21:19,971862,275243,490819,205800,971862
2023-04-21 21:20,971869,275249,490820,205800,971869
2023-04-21 21:21,971875,275255,490820,205800,971875
2023-04-21 21:22,971881,275256,490823,205802,971881
2023-04-21 21:23,971888,275256,490823,205809,971888
2023-04-21 21:24,971894,275254,490827,205813,971894
2023-04-21 21:25,971900,275260,490827,205813,971900
2023-04-21 21:26,971906,275257,490831,205818,971906
2023-04-21 21:27,971914,275262,490831,205821,971914
2023-04-21 21:28,971921,275264,490835,205822,971921
2023-04-21 21:29,971927,275268,490835,205824,971927
2023-04-21 21:30,971935,275269,490839,205827,971935
2023-04-21 21:31,971941,275274,490839,205828,971941
2023-04-21 21:32,971948,275271,490846,205831,971948
2023-04-21 21:33,971957,275278,490846,205833,971957
2023-04-21 21:34,971963,275280,490849,205834,971963
2023-04-21 21:35,971970,275274,490857,205839,971970
2023-04-21 21:36,971977,275278,490857,205842,971977
2023-04-21 21:37,971983,275276,490861,205846,971983
2023-04-21 21:39,971990,275279,490861,205850,971990
2023-04-21 21:40,971996,275277,490864,205855,971996
2023-04-21 21:41,972003,275280,490864,205859,972003
2023-04-21 21:42,972010,275284,490865,205861,972010
2023-04-21 21:43,972016,275289,490865,205862,972016
2023-04-21 21:44,972022,275286,490869,205867,972022
2023-04-21 21:45,972028,275287,490869,205872,972028
2023-04-21 21:46,972035,275288,490872,205875,972035
2023-04-21 21:47,972041,275292,490872,205877,972041
2023-04-21 21:48,972048,275296,490874,205878,972048
2023-04-21 21:49,972055,275298,490874,205883,972055
2023-04-21 21:50,972063,275296,490880,205887,972063
2023-04-21 21:51,972070,275301,490880,205889,972070
2023-04-21 21:52,972076,275299,490884,205893,972076
2023-04-21 21:53,972083,275304,490884,205895,972083
2023-04-21 21:54,972089,275300,490889,205900,972089
2023-04-21 21:55,972096,275303,490889,205904,972096
2023-04-21 21:56,972103,275302,490893,205908,972103
2023-04-21 21:57,972112,275307,490893,205912,972112
2023-04-21 21:58,972118,275303,490897,205918,972118
2023-04-21 21:59,972126,275309,490897,205920,972126
2023-04-21 22:00,972131,275303,490904,205924,972131
2023-04-21 22:01,972135,275304,490906,205925,972135
2023-04-21 22:02,972138,275303,490906,205929,972138
2023-04-21 22:03,972142,275304,490907,205931,972142
2023-04-21 22:04,972146,275306,490907,205933,972146
2023-04-21 22:05,972150,275307,490909,205934,972150
2023-04-21 22:06,972155,275310,490909,205936,972155
2023-04-21 22:07,972158,275310,490911,205937,972158
2023-04-21 22:08,972161,275313,490911,205937,972161
2023-04-21 22:09,972165,275313,490915,205937,972165
2023-04-21 22:10,972169,275312,490915,205942,972169
2023-04-21 22:11,972173,275306,490917,205950,972173
2023-04-21 22:12,972177,275299,490921,205957,972177
2023-04-21 22:13,972181,275300,490921,205960,972181
2023-04-21 22:14,972185,275293,490928,205964,972185
2023-04-21 22:15,972188,275289,490931,205968,972188
2023-04-21 22:16,972193,275292,490931,205970,972193
2023-04-21 22:17,972196,275286,490933,205977,972196
2023-04-21 22:18,972199,275284,490933,205982,972199
2023-04-21 22:19,972203,275281,490939,205983,972203
2023-04-21 22:20,972207,275279,490942,205986,972207
2023-04-21 22:21,972210,275277,490942,205991,972210
2023-04-21 22:22,972214,275277,490943,205994,972214
2023-04-21 22:23,972218,275279,490943,205996,972218
2023-04-21 22:24,972221,275272,490948,206001,972221
2023-04-21 22:26,972224,275270,490952,206002,972224
2023-04-21 22:27,972228,275267,490952,206009,972228
2023-04-21 22:28,972231,275256,490962,206013,972231
2023-04-21 22:29,972234,275255,490962,206017,972234
2023-04-21 22:30,972238,275252,490966,206020,972238
2023-04-21 22:31,972242,275254,490966,206022,972242
2023-04-21 22:32,972245,275252,490967,206026,972245
2023-04-21 22:33,972250,275251,490970,206029,972250
2023-04-21 22:34,972253,275242,490977,206034,972253
2023-04-21 22:35,972257,275243,490977,206037,972257
2023-04-21 22:36,972260,275245,490976,206039,972260
2023-04-21 22:37,972264,275246,490976,206042,972264
2023-04-21 22:38,972268,275245,490980,206043,972268
2023-04-21 22:39,972271,275246,490980,206045,972271
2023-04-21 22:40,972275,275244,490983,206048,972275
2023-04-21 22:41,972279,275245,490983,206051,972279
2023-04-21 22:42,972282,275237,490991,206054,972282
2023-04-21 22:43,972286,275240,490991,206055,972286
2023-04-21 22:44,972289,275238,490995,206056,972289
2023-04-21 22:45,972292,275236,490995,206061,972292
2023-04-21 22:46,972297,275235,490999,206063,972297
2023-04-21 22:47,972300,275236,490999,206065,972300
2023-04-21 22:48,972303,275230,491002,206071,972303
2023-04-21 22:49,972306,275230,491004,206072,972306
2023-04-21 22:50,972310,275229,491004,206077,972310
2023-04-21 22:51,972313,275227,491004,206082,972313
2023-04-21 22:52,972317,275225,491008,206084,972317
2023-04-21 22:53,972321,275222,491008,206091,972321
2023-04-21 22:54,972324,275217,491015,206092,972324
2023-04-21 22:55,972328,275221,491015,206092,972328
2023-04-21 22:56,972332,275220,491017,206095,972332
2023-04-21 22:57,972335,275218,491017,206100,972335
2023-04-21 22:58,972340,275221,491018,206101,972340
2023-04-21 22:59,972345,275224,491018,206103,972345
2023-04-21 23:00,972353,275226,491021,206106,972353
2023-04-21 23:01,972363,275233,491021,206109,972363
2023-04-21 23:02,972373,275234,491026,206113,972373
2023-04-21 23:03,972382,275241,491026,206115,972382
2023-04-21 23:04,972392,275245,491032,206115,972392
2023-04-21 23:05,972403,275250,491032,206121,972403
2023-04-21 23:06,972412,275249,491037,206126,972412
2023-04-21 23:07,972422,275258,491037,206127,972422
2023-04-21 23:08,972435,275265,491043,206127,972435
2023-04-21 23:09,972444,275271,491043,206130,972444
2023-04-21 23:10,972454,275272,491051,206131,972454
2023-04-21 23:11,972464,275282,491051,206131,972464
2023-04-21 23:13,972474,275285,491054,206135,972474
2023-04-21 23:14,972483,275293,491054,206136,972483
2023-04-21 23:15,972493,275297,491057,206139,972493
2023-04-21 23:16,972503,275304,491057,206142,972503
2023-04-21 23:17,972512,275306,491060,206146,972512
2023-04-21 23:18,972522,275313,491060,206149,972522
2023-04-21 23:19,972532,275316,491064,206152,972532
2023-04-21 23:20,972542,275321,491067,206154,972542
2023-04-21 23:21,972554,275329,491067,206158,972554
2023-04-21 23:22,972563,275324,491078,206161,972563
2023-04-21 23:23,972573,275333,491078,206162,972573
2023-04-21 23:24,972582,275329,491086,206167,972582
2023-04-21 23:25,972591,275333,491086,206172,972591
2023-04-21 23:26,972600,275335,491089,206176,972600
2023-04-21 23:27,972610,275343,491089,206178,972610
2023-04-21 23:28,972619,275341,491094,206184,972619
2023-04-21 23:29,972629,275349,491094,206186,972629
2023-04-21 23:30,972638,275354,491096,206188,972638
2023-04-21 23:31,972648,275360,491096,206192,972648
2023-04-21 23:32,972657,275362,491099,206196,972657
2023-04-21 23:33,972668,275371,491099,206198,972668
2023-04-21 23:34,972679,275369,491106,206204,972679
2023-04-21 23:35,972688,275374,491106,206208,972688
2023-04-21 23:36,972697,275379,491110,206208,972697
2023-04-21 23:37,972707,275385,491110,206212,972707
2023-04-21 23:38,972716,275390,491111,206215,972716
2023-04-21 23:39,972725,275396,491111,206218,972725
2023-04-21 23:40,972736,275402,491114,206220,972736
2023-04-21 23:41,972746,275407,491114,206225,972746
2023-04-21 23:42,972756,275412,491116,206228,972756
2023-04-21 23:43,972765,275418,491116,206231,972765
2023-04-21 23:44,972774,275422,491117,206235,972774
2023-04-21 23:45,972784,275425,491120,206239,972784
2023-04-21 23:46,972793,275431,491120,206242,972793
2023-04-21 23:47,972803,275432,491123,206248,972803
2023-04-21 23:48,972812,275440,491123,206249,972812
2023-04-21 23:49,972821,275441,491130,206250,972821
2023-04-21 23:50,972831,275449,491130,206252,972831
2023-04-21 23:51,972840,275456,491130,206254,972840
2023-04-21 23:52,972849,275465,491130,206254,972849
2023-04-21 23:53,972859,275473,491130,206256,972859
2023-04-21 23:54,972868,275482,491130,206256,972868
2023-04-21 23:55,972878,275490,491130,206258,972878
2023-04-21 23:56,972887,275495,491130,206262,972887
2023-04-21 23:57,972897,275504,491130,206263,972897
2023-04-21 23:58,972907,275510,491130,206267,972907
2023-04-22 00:00,972916,275497,491148,206271,972916
2023-04-22 00:01,972931,275512,491148,206271,972931
2023-04-22 00:02,972946,275524,491151,206271,972946
2023-04-22 00:03,972962,275537,491151,206274,972962
2023-04-22 00:04,972979,275545,491157,206277,972979
2023-04-22 00:05,972995,275559,491157,206279,972995
2023-04-22 00:06,973011,275571,491159,206281,973011
2023-04-22 00:07,973028,275582,491162,206284,973028
2023-04-22 00:08,973043,275595,491162,206286,973043
2023-04-22 00:09,973059,275604,491167,206288,973059
2023-04-22 00:10,973074,275614,491167,206293,973074
2023-04-22 00:11,973089,275621,491171,206297,973089
2023-04-22 00:12,973106,275638,491171,206297,973106
2023-04-22 00:13,973122,275651,491173,206298,973122
2023-04-22 00:14,973137,275662,491173,206302,973137
2023-04-22 00:15,973153,275673,491173,206307,973153
2023-04-22 00:16,973170,275686,491173,206311,973170
2023-04-22 00:17,973186,275693,491178,206315,973186
2023-04-22 00:18,973201,275705,491178,206318,973201
2023-04-22 00:19,973218,275712,491185,206321,973218
2023-04-22 00:20,973235,275727,491185,206323,973235
2023-04-22 00:21,973253,275742,491188,206323,973253
2023-04-22 00:22,973269,275757,491188,206324,973269
2023-04-22 00:23,973284,275767,491190,206327,973284
2023-04-22 00:24,973300,275779,491190,206331,973300
2023-04-22 00:25,973315,275786,491198,206331,973315
2023-04-22 00:26,973332,275800,491198,206334,973332
2023-04-22 00:27,973347,275811,491200,206336,973347
2023-04-22 00:28,973363,275821,491205,206337,973363
2023-04-22 00:29,973379,275833,491207,206339,973379
2023-04-22 00:30,973394,275847,491207,206340,973394
2023-04-22 00:31,973410,275858,491210,206342,973410
2023-04-22 00:32,973426,275868,491210,206348,973426
2023-04-22 00:33,973443,275883,491212,206348,973443
2023-04-22 00:34,973459,275898,491212,206349,973459
2023-04-22 00:35,973474,275907,491215,206352,973474
2023-04-22 00:36,973490,275921,491215,206354,973490
2023-04-22 00:37,973505,275930,491218,206357,973505
2023-04-22 00:38,973521,275945,491218,206358,973521
2023-04-22 00:39,973536,275953,491222,206361,973536
2023-04-22 00:40,973552,275967,491222,206363,973552
2023-04-22 00:41,973568,275982,491223,206363,973568
2023-04-22 00:42,973584,275996,491223,206365,973584
2023-04-22 00:43,973600,276009,491224,206367,973600
2023-04-22 00:44,973616,276023,491224,206369,973616
2023-04-22 00:45,973631,276033,491228,206370,973631
2023-04-22 00:46,973647,276044,491228,206375,973647
2023-04-22 00:47,973662,276052,491230,206380,973662
2023-04-22 00:49,973678,276065,491230,206383,973678
2023-04-22 00:50,973693,276074,491236,206383,973693
2023-04-22 00:51,973710,276089,491236,206385,973710
2023-04-22 00:52,973727,276100,491240,206387,973727
2023-04-22 00:53,973742,276113,491240,206389,973742
2023-04-22 00:54,973758,276120,491247,206391,973758
2023-04-22 00:55,973775,276134,491247,206394,973775
2023-04-22 00:56,973791,276144,491250,206397,973791
2023-04-22 00:57,973807,276159,491250,206398,973807
2023-04-22 00:58,973823,276169,491254,206400,973823
2023-04-22 00:59,973839,276182,491254,206403,973839
2023-04-22 01:00,973853,276189,491258,206406,973853
2023-04-22 01:01,973866,276200,491258,206408,973866
2023-04-22 01:02,973878,276206,491262,206410,973878
2023-04-22 01:03,973890,276216,491262,206412,973890
2023-04-22 01:04,973902,276224,491263,206415,973902
2023-04-22 01:05,973914,276235,491263,206416,973914
2023-04-22 01:06,973926,276244,491264,206418,973926
2023-04-22 01:07,973938,276255,491264,206419,973938
2023-04-22 01:08,973950,276264,491264,206422,973950
2023-04-22 01:09,973962,276277,491264,206421,973962
2023-04-22 01:10,973975,276284,491269,206422,973975
2023-04-22 01:11,973987,276291,491269,206427,973987
2023-04-22 01:12,973999,276299,491272,206428,973999
2023-04-22 01:13,974012,276311,491272,206429,974012
2023-04-22 01:14,974024,276322,491272,206430,974024
2023-04-22 01:15,974036,276334,491272,206430,974036
2023-04-22 01:16,974048,276342,491274,206432,974048
2023-04-22 01:17,974062,276356,491274,206432,974062
2023-04-22 01:18,974074,276365,491275,206434,974074
2023-04-22 01:19,974086,276373,491277,206436,974086
2023-04-22 01:20,974098,276384,491277,206437,974098
2023-04-22 01:21,974110,276388,491283,206439,974110
2023-04-22 01:22,974123,276401,491283,206439,974123
2023-04-22 01:23,974135,276413,491283,206439,974135
2023-04-22 01:24,974148,276424,491283,206441,974148
2023-04-22 01:25,974163,276437,491283,206443,974163
2023-04-22 01:26,974175,276448,491283,206444,974175
2023-04-22 01:27,974187,276456,491286,206445,974187
2023-04-22 01:28,974200,276466,491286,206448,974200
2023-04-22 01:29,974212,276473,491288,206451,974212
2023-04-22 01:30,974224,276484,491289,206451,974224
2023-04-22 01:31,974237,276497,491289,206451,974237
2023-04-22 01:32,974248,276503,491292,206453,974248
2023-04-22 01:33,974261,276514,491292,206455,974261
2023-04-22 01:34,974273,276523,491295,206455,974273
2023-04-22 01:35,974285,276533,491295,206457,974285
2023-04-22 01:37,974297,276538,491301,206458,974297
2023-04-22 01:38,974309,276546,491301,206462,974309
2023-04-22 01:39,974321,276554,491302,206465,974321
2023-04-22 01:40,974333,276566,491302,206465,974333
2023-04-22 01:41,974346,276574,491305,206467,974346
2023-04-22 01:42,974358,276586,491305,206467,974358
2023-04-22 01:43,974371,276595,491308,206468,974371
2023-04-22 01:44,974383,276604,491308,206471,974383
2023-04-22 01:45,974395,276614,491310,206471,974395
2023-04-22 01:46,974408,276624,491310,206474,974408
2023-04-22 01:47,974421,276638,491309,206474,974421
2023-04-22 01:48,974433,276650,491309,206474,974433
2023-04-22 01:49,974445,276657,491314,206474,974445
2023-04-22 01:50,974457,276667,491315,206475,974457
2023-04-22 01:51,974469,276679,491315,206475,974469
2023-04-22 01:52,974482,276688,491317,206477,974482
2023-04-22 01:53,974494,276699,491317,206478,974494
2023-04-22 01:54,974506,276702,491321,206483,974506
2023-04-22 01:55,974518,276711,491322,206485,974518
2023-04-22 01:56,974530,276720,491323,206487,974530
2023-04-22 01:57,974542,276732,491323,206487,974542
2023-04-22 01:58,974555,276743,491325,206487,974555
2023-04-22 01:59,974567,276755,491325,206487,974567
2023-04-22 02:00,974579,276767,491325,206487,974579
2023-04-22 02:01,974590,276778,491325,206487,974590
2023-04-22 02:02,974600,276787,491326,206487,974600
2023-04-22 02:03,974610,276796,491326,206488,974610
2023-04-22 02:04,974620,276803,491329,206488,974620
2023-04-22 02:05,974630,276812,491329,206489,974630
2023-04-22 02:06,974640,276819,491332,206489,974640
2023-04-22 02:07,974651,276826,491334,206491,974651
2023-04-22 02:08,974661,276836,491334,206491,974661
2023-04-22 02:09,974671,276843,491336,206492,974671
2023-04-22 02:10,974681,276850,491336,206495,974681
2023-04-22 02:11,974691,276858,491338,206495,974691
2023-04-22 02:12,974701,276867,491338,206496,974701
2023-04-22 02:13,974711,276872,491342,206497,974711
2023-04-22 02:14,974721,276880,491343,206498,974721
2023-04-22 02:15,974731,276888,491343,206500,974731
2023-04-22 02:16,974742,276895,491344,206503,974742
2023-04-22 02:17,974752,276904,491344,206504,974752
2023-04-22 02:18,974762,276912,491344,206506,974762
2023-04-22 02:19,974772,276921,491344,206507,974772
2023-04-22 02:20,974782,276930,491345,206507,974782
2023-04-22 02:21,974792,276939,491345,206508,974792
2023-04-22 02:22,974802,276947,491347,206508,974802
2023-04-22 02:23,974812,276957,491347,206508,974812
2023-04-22 02:24,974822,276967,491347,206508,974822
2023-04-22 02:26,974832,276974,491347,206511,974832
2023-04-22 02:27,974843,276984,491348,206511,974843
2023-04-22 02:28,974853,276994,491348,206511,974853
2023-04-22 02:29,974864,277004,491349,206511,974864
2023-04-22 02:30,974874,277013,491349,206512,974874
2023-04-22 02:31,974884,277022,491350,206512,974884
2023-04-22 02:32,974894,277032,491350,206512,974894
2023-04-22 02:33,974904,277041,491350,206513,974904
2023-04-22 02:34,974914,277050,491350,206514,974914
2023-04-22 02:35,974924,277060,491350,206514,974924
2023-04-22 02:36,974934,277068,491350,206516,974934
2023-04-22 02:37,974944,277076,491352,206516,974944
2023-04-22 02:38,974953,277084,491352,206517,974953
2023-04-22 02:39,974964,277091,491354,206519,974964
2023-04-22 02:40,974974,277101,491354,206519,974974
2023-04-22 02:41,974984,277110,491355,206519,974984
2023-04-22 02:42,974994,277120,491355,206519,974994
2023-04-22 02:43,975004,277126,491359,206519,975004
2023-04-22 02:44,975014,277134,491359,206521,975014
2023-04-22 02:45,975026,277143,491361,206522,975026
2023-04-22 02:46,975035,277149,491361,206525,975035
2023-04-22 02:47,975045,277155,491363,206527,975045
2023-04-22 02:48,975055,277165,491363,206527,975055
2023-04-22 02:49,975066,277175,491364,206527,975066
2023-04-22 02:50,975075,277183,491364,206528,975075
2023-04-22 02:51,975085,277193,491364,206528,975085
2023-04-22 02:52,975096,277203,491364,206529,975096
2023-04-22 02:53,975105,277210,491364,206531,975105
2023-04-22 02:54,975115,277219,491364,206532,975115
2023-04-22 02:55,975126,277228,491366,206532,975126
2023-04-22 02:56,975136,277237,491366,206533,975136
2023-04-22 02:57,975146,277243,491369,206534,975146
2023-04-22 02:58,975156,277252,491369,206535,975156
2023-04-22 02:59,975166,277260,491369,206537,975166
2023-04-22 03:00,975177,277271,491369,206537,975177
2023-04-22 03:01,975189,277282,491370,206537,975189
2023-04-22 03:02,975201,277292,491370,206539,975201
2023-04-22 03:03,975212,277301,491372,206539,975212
2023-04-22 03:04,975224,277313,491372,206539,975224
2023-04-22 03:05,975236,277323,491374,206539,975236
2023-04-22 03:06,975247,277333,491374,206540,975247
2023-04-22 03:07,975259,277343,491374,206542,975259
2023-04-22 03:08,975271,277354,491374,206543,975271
2023-04-22 03:09,975284,277366,491374,206544,975284
2023-04-22 03:10,975296,277377,491374,206545,975296
2023-04-22 03:11,975307,277386,491376,206545,975307
2023-04-22 03:12,975319,277397,491376,206546,975319
2023-04-22 03:14,975330,277407,491377,206546,975330
2023-04-22 03:15,975342,277418,491377,206547,975342
2023-04-22 03:16,975355,277430,491378,206547,975355
2023-04-22 03:17,975366,277439,491378,206549,975366
2023-04-22 03:18,975378,277447,491382,206549,975378
2023-04-22 03:19,975391,277460,491382,206549,975391
2023-04-22 03:20,975403,277471,491382,206550,975403
2023-04-22 03:21,975414,277481,491382,206551,975414
2023-04-22 03:22,975427,277494,491382,206551,975427
2023-04-22 03:23,975438,277504,491382,206552,975438
2023-04-22 03:24,975450,277516,491382,206552,975450
2023-04-22 03:25,975462,277528,491382,206552,975462
2023-04-22 03:26,975473,277535,491384,206554,975473
2023-04-22 03:27,975486,277548,491384,206554,975486
2023-04-22 03:28,975498,277558,491385,206555,975498
2023-04-22 03:29,975509,277569,491385,206555,975509
2023-04-22 03:30,975521,277579,491386,206556,975521
2023-04-22 03:31,975533,277591,491386,206556,975533
2023-04-22 03:32,975544,277601,491387,206556,975544
2023-04-22 03:33,975556,277613,491387,206556,975556
2023-04-22 03:34,975568,277622,491390,206556,975568
2023-04-22 03:35,975580,277633,491390,206557,975580
2023-04-22 03:36,975592,277642,491390,206560,975592
2023-04-22 03:37,975603,277650,491393,206560,975603
2023-04-22 03:38,975615,277662,491393,206560,975615
2023-04-22 03:39,975627,277672,491395,206560,975627
2023-04-22 03:40,975638,277683,491395,206560,975638
2023-04-22 03:41,975650,277695,491395,206560,975650
2023-04-22 03:42,975662,277707,491395,206560,975662
2023-04-22 03:43,975673,277718,491395,206560,975673
2023-04-22 03:44,975685,277730,491395,206560,975685
2023-04-22 03:45,975697,277742,491395,206560,975697
2023-04-22 03:46,975709,277754,491395,206560,975709
2023-04-22 03:47,975721,277763,491397,206561,975721
2023-04-22 03:48,975732,277774,491397,206561,975732
2023-04-22 03:49,975744,277786,491397,206561,975744
2023-04-22 03:50,975755,277797,491397,206561,975755
2023-04-22 03:51,975768,277808,491399,206561,975768
2023-04-22 03:52,975779,277819,491399,206561,975779
2023-04-22 03:53,975791,277830,491400,206561,975791
2023-04-22 03:54,975803,277841,491400,206562,975803
2023-04-22 03:55,975814,277851,491401,206562,975814
2023-04-22 03:56,975826,277863,491401,206562,975826
2023-04-22 03:57,975838,277874,491402,206562,975838
2023-04-22 03:58,975849,277885,491402,206562,975849
2023-04-22 03:59,975862,277898,491402,206562,975862
2023-04-22 04:00,975873,277909,491402,206562,975873
2023-04-22 04:02,975883,277919,491402,206562,975883
2023-04-22 04:03,975895,277931,491402,206562,975895
2023-04-22 04:04,975906,277941,491403,206562,975906
2023-04-22 04:05,975918,277953,491403,206562,975918
2023-04-22 04:06,975930,277965,491403,206562,975930
2023-04-22 04:07,975940,277974,491403,206563,975940
2023-04-22 04:08,975951,277983,491405,206563,975951
2023-04-22 04:09,975962,277993,491406,206563,975962
2023-04-22 04:10,975974,278005,491406,206563,975974
2023-04-22 04:11,975985,278017,491405,206563,975985
2023-04-22 04:12,975996,278028,491405,206563,975996
2023-04-22 04:13,976008,278040,491404,206564,976008
2023-04-22 04:14,976019,278051,491404,206564,976019
2023-04-22 04:15,976030,278062,491404,206564,976030
2023-04-22 04:16,976041,278073,491404,206564,976041
2023-04-22 04:17,976053,278083,491405,206565,976053
2023-04-22 04:18,976063,278093,491405,206565,976063
2023-04-22 04:19,976075,278103,491407,206565,976075
2023-04-22 04:20,976085,278113,491407,206565,976085
2023-04-22 04:21,976098,278126,491407,206565,976098
2023-04-22 04:22,976109,278136,491407,206566,976109
2023-04-22 04:23,976120,278147,491407,206566,976120
2023-04-22 04:24,976132,278159,491407,206566,976132
2023-04-22 04:25,976143,278170,491407,206566,976143
2023-04-22 04:26,976153,278180,491407,206566,976153
2023-04-22 04:27,976165,278192,491407,206566,976165
2023-04-22 04:28,976176,278203,491407,206566,976176
2023-04-22 04:29,976187,278213,491407,206567,976187
2023-04-22 04:30,976199,278225,491407,206567,976199
2023-04-22 04:31,976209,278235,491407,206567,976209
2023-04-22 04:32,976221,278247,491407,206567,976221
2023-04-22 04:33,976232,278258,491407,206567,976232
2023-04-22 04:34,976243,278268,491407,206568,976243
2023-04-22 04:35,976254,278278,491407,206569,976254
2023-04-22 04:36,976265,278289,491407,206569,976265
2023-04-22 04:37,976276,278300,491407,206569,976276
2023-04-22 04:38,976288,278312,491407,206569,976288
2023-04-22 04:39,976299,278323,491407,206569,976299
2023-04-22 04:40,976310,278334,491407,206569,976310
2023-04-22 04:41,976321,278343,491409,206569,976321
2023-04-22 04:42,976332,278354,491409,206569,976332
2023-04-22 04:43,976343,278365,491409,206569,976343
2023-04-22 04:44,976355,278375,491409,206571,976355
2023-04-22 04:45,976366,278385,491410,206571,976366
2023-04-22 04:46,976377,278396,491410,206571,976377
2023-04-22 04:48,976388,278407,491410,206571,976388
2023-04-22 04:49,976399,278418,491410,206571,976399
2023-04-22 04:50,976410,278428,491411,206571,976410
2023-04-22 04:51,976421,278439,491411,206571,976421
2023-04-22 04:52,976433,278450,491411,206572,976433
2023-04-22 04:53,976444,278461,491411,206572,976444
2023-04-22 04:54,976455,278472,491411,206572,976455
2023-04-22 04:55,976466,278483,491411,206572,976466
2023-04-22 04:56,976477,278494,491411,206572,976477
2023-04-22 04:57,976488,278505,491411,206572,976488
2023-04-22 04:58,976499,278513,491413,206573,976499
2023-04-22 04:59,976511,278525,491413,206573,976511
2023-04-22 05:00,976521,278535,491413,206573,976521
2023-04-22 05:01,976529,278543,491413,206573,976529
2023-04-22 05:02,976537,278551,491413,206573,976537
2023-04-22 05:03,976545,278559,491413,206573,976545
2023-04-22 05:04,976553,278567,491413,206573,976553
2023-04-22 05:05,976562,278576,491413,206573,976562
2023-04-22 05:06,976570,278583,491412,206575,976570
2023-04-22 05:07,976579,278591,491412,206576,976579
2023-04-22 05:08,976587,278599,491412,206576,976587
2023-04-22 05:09,976594,278605,491412,206577,976594
2023-04-22 05:10,976603,278614,491412,206577,976603
2023-04-22 05:11,976611,278622,491412,206577,976611
2023-04-22 05:12,976619,278629,491414,206576,976619
2023-04-22 05:13,976626,278636,491414,206576,976626
2023-04-22 05:14,976634,278644,491414,206576,976634
2023-04-22 05:15,976643,278653,491414,206576,976643
2023-04-22 05:16,976651,278658,491416,206577,976651
2023-04-22 05:17,976659,278666,491416,206577,976659
2023-04-22 05:18,976667,278674,491416,206577,976667
2023-04-22 05:19,976675,278681,491416,206578,976675
2023-04-22 05:20,976683,278688,491416,206579,976683
2023-04-22 05:21,976691,278696,491416,206579,976691
2023-04-22 05:22,976699,278704,491416,206579,976699
2023-04-22 05:23,976707,278712,491416,206579,976707
2023-04-22 05:24,976715,278719,491417,206579,976715
2023-04-22 05:25,976723,278727,491417,206579,976723
2023-04-22 05:26,976731,278733,491418,206580,976731
2023-04-22 05:27,976739,278741,491418,206580,976739
2023-04-22 05:28,976747,278749,491418,206580,976747
2023-04-22 05:29,976755,278756,491418,206581,976755
2023-04-22 05:30,976763,278764,491418,206581,976763
2023-04-22 05:31,976771,278772,491418,206581,976771
2023-04-22 05:32,976780,278780,491419,206581,976780
2023-04-22 05:33,976787,278786,491419,206582,976787
2023-04-22 05:35,976796,278796,491418,206582,976796
2023-04-22 05:36,976803,278803,491418,206582,976803
2023-04-22 05:37,976811,278811,491418,206582,976811
2023-04-22 05:38,976819,278819,491418,206582,976819
2023-04-22 05:39,976829,278828,491419,206582,976829
2023-04-22 05:40,976837,278836,491419,206582,976837
2023-04-22 05:41,976845,278844,491419,206582,976845
2023-04-22 05:42,976853,278852,491419,206582,976853
2023-04-22 05:43,976861,278860,491419,206582,976861
2023-04-22 05:44,976869,278868,491419,206582,976869
2023-04-22 05:45,976877,278876,491419,206582,976877
2023-04-22 05:46,976885,278883,491419,206583,976885
2023-04-22 05:47,976893,278891,491419,206583,976893
2023-04-22 05:48,976901,278899,491419,206583,976901
2023-04-22 05:49,976909,278907,491419,206583,976909
2023-04-22 05:50,976917,278915,491419,206583,976917
2023-04-22 05:51,976925,278922,491420,206583,976925
2023-04-22 05:52,976933,278929,491420,206584,976933
2023-04-22 05:53,976941,278936,491420,206585,976941
2023-04-22 05:54,976949,278943,491420,206586,976949
2023-04-22 05:55,976958,278951,491421,206586,976958
2023-04-22 05:56,976966,278959,491421,206586,976966
2023-04-22 05:57,976974,278965,491423,206586,976974
2023-04-22 05:58,976981,278971,491423,206587,976981
2023-04-22 05:59,976989,278979,491423,206587,976989
2023-04-22 06:00,976998,278987,491423,206588,976998
2023-04-22 06:01,977006,278994,491423,206589,977006
2023-04-22 06:02,977015,279003,491423,206589,977015
2023-04-22 06:03,977025,279011,491425,206589,977025
2023-04-22 06:04,977033,279019,491425,206589,977033
2023-04-22 06:05,977042,279025,491426,206591,977042
2023-04-22 06:06,977050,279032,491426,206592,977050
2023-04-22 06:07,977060,279040,491427,206593,977060
2023-04-22 06:08,977068,279048,491427,206593,977068
2023-04-22 06:09,977077,279056,491427,206594,977077
2023-04-22 06:10,977086,279065,491427,206594,977086
2023-04-22 06:11,977094,279072,491428,206594,977094
2023-04-22 06:12,977103,279081,491428,206594,977103
2023-04-22 06:13,977111,279090,491427,206594,977111
2023-04-22 06:14,977120,279099,491427,206594,977120
2023-04-22 06:15,977128,279105,491428,206595,977128
2023-04-22 06:16,977137,279114,491428,206595,977137
2023-04-22 06:17,977146,279122,491429,206595,977146
2023-04-22 06:18,977154,279130,491429,206595,977154
2023-04-22 06:19,977163,279137,491431,206595,977163
2023-04-22 06:20,977172,279145,491431,206596,977172
2023-04-22 06:22,977180,279153,491430,206597,977180
2023-04-22 06:23,977189,279162,491430,206597,977189
2023-04-22 06:24,977197,279170,491430,206597,977197
2023-04-22 06:25,977206,279178,491430,206598,977206
2023-04-22 06:26,977215,279186,491431,206598,977215
2023-04-22 06:27,977223,279194,491431,206598,977223
2023-04-22 06:28,977231,279201,491432,206598,977231
2023-04-22 06:29,977240,279210,491432,206598,977240
2023-04-22 06:30,977249,279219,491432,206598,977249
2023-04-22 06:31,977257,279226,491432,206599,977257
2023-04-22 06:32,977267,279236,491432,206599,977267
2023-04-22 06:33,977275,279242,491432,206601,977275
2023-04-22 06:34,977284,279249,491433,206602,977284
2023-04-22 06:35,977294,279259,491433,206602,977294
2023-04-22 06:36,977302,279267,491433,206602,977302
2023-04-22 06:37,977311,279276,491433,206602,977311
2023-04-22 06:38,977321,279285,491434,206602,977321
2023-04-22 06:39,977329,279293,491434,206602,977329
2023-04-22 06:40,977337,279300,491434,206603,977337
2023-04-22 06:41,977346,279309,491434,206603,977346
2023-04-22 06:42,977354,279315,491435,206604,977354
2023-04-22 06:43,977363,279324,491435,206604,977363
2023-04-22 06:44,977372,279332,491436,206604,977372
2023-04-22 06:45,977380,279339,491436,206605,977380
2023-04-22 06:46,977389,279347,491436,206606,977389
2023-04-22 06:47,977398,279354,491436,206608,977398
2023-04-22 06:48,977406,279362,491436,206608,977406
2023-04-22 06:49,977415,279371,491436,206608,977415
2023-04-22 06:50,977423,279376,491437,206610,977423
2023-04-22 06:51,977432,279385,491437,206610,977432
2023-04-22 06:52,977440,279392,491438,206610,977440
2023-04-22 06:53,977449,279401,491438,206610,977449
2023-04-22 06:54,977458,279408,491438,206612,977458
2023-04-22 06:55,977466,279415,491438,206613,977466
2023-04-22 06:56,977475,279423,491438,206614,977475
2023-04-22 06:57,977483,279431,491438,206614,977483
2023-04-22 06:58,977492,279438,491439,206615,977492
2023-04-22 06:59,977500,279445,491439,206616,977500
2023-04-22 07:00,977512,279457,491439,206616,977512
2023-04-22 07:01,977523,279465,491439,206619,977523
2023-04-22 07:02,977534,279475,491440,206619,977534
2023-04-22 07:03,977547,279488,491440,206619,977547
2023-04-22 07:04,977559,279498,491442,206619,977559
2023-04-22 07:05,977571,279510,491442,206619,977571
2023-04-22 07:06,977583,279519,491443,206621,977583
2023-04-22 07:07,977595,279531,491443,206621,977595
2023-04-22 07:09,977606,279538,491445,206623,977606
2023-04-22 07:10,977619,279551,491445,206623,977619
2023-04-22 07:11,977630,279561,491446,206623,977630
2023-04-22 07:12,977642,279571,491446,206625,977642
2023-04-22 07:13,977654,279582,491447,206625,977654
2023-04-22 07:14,977665,279592,491447,206626,977665
2023-04-22 07:15,977677,279602,491449,206626,977677
2023-04-22 07:16,977689,279614,491449,206626,977689
2023-04-22 07:17,977701,279621,491451,206629,977701
2023-04-22 07:18,977714,279634,491451,206629,977714
2023-04-22 07:19,977725,279644,491452,206629,977725
2023-04-22 07:20,977736,279654,491452,206630,977736
2023-04-22 07:21,977748,279665,491452,206631,977748
2023-04-22 07:22,977760,279675,491452,206633,977760
2023-04-22 07:23,977772,279685,491454,206633,977772
2023-04-22 07:24,977783,279695,491454,206634,977783
2023-04-22 07:25,977794,279701,491456,206637,977794
2023-04-22 07:26,977806,279712,491456,206638,977806
2023-04-22 07:27,977818,279723,491457,206638,977818
2023-04-22 07:28,977830,279734,491457,206639,977830
2023-04-22 07:29,977842,279744,491459,206639,977842
2023-04-22 07:30,977853,279754,491459,206640,977853
2023-04-22 07:31,977867,279768,491459,206640,977867
2023-04-22 07:32,977879,279780,491459,206640,977879
2023-04-22 07:33,977890,279787,491460,206643,977890
2023-04-22 07:34,977902,279797,491460,206645,977902
2023-04-22 07:35,977913,279803,491462,206648,977913
2023-04-22 07:36,977926,279814,491463,206649,977926
2023-04-22 07:37,977937,279825,491463,206649,977937
2023-04-22 07:38,977948,279833,491466,206649,977948
2023-04-22 07:39,977961,279844,491466,206651,977961
2023-04-22 07:40,977973,279855,491466,206652,977973
2023-04-22 07:41,977985,279867,491466,206652,977985
2023-04-22 07:42,977996,279877,491467,206652,977996
2023-04-22 07:43,978009,279890,491467,206652,978009
2023-04-22 07:44,978021,279897,491469,206655,978021
2023-04-22 07:45,978034,279909,491469,206656,978034
2023-04-22 07:46,978045,279918,491469,206658,978045
2023-04-22 07:47,978057,279928,491469,206660,978057
2023-04-22 07:48,978069,279934,491471,206664,978069
2023-04-22 07:49,978081,279945,491471,206665,978081
2023-04-22 07:50,978093,279955,491473,206665,978093
2023-04-22 07:51,978104,279965,491473,206666,978104
2023-04-22 07:52,978116,279972,491475,206669,978116
2023-04-22 07:53,978127,279983,491475,206669,978127
2023-04-22 07:54,978139,279994,491476,206669,978139
2023-04-22 07:56,978152,280003,491476,206673,978152
2023-04-22 07:57,978163,280012,491477,206674,978163
2023-04-22 07:58,978175,280024,491477,206674,978175
2023-04-22 07:59,978187,280035,491477,206675,978187
2023-04-22 08:00,978199,280047,491477,206675,978199
2023-04-22 08:01,978212,280058,491477,206677,978212
2023-04-22 08:02,978225,280069,491477,206679,978225
2023-04-22 08:03,978240,280083,491477,206680,978240
2023-04-22 08:04,978253,280095,491477,206681,978253
2023-04-22 08:05,978266,280107,491477,206682,978266
2023-04-22 08:06,978279,280119,491477,206683,978279
2023-04-22 08:07,978293,280126,491484,206683,978293
2023-04-22 08:08,978305,280137,491484,206684,978305
2023-04-22 08:09,978319,280151,491484,206684,978319
2023-04-22 08:10,978333,280164,491484,206685,978333
2023-04-22 08:11,978346,280177,491484,206685,978346
2023-04-22 08:12,978360,280191,491484,206685,978360
2023-04-22 08:13,978372,280202,491484,206686,978372
2023-04-22 08:14,978386,280214,491484,206688,978386
2023-04-22 08:15,978399,280227,491484,206688,978399
2023-04-22 08:16,978412,280239,491484,206689,978412
2023-04-22 08:17,978426,280240,491497,206689,978426
2023-04-22 08:18,978440,280252,491497,206691,978440
2023-04-22 08:19,978454,280264,491497,206693,978454
2023-04-22 08:20,978469,280276,491497,206696,978469
2023-04-22 08:21,978482,280286,491497,206699,978482
2023-04-22 08:22,978495,280297,491497,206701,978495
2023-04-22 08:23,978509,280307,491497,206705,978509
2023-04-22 08:24,978522,280320,491497,206705,978522
2023-04-22 08:25,978535,280331,491497,206707,978535
2023-04-22 08:26,978548,280344,491497,206707,978548
2023-04-22 08:27,978562,280351,491503,206708,978562
2023-04-22 08:28,978574,280362,491503,206709,978574
2023-04-22 08:29,978588,280376,491503,206709,978588
2023-04-22 08:30,978602,280388,491503,206711,978602
2023-04-22 08:31,978615,280400,491503,206712,978615
2023-04-22 08:32,978628,280404,491509,206715,978628
2023-04-22 08:33,978642,280416,491509,206717,978642
2023-04-22 08:34,978655,280426,491511,206718,978655
2023-04-22 08:35,978668,280436,491511,206721,978668
2023-04-22 08:36,978682,280450,491511,206721,978682
2023-04-22 08:37,978695,280461,491511,206723,978695
2023-04-22 08:38,978708,280471,491513,206724,978708
2023-04-22 08:39,978721,280483,491513,206725,978721
2023-04-22 08:40,978735,280494,491515,206726,978735
2023-04-22 08:41,978748,280503,491515,206730,978748
2023-04-22 08:42,978763,280513,491518,206732,978763
2023-04-22 08:44,978776,280524,491518,206734,978776
2023-04-22 08:45,978789,280530,491522,206737,978789
2023-04-22 08:46,978802,280543,491522,206737,978802
2023-04-22 08:47,978816,280555,491522,206739,978816
2023-04-22 08:48,978828,280564,491522,206742,978828
2023-04-22 08:49,978842,280577,491523,206742,978842
2023-04-22 08:50,978855,280589,491523,206743,978855
2023-04-22 08:51,978869,280600,491524,206745,978869
2023-04-22 08:52,978882,280610,491524,206748,978882
2023-04-22 08:53,978895,280620,491525,206750,978895
2023-04-22 08:54,978908,280632,491525,206751,978908
2023-04-22 08:55,978921,280642,491528,206751,978921
2023-04-22 08:56,978934,280655,491528,206751,978934
2023-04-22 08:57,978947,280666,491528,206753,978947
2023-04-22 08:58,978961,280678,491528,206755,978961
2023-04-22 08:59,978974,280690,491528,206756,978974
2023-04-22 09:00,978988,280703,491528,206757,978988
2023-04-22 09:01,978997,280710,491528,206759,978997
2023-04-22 09:02,979008,280717,491528,206763,979008
2023-04-22 09:03,979018,280726,491528,206764,979018
2023-04-22 09:04,979029,280734,491528,206767,979029
2023-04-22 09:05,979040,280743,491528,206769,979040
2023-04-22 09:06,979050,280752,491528,206770,979050
2023-04-22 09:07,979060,280746,491543,206771,979060
2023-04-22 09:08,979070,280752,491543,206775,979070
2023-04-22 09:09,979081,280761,491543,206777,979081
2023-04-22 09:10,979090,280768,491543,206779,979090
2023-04-22 09:11,979100,280775,491543,206782,979100
2023-04-22 09:12,979112,280787,491543,206782,979112
2023-04-22 09:13,979122,280796,491543,206783,979122
2023-04-22 09:14,979132,280805,491543,206784,979132
2023-04-22 09:15,979142,280815,491543,206784,979142
2023-04-22 09:16,979152,280823,491543,206786,979152
2023-04-22 09:17,979162,280820,491556,206786,979162
2023-04-22 09:18,979172,280830,491556,206786,979172
2023-04-22 09:19,979182,280838,491556,206788,979182
2023-04-22 09:20,979192,280848,491556,206788,979192
2023-04-22 09:21,979202,280856,491556,206790,979202
2023-04-22 09:22,979213,280863,491556,206794,979213
2023-04-22 09:23,979225,280875,491556,206794,979225
2023-04-22 09:24,979235,280884,491556,206795,979235
2023-04-22 09:25,979246,280892,491556,206798,979246
2023-04-22 09:26,979257,280902,491556,206799,979257
2023-04-22 09:27,979268,280899,491569,206800,979268
2023-04-22 09:28,979278,280908,491569,206801,979278
2023-04-22 09:30,979288,280912,491573,206803,979288
2023-04-22 09:31,979301,280924,491573,206804,979301
2023-04-22 09:32,979311,280930,491577,206804,979311
2023-04-22 09:33,979321,280938,491577,206806,979321
2023-04-22 09:34,979332,280942,491582,206808,979332
2023-04-22 09:35,979341,280951,491582,206808,979341
2023-04-22 09:36,979352,280954,491589,206809,979352
2023-04-22 09:37,979362,280962,491589,206811,979362
2023-04-22 09:38,979371,280968,491591,206812,979371
2023-04-22 09:39,979382,280977,491591,206814,979382
2023-04-22 09:40,979392,280984,491593,206815,979392
2023-04-22 09:41,979403,280993,491593,206817,979403
2023-04-22 09:42,979414,281000,491596,206818,979414
2023-04-22 09:43,979424,281009,491596,206819,979424
2023-04-22 09:44,979434,281014,491598,206822,979434
2023-04-22 09:45,979445,281022,491598,206825,979445
2023-04-22 09:46,979456,281032,491598,206826,979456
2023-04-22 09:47,979467,281042,491598,206827,979467
2023-04-22 09:48,979476,281047,491601,206828,979476
2023-04-22 09:49,979488,281054,491601,206833,979488
2023-04-22 09:50,979498,281060,491603,206835,979498
2023-04-22 09:51,979508,281067,491603,206838,979508
2023-04-22 09:52,979518,281071,491607,206840,979518
2023-04-22 09:53,979529,281081,491607,206841,979529
2023-04-22 09:54,979539,281083,491613,206843,979539
2023-04-22 09:55,979549,281089,491613,206847,979549
2023-04-22 09:56,979560,281098,491614,206848,979560
2023-04-22 09:57,979571,281108,491614,206849,979571
2023-04-22 09:58,979581,281112,491617,206852,979581
2023-04-22 09:59,979592,281122,491617,206853,979592
2023-04-22 10:00,979601,281125,491619,206857,979601
2023-04-22 10:01,979608,281129,491619,206860,979608
2023-04-22 10:02,979614,281129,491621,206864,979614
2023-04-22 10:03,979621,281135,491621,206865,979621
2023-04-22 10:04,979630,281137,491627,206866,979630
2023-04-22 10:05,979637,281141,491627,206869,979637
2023-04-22 10:06,979643,281142,491629,206872,979643
2023-04-22 10:07,979649,281148,491629,206872,979649
2023-04-22 10:08,979657,281153,491631,206873,979657
2023-04-22 10:09,979665,281160,491631,206874,979665
2023-04-22 10:10,979673,281160,491637,206876,979673
2023-04-22 10:11,979679,281164,491637,206878,979679
2023-04-22 10:12,979685,281164,491640,206881,979685
2023-04-22 10:13,979692,281171,491640,206881,979692
2023-04-22 10:14,979698,281170,491644,206884,979698
2023-04-22 10:15,979705,281176,491644,206885,979705
2023-04-22 10:17,979712,281180,491645,206887,979712
2023-04-22 10:18,979719,281185,491645,206889,979719
2023-04-22 10:19,979725,281185,491649,206891,979725
2023-04-22 10:20,979732,281192,491649,206891,979732
2023-04-22 10:21,979739,281191,491655,206893,979739
2023-04-22 10:22,979745,281193,491655,206897,979745
2023-04-22 10:23,979752,281195,491656,206901,979752
2023-04-22 10:24,979758,281199,491656,206903,979758
2023-04-22 10:25,979765,281202,491660,206903,979765
2023-04-22 10:26,979772,281208,491660,206904,979772
2023-04-22 10:27,979779,281206,491665,206908,979779
2023-04-22 10:28,979787,281212,491665,206910,979787
2023-04-22 10:29,979793,281213,491668,206912,979793
2023-04-22 10:30,979799,281218,491668,206913,979799
2023-04-22 10:31,979807,281222,491670,206915,979807
2023-04-22 10:32,979814,281227,491670,206917,979814
2023-04-22 10:33,979822,281236,491670,206916,979822
2023-04-22 10:34,979828,281240,491670,206918,979828
2023-04-22 10:35,979835,281243,491674,206918,979835
2023-04-22 10:36,979841,281246,491674,206921,979841
2023-04-22 10:37,979848,281247,491678,206923,979848
2023-04-22 10:38,979855,281250,491678,206927,979855
2023-04-22 10:39,979861,281247,491685,206929,979861
2023-04-22 10:40,979868,281252,491685,206931,979868
2023-04-22 10:41,979875,281255,491688,206932,979875
2023-04-22 10:42,979882,281260,491688,206934,979882
2023-04-22 10:43,979888,281262,491692,206934,979888
2023-04-22 10:44,979895,281268,491692,206935,979895
2023-04-22 10:45,979903,281270,491696,206937,979903
2023-04-22 10:46,979910,281276,491696,206938,979910
2023-04-22 10:47,979917,281277,491699,206941,979917
2023-04-22 10:48,979923,281283,491699,206941,979923
2023-04-22 10:49,979930,281283,491704,206943,979930
2023-04-22 10:50,979936,281288,491704,206944,979936
2023-04-22 10:51,979942,281291,491706,206945,979942
2023-04-22 10:52,979949,281297,491706,206946,979949
2023-04-22 10:53,979955,281295,491708,206952,979955
2023-04-22 10:54,979962,281301,491708,206953,979962
2023-04-22 10:55,979968,281301,491712,206955,979968
2023-04-22 10:56,979974,281303,491713,206958,979974
2023-04-22 10:57,979981,281308,491713,206960,979981
2023-04-22 10:58,979987,281309,491716,206962,979987
2023-04-22 10:59,979994,281312,491716,206966,979994
2023-04-22 11:00,980000,281312,491719,206969,980000
2023-04-22 11:01,980007,281316,491719,206972,980007
2023-04-22 11:02,980014,281322,491719,206973,980014
2023-04-22 11:04,980020,281324,491719,206977,980020
2023-04-22 11:05,980026,281319,491727,206980,980026
2023-04-22 11:06,980033,281324,491727,206982,980033
2023-04-22 11:07,980039,281326,491728,206985,980039
2023-04-22 11:08,980046,281333,491728,206985,980046
2023-04-22 11:09,980053,281335,491731,206987,980053
2023-04-22 11:10,980059,281340,491731,206988,980059
2023-04-22 11:11,980065,281345,491732,206988,980065
2023-04-22 11:12,980071,281350,491732,206989,980071
2023-04-22 11:13,980077,281353,491735,206989,980077
2023-04-22 11:14,980084,281359,491735,206990,980084
2023-04-22 11:15,980091,281363,491736,206992,980091
2023-04-22 11:16,980097,281369,491736,206992,980097
2023-04-22 11:17,980103,281374,491735,206994,980103
2023-04-22 11:18,980110,281378,491735,206997,980110
2023-04-22 11:19,980116,281378,491738,207000,980116
2023-04-22 11:20,980122,281377,491739,207006,980122
2023-04-22 11:21,980130,281384,491739,207007,980130
2023-04-22 11:22,980137,281384,491742,207011,980137
2023-04-22 11:23,980143,281388,491742,207013,980143
2023-04-22 11:24,980149,281389,491745,207015,980149
2023-04-22 11:25,980155,281392,491745,207018,980155
2023-04-22 11:26,980163,281390,491751,207022,980163
2023-04-22 11:27,980169,281394,491751,207024,980169
2023-04-22 11:28,980175,281394,491751,207030,980175
2023-04-22 11:29,980181,281398,491751,207032,980181
2023-04-22 11:30,980188,281403,491752,207033,980188
2023-04-22 11:31,980194,281408,491752,207034,980194
2023-04-22 11:32,980200,281406,491758,207036,980200
2023-04-22 11:33,980206,281412,491758,207036,980206
2023-04-22 11:34,980215,281412,491765,207038,980215
2023-04-22 11:35,980221,281412,491768,207041,980221
2023-04-22 11:36,980227,281417,491768,207042,980227
2023-04-22 11:37,980233,281415,491772,207046,980233
2023-04-22 11:38,980239,281420,491772,207047,980239
2023-04-22 11:39,980245,281416,491780,207049,980245
2023-04-22 11:40,980251,281419,491780,207052,980251
2023-04-22 11:41,980257,281414,491788,207055,980257
2023-04-22 11:42,980264,281414,491792,207058,980264
2023-04-22 11:43,980270,281420,491792,207058,980270
2023-04-22 11:44,980277,281418,491798,207061,980277
2023-04-22 11:45,980283,281419,491803,207061,980283
2023-04-22 11:46,980290,281420,491803,207067,980290
2023-04-22 11:47,980297,281420,491809,207068,980297
2023-04-22 11:48,980302,281422,491811,207069,980302
2023-04-22 11:49,980309,281428,491811,207070,980309
2023-04-22 11:50,980316,281419,491823,207074,980316
2023-04-22 11:51,980323,281424,491823,207076,980323
2023-04-22 11:53,980331,281418,491834,207079,980331
2023-04-22 11:54,980338,281414,491841,207083,980338
2023-04-22 11:55,980344,281417,491843,207084,980344
2023-04-22 11:56,980350,281421,491843,207086,980350
2023-04-22 11:57,980358,281421,491848,207089,980358
2023-04-22 11:58,980364,281417,491855,207092,980364
2023-04-22 11:59,980373,281426,491855,207092,980373
2023-04-22 12:00,980379,281423,491862,207094,980379
2023-04-22 12:01,980386,281425,491862,207099,980386
2023-04-22 12:02,980391,281424,491867,207100,980391
2023-04-22 12:03,980397,281422,491871,207104,980397
2023-04-22 12:04,980403,281427,491871,207105,980403
2023-04-22 12:05,980409,281417,491878,207114,980409
2023-04-22 12:06,980414,281417,491881,207116,980414
2023-04-22 12:07,980420,281419,491881,207120,980420
2023-04-22 12:08,980426,281415,491888,207123,980426
2023-04-22 12:09,980431,281417,491888,207126,980431
2023-04-22 12:10,980438,281421,491888,207129,980438
2023-04-22 12:11,980443,281425,491888,207130,980443
2023-04-22 12:12,980449,281430,491888,207131,980449
2023-04-22 12:13,980454,281416,491904,207134,980454
2023-04-22 12:14,980460,281419,491905,207136,980460
2023-04-22 12:15,980466,281425,491905,207136,980466
2023-04-22 12:16,980472,281420,491912,207140,980472
2023-04-22 12:17,980478,281422,491912,207144,980478
2023-04-22 12:18,980486,281424,491918,207144,980486
2023-04-22 12:19,980493,281426,491918,207149,980493
2023-04-22 12:20,980501,281426,491922,207153,980501
2023-04-22 12:21,980509,281431,491922,207156,980509
2023-04-22 12:22,980517,281432,491924,207161,980517
2023-04-22 12:23,980522,281434,491924,207164,980522
2023-04-22 12:24,980528,281425,491934,207169,980528
2023-04-22 12:25,980533,281426,491938,207169,980533
2023-04-22 12:26,980539,281431,491938,207170,980539
2023-04-22 12:27,980546,281423,491951,207172,980546
2023-04-22 12:28,980552,281428,491952,207172,980552
2023-04-22 12:31,980558,281425,491952,207181,980558
2023-04-22 12:32,980578,281446,491952,207180,980578
2023-04-22 12:33,980584,281426,491974,207184,980584
2023-04-22 12:34,980590,281432,491974,207184,980590
2023-04-22 12:37,980596,281433,491976,207187,980596
2023-04-22 12:38,980613,281440,491982,207191,980613
2023-04-22 12:39,980619,281444,491982,207193,980619
2023-04-22 12:40,980627,281443,491991,207193,980627
2023-04-22 12:41,980633,281448,491991,207194,980633
2023-04-22 12:42,980640,281446,491994,207200,980640
2023-04-22 12:44,980646,281444,491998,207204,980646
2023-04-22 12:45,980661,281452,492001,207208,980661
2023-04-22 12:46,980666,281458,492001,207207,980666
2023-04-22 12:47,980672,281457,492005,207210,980672
2023-04-22 12:48,980679,281461,492005,207213,980679
2023-04-22 12:49,980685,281459,492010,207216,980685
2023-04-22 12:50,980691,281463,492010,207218,980691
2023-04-22 12:51,980698,281463,492015,207220,980698
2023-04-22 12:52,980704,281468,492015,207221,980704
2023-04-22 12:53,980709,281471,492015,207223,980709
2023-04-22 12:54,980715,281475,492015,207225,980715
2023-04-22 12:55,980721,281470,492022,207229,980721
2023-04-22 12:56,980727,281469,492022,207236,980727
2023-04-22 12:57,980733,281468,492029,207236,980733
2023-04-22 12:58,980740,281474,492029,207237,980740
2023-04-22 12:59,980746,281474,492034,207238,980746
2023-04-22 13:00,980760,281487,492034,207239,980760
2023-04-22 13:01,980774,281495,492035,207244,980774
2023-04-22 13:02,980790,281508,492035,207247,980790
2023-04-22 13:03,980804,281516,492038,207250,980804
2023-04-22 13:05,980820,281526,492040,207254,980820
2023-04-22 13:06,980835,281541,492040,207254,980835
2023-04-22 13:07,980849,281548,492047,207254,980849
2023-04-22 13:08,980864,281559,492047,207258,980864
2023-04-22 13:09,980879,281555,492061,207263,980879
2023-04-22 13:10,980893,281568,492061,207264,980893
2023-04-22 13:11,980908,281570,492067,207271,980908
2023-04-22 13:12,980922,281585,492067,207270,980922
2023-04-22 13:13,980938,281593,492072,207273,980938
2023-04-22 13:14,980953,281607,492072,207274,980953
2023-04-22 13:15,980967,281611,492081,207275,980967
2023-04-22 13:16,980980,281622,492081,207277,980980
2023-04-22 13:17,980996,281631,492086,207279,980996
2023-04-22 13:18,981012,281644,492086,207282,981012
2023-04-22 13:19,981026,281653,492089,207284,981026
2023-04-22 13:20,981040,281665,492089,207286,981040
2023-04-22 13:21,981054,281668,492093,207293,981054
2023-04-22 13:22,981068,281680,492094,207294,981068
2023-04-22 13:23,981083,281693,492094,207296,981083
2023-04-22 13:24,981098,281698,492102,207298,981098
2023-04-22 13:25,981112,281711,492102,207299,981112
2023-04-22 13:26,981127,281722,492104,207301,981127
2023-04-22 13:27,981143,281733,492104,207306,981143
2023-04-22 13:28,981157,281737,492109,207311,981157
2023-04-22 13:29,981173,281749,492109,207315,981173
2023-04-22 13:30,981188,281763,492109,207316,981188
2023-04-22 13:31,981202,281774,492109,207319,981202
2023-04-22 13:32,981219,281782,492115,207322,981219
2023-04-22 13:33,981234,281792,492119,207323,981234
2023-04-22 13:34,981249,281806,492119,207324,981249
2023-04-22 13:35,981264,281809,492124,207331,981264
2023-04-22 13:36,981279,281819,492125,207335,981279
2023-04-22 13:37,981293,281832,492125,207336,981293
2023-04-22 13:38,981307,281841,492129,207337,981307
2023-04-22 13:39,981322,281851,492129,207342,981322
2023-04-22 13:40,981336,281854,492135,207347,981336
2023-04-22 13:41,981351,281866,492135,207350,981351
2023-04-22 13:42,981366,281872,492140,207354,981366
2023-04-22 13:43,981382,281886,492140,207356,981382
2023-04-22 13:44,981397,281897,492144,207356,981397
2023-04-22 13:45,981412,281911,492144,207357,981412
2023-04-22 13:46,981426,281917,492149,207360,981426
2023-04-22 13:47,981441,281929,492149,207363,981441
2023-04-22 13:48,981457,281939,492151,207367,981457
2023-04-22 13:49,981472,281953,492151,207368,981472
2023-04-22 13:51,981487,281965,492155,207367,981487
2023-04-22 13:52,981501,281976,492155,207370,981501
2023-04-22 13:53,981516,281987,492156,207373,981516
2023-04-22 13:54,981531,282001,492156,207374,981531
2023-04-22 13:55,981547,282011,492159,207377,981547
2023-04-22 13:56,981561,282023,492159,207379,981561
2023-04-22 13:57,981574,282026,492165,207383,981574
2023-04-22 13:58,981590,282041,492165,207384,981590
2023-04-22 13:59,981604,282048,492171,207385,981604
2023-04-22 14:00,981619,282061,492171,207387,981619
2023-04-22 14:01,981637,282070,492177,207390,981637
2023-04-22 14:02,981655,282086,492177,207392,981655
2023-04-22 14:03,981673,282099,492180,207394,981673
2023-04-22 14:04,981690,282114,492180,207396,981690
2023-04-22 14:05,981708,282122,492186,207400,981708
2023-04-22 14:06,981725,282138,492186,207401,981725
2023-04-22 14:07,981742,282146,492189,207407,981742
2023-04-22 14:08,981759,282159,492189,207411,981759
2023-04-22 14:09,981779,282173,492193,207413,981779
2023-04-22 14:10,981795,282185,492193,207417,981795
2023-04-22 14:11,981813,282193,492197,207423,981813
2023-04-22 14:12,981830,282205,492197,207428,981830
2023-04-22 14:13,981849,282214,492205,207430,981849
2023-04-22 14:14,981867,282228,492205,207434,981867
2023-04-22 14:15,981885,282241,492206,207438,981885
2023-04-22 14:16,981901,282256,492206,207439,981901
2023-04-22 14:17,981918,282266,492212,207440,981918
2023-04-22 14:18,981938,282283,492212,207443,981938
2023-04-22 14:19,981956,282293,492216,207447,981956
2023-04-22 14:20,981975,282312,492216,207447,981975
2023-04-22 14:21,981992,282324,492220,207448,981992
2023-04-22 14:22,982010,282338,492220,207452,982010
2023-04-22 14:23,982028,282353,492223,207452,982028
2023-04-22 14:24,982046,282370,492223,207453,982046
2023-04-22 14:25,982064,282385,492224,207455,982064
2023-04-22 14:26,982082,282400,492224,207458,982082
2023-04-22 14:27,982102,282413,492229,207460,982102
2023-04-22 14:28,982119,282428,492229,207462,982119
2023-04-22 14:29,982136,282441,492231,207464,982136
2023-04-22 14:30,982155,282455,492233,207467,982155
2023-04-22 14:31,982174,282471,492233,207470,982174
2023-04-22 14:32,982192,282486,492235,207471,982192
2023-04-22 14:33,982210,282500,492236,207474,982210
2023-04-22 14:34,982229,282518,492236,207475,982229
2023-04-22 14:35,982245,282526,492243,207476,982245
2023-04-22 14:36,982264,282542,492243,207479,982264
2023-04-22 14:37,982281,282555,492247,207479,982281
2023-04-22 14:39,982300,282574,492247,207479,982300
2023-04-22 14:40,982318,282590,492248,207480,982318
2023-04-22 14:41,982336,282607,492248,207481,982336
2023-04-22 14:42,982356,282623,492249,207484,982356
2023-04-22 14:43,982373,282638,492249,207486,982373
2023-04-22 14:44,982392,282651,492253,207488,982392
2023-04-22 14:45,982410,282668,492253,207489,982410
2023-04-22 14:46,982428,282679,492258,207491,982428
2023-04-22 14:47,982444,282692,492258,207494,982444
2023-04-22 14:48,982462,282700,492265,207497,982462
2023-04-22 14:49,982479,282714,492265,207500,982479
2023-04-22 14:50,982498,282727,492270,207501,982498
2023-04-22 14:51,982516,282745,492270,207501,982516
2023-04-22 14:52,982534,282757,492273,207504,982534
2023-04-22 14:53,982552,282773,492273,207506,982552
2023-04-22 14:54,982569,282788,492274,207507,982569
2023-04-22 14:55,982589,282806,492274,207509,982589
2023-04-22 14:56,982610,282822,492276,207512,982610
2023-04-22 14:57,982628,282834,492279,207515,982628
2023-04-22 14:58,982645,282849,492279,207517,982645
2023-04-22 14:59,982662,282855,492283,207524,982662
2023-04-22 15:00,982676,282865,492286,207525,982676
2023-04-22 15:01,982685,282872,492286,207527,982685
2023-04-22 15:02,982694,282875,492289,207530,982694
2023-04-22 15:03,982705,282881,492289,207535,982705
2023-04-22 15:04,982713,282886,492292,207535,982713
2023-04-22 15:05,982723,282893,492292,207538,982723
2023-04-22 15:06,982732,282896,492296,207540,982732
2023-04-22 15:07,982741,282901,492296,207544,982741
2023-04-22 15:08,982750,282901,492298,207551,982750
2023-04-22 15:09,982761,282910,492300,207551,982761
2023-04-22 15:10,982772,282918,492300,207554,982772
2023-04-22 15:11,982783,282919,492307,207557,982783
2023-04-22 15:12,982796,282931,492307,207558,982796
2023-04-22 15:13,982805,282936,492310,207559,982805
2023-04-22 15:14,982814,282941,492311,207562,982814
2023-04-22 15:15,982824,282949,492311,207564,982824
2023-04-22 15:16,982833,282950,492319,207564,982833
2023-04-22 15:17,982843,282960,492319,207564,982843
2023-04-22 15:18,982853,282965,492323,207565,982853
2023-04-22 15:19,982863,282974,492323,207566,982863
2023-04-22 15:20,982873,282981,492325,207567,982873
2023-04-22 15:21,982883,282986,492325,207572,982883
2023-04-22 15:22,982894,282996,492324,207574,982894
2023-04-22 15:23,982903,283002,492324,207577,982903
2023-04-22 15:24,982913,283007,492329,207577,982913
2023-04-22 15:26,982924,283013,492329,207582,982924
2023-04-22 15:27,982933,283008,492339,207586,982933
2023-04-22 15:28,982942,283017,492339,207586,982942
2023-04-22 15:29,982953,283023,492342,207588,982953
2023-04-22 15:30,982964,283033,492342,207589,982964
2023-04-22 15:31,982973,283033,492348,207592,982973
2023-04-22 15:32,982983,283038,492351,207594,982983
2023-04-22 15:33,982992,283043,492351,207598,982992
2023-04-22 15:34,983002,283045,492355,207602,983002
2023-04-22 15:35,983011,283053,492355,207603,983011
2023-04-22 15:36,983021,283059,492357,207605,983021
2023-04-22 15:37,983031,283068,492357,207606,983031
2023-04-22 15:38,983039,283066,492361,207612,983039
2023-04-22 15:39,983049,283074,492362,207613,983049
2023-04-22 15:40,983058,283079,492362,207617,983058
2023-04-22 15:41,983069,283086,492363,207620,983069
2023-04-22 15:42,983078,283088,492364,207626,983078
2023-04-22 15:43,983088,283096,492364,207628,983088
2023-04-22 15:44,983098,283096,492369,207633,983098
2023-04-22 15:45,983107,283103,492369,207635,983107
2023-04-22 15:46,983116,283107,492373,207636,983116
2023-04-22 15:47,983127,283112,492379,207636,983127
2023-04-22 15:48,983137,283119,492379,207639,983137
2023-04-22 15:49,983148,283125,492381,207642,983148
2023-04-22 15:50,983159,283135,492381,207643,983159
2023-04-22 15:51,983169,283143,492383,207643,983169
2023-04-22 15:52,983179,283151,492383,207645,983179
2023-04-22 15:53,983188,283154,492388,207646,983188
2023-04-22 15:54,983197,283160,492388,207649,983197
2023-04-22 15:55,983206,283161,492393,207652,983206
2023-04-22 15:56,983215,283165,492396,207654,983215
2023-04-22 15:57,983224,283173,492396,207655,983224
2023-04-22 15:58,983233,283172,492403,207658,983233
2023-04-22 15:59,983245,283182,492403,207660,983245
2023-04-22 16:00,983258,283192,492403,207663,983258
2023-04-22 16:01,983278,283208,492403,207667,983278
2023-04-22 16:02,983295,283217,492411,207667,983295
2023-04-22 16:03,983313,283235,492411,207667,983313
2023-04-22 16:04,983329,283241,492416,207672,983329
2023-04-22 16:07,983347,283245,492422,207680,983347
2023-04-22 16:08,983389,283280,492427,207682,983389
2023-04-22 16:09,983407,283290,492433,207684,983407
2023-04-22 16:10,983424,283306,492433,207685,983424
2023-04-22 16:11,983440,283314,492437,207689,983440
2023-04-22 16:12,983460,283330,492437,207693,983460
2023-04-22 16:13,983477,283336,492441,207700,983477
2023-04-22 16:14,983493,283352,492441,207700,983493
2023-04-22 16:15,983510,283367,492443,207700,983510
2023-04-22 16:16,983528,283385,492443,207700,983528
2023-04-22 16:17,983545,283397,492447,207701,983545
2023-04-22 16:18,983563,283413,492447,207703,983563
2023-04-22 16:19,983581,283428,492449,207704,983581
2023-04-22 16:20,983598,283440,492449,207709,983598
2023-04-22 16:21,983614,283450,492454,207710,983614
2023-04-22 16:22,983630,283464,492454,207712,983630
2023-04-22 16:23,983648,283481,492454,207713,983648
2023-04-22 16:24,983664,283493,492456,207715,983664
2023-04-22 16:25,983682,283508,492458,207716,983682
2023-04-22 16:26,983698,283523,492457,207718,983698
2023-04-22 16:27,983714,283534,492457,207723,983714
2023-04-22 16:28,983731,283544,492461,207726,983731
2023-04-22 16:29,983748,283556,492465,207727,983748
2023-04-22 16:30,983767,283573,492465,207729,983767
2023-04-22 16:31,983784,283586,492466,207732,983784
2023-04-22 16:32,983802,283604,492466,207732,983802
2023-04-22 16:33,983819,283619,492467,207733,983819
2023-04-22 16:34,983836,283635,492467,207734,983836
2023-04-22 16:36,983854,283646,492472,207736,983854
2023-04-22 16:37,983871,283663,492472,207736,983871
2023-04-22 16:38,983887,283671,492479,207737,983887
2023-04-22 16:39,983904,283684,492479,207741,983904
2023-04-22 16:40,983921,283697,492482,207742,983921
2023-04-22 16:41,983940,283715,492482,207743,983940
2023-04-22 16:42,983957,283728,492483,207746,983957
2023-04-22 16:43,983973,283742,492483,207748,983973
2023-04-22 16:44,983991,283753,492486,207752,983991
2023-04-22 16:45,984007,283767,492486,207754,984007
2023-04-22 16:46,984026,283780,492491,207755,984026
2023-04-22 16:47,984044,283794,492491,207759,984044
2023-04-22 16:48,984060,283803,492495,207762,984060
2023-04-22 16:49,984077,283819,492495,207763,984077
2023-04-22 16:50,984093,283830,492496,207767,984093
2023-04-22 16:51,984110,283843,492498,207769,984110
2023-04-22 16:52,984128,283860,492499,207769,984128
2023-04-22 16:53,984145,283875,492499,207771,984145
2023-04-22 16:54,984162,283887,492503,207772,984162
2023-04-22 16:55,984178,283899,492503,207776,984178
2023-04-22 16:56,984195,283910,492504,207781,984195
2023-04-22 16:57,984212,283917,492510,207785,984212
2023-04-22 16:58,984228,283931,492510,207787,984228
2023-04-22 16:59,984245,283943,492511,207791,984245
2023-04-22 17:00,984262,283958,492511,207793,984262
2023-04-22 17:01,984278,283970,492512,207796,984278
2023-04-22 17:02,984293,283984,492512,207797,984293
2023-04-22 17:03,984309,283995,492513,207801,984309
2023-04-22 17:04,984324,284005,492513,207806,984324
2023-04-22 17:05,984338,284010,492519,207809,984338
2023-04-22 17:06,984353,284023,492519,207811,984353
2023-04-22 17:07,984369,284037,492520,207812,984369
2023-04-22 17:08,984385,284045,492521,207819,984385
2023-04-22 17:09,984400,284056,492521,207823,984400
2023-04-22 17:10,984417,284063,492526,207828,984417
2023-04-22 17:11,984433,284075,492526,207832,984433
2023-04-22 17:12,984448,284089,492527,207832,984448
2023-04-22 17:13,984465,284102,492528,207835,984465
2023-04-22 17:14,984480,284115,492528,207837,984480
2023-04-22 17:15,984498,284128,492530,207840,984498
2023-04-22 17:16,984513,284140,492530,207843,984513
2023-04-22 17:17,984531,284155,492532,207844,984531
2023-04-22 17:18,984545,284167,492530,207848,984545
2023-04-22 17:19,984562,284182,492530,207850,984562
2023-04-22 17:20,984579,284193,492534,207852,984579
2023-04-22 17:22,984594,284207,492534,207853,984594
2023-04-22 17:23,984609,284213,492542,207854,984609
2023-04-22 17:24,984625,284227,492543,207855,984625
2023-04-22 17:25,984642,284242,492543,207857,984642
2023-04-22 17:26,984657,284252,492548,207857,984657
2023-04-22 17:27,984672,284267,492548,207857,984672
2023-04-22 17:28,984688,284276,492554,207858,984688
2023-04-22 17:29,984704,284286,492556,207862,984704
2023-04-22 17:30,984720,284296,492561,207863,984720
2023-04-22 17:31,984734,284300,492569,207865,984734
2023-04-22 17:32,984751,284314,492569,207868,984751
2023-04-22 17:33,984766,284320,492573,207873,984766
2023-04-22 17:34,984783,284333,492573,207877,984783
2023-04-22 17:35,984799,284342,492576,207881,984799
2023-04-22 17:36,984815,284357,492576,207882,984815
2023-04-22 17:37,984831,284366,492582,207883,984831
2023-04-22 17:38,984847,284380,492582,207885,984847
2023-04-22 17:39,984862,284389,492585,207888,984862
2023-04-22 17:40,984878,284400,492585,207893,984878
2023-04-22 17:41,984893,284409,492587,207897,984893
2023-04-22 17:42,984909,284421,492587,207901,984909
2023-04-22 17:43,984926,284430,492591,207905,984926
2023-04-22 17:44,984942,284443,492591,207908,984942
2023-04-22 17:45,984958,284448,492597,207913,984958
2023-04-22 17:46,984973,284462,492597,207914,984973
2023-04-22 17:47,984991,284475,492599,207917,984991
2023-04-22 17:48,985007,284489,492599,207919,985007
2023-04-22 17:49,985023,284498,492602,207923,985023
2023-04-22 17:50,985039,284513,492602,207924,985039
2023-04-22 17:51,985055,284523,492606,207926,985055
2023-04-22 17:52,985071,284537,492606,207928,985071
2023-04-22 17:53,985087,284547,492609,207931,985087
2023-04-22 17:54,985103,284561,492609,207933,985103
2023-04-22 17:55,985121,284574,492612,207935,985121
2023-04-22 17:56,985136,284584,492612,207940,985136
2023-04-22 17:57,985153,284596,492617,207940,985153
2023-04-22 17:58,985168,284610,492617,207941,985168
2023-04-22 17:59,985183,284616,492624,207943,985183
2023-04-22 18:00,985197,284627,492624,207946,985197
2023-04-22 18:01,985211,284637,492628,207946,985211
2023-04-22 18:02,985224,284650,492628,207946,985224
2023-04-22 18:03,985238,284658,492633,207947,985238
2023-04-22 18:04,985250,284669,492633,207948,985250
2023-04-22 18:05,985263,284678,492636,207949,985263
2023-04-22 18:06,985277,284689,492636,207952,985277
2023-04-22 18:07,985290,284701,492637,207952,985290
2023-04-22 18:08,985302,284709,492637,207956,985302
2023-04-22 18:10,985316,284720,492640,207956,985316
2023-04-22 18:11,985331,284732,492640,207959,985331
2023-04-22 18:12,985346,284745,492642,207959,985346
2023-04-22 18:13,985361,284756,492642,207963,985361
2023-04-22 18:14,985373,284762,492647,207964,985373
2023-04-22 18:15,985386,284773,492647,207966,985386
2023-04-22 18:16,985401,284785,492649,207967,985401
2023-04-22 18:17,985414,284797,492649,207968,985414
2023-04-22 18:18,985428,284805,492652,207971,985428
2023-04-22 18:19,985442,284817,492653,207972,985442
2023-04-22 18:20,985456,284829,492653,207974,985456
2023-04-22 18:21,985470,284833,492663,207974,985470
2023-04-22 18:22,985484,284845,492664,207975,985484
2023-04-22 18:23,985497,284857,492665,207975,985497
2023-04-22 18:24,985512,284869,492665,207978,985512
2023-04-22 18:25,985524,284873,492669,207982,985524
2023-04-22 18:26,985539,284884,492672,207983,985539
2023-04-22 18:27,985552,284895,492672,207985,985552
2023-04-22 18:28,985566,284903,492676,207987,985566
2023-04-22 18:29,985579,284913,492676,207990,985579
2023-04-22 18:30,985594,284920,492679,207995,985594
2023-04-22 18:31,985609,284926,492684,207999,985609
2023-04-22 18:32,985622,284931,492689,208002,985622
2023-04-22 18:33,985638,284936,492700,208002,985638
2023-04-22 18:34,985651,284946,492700,208005,985651
2023-04-22 18:35,985667,284952,492706,208009,985667
2023-04-22 18:36,985679,284954,492714,208011,985679
2023-04-22 18:37,985695,284961,492721,208013,985695
2023-04-22 18:38,985708,284973,492721,208014,985708
2023-04-22 18:39,985722,284981,492725,208016,985722
2023-04-22 18:40,985736,284992,492725,208019,985736
2023-04-22 18:41,985749,285000,492730,208019,985749
2023-04-22 18:42,985762,285011,492730,208021,985762
2023-04-22 18:43,985776,285015,492740,208021,985776
2023-04-22 18:44,985791,285028,492740,208023,985791
2023-04-22 18:45,985806,285032,492749,208025,985806
2023-04-22 18:46,985821,285045,492749,208027,985821
2023-04-22 18:47,985836,285055,492751,208030,985836
2023-04-22 18:48,985848,285061,492751,208036,985848
2023-04-22 18:49,985863,285065,492758,208040,985863
2023-04-22 18:50,985876,285076,492758,208042,985876
2023-04-22 18:51,985889,285084,492760,208045,985889
2023-04-22 18:52,985903,285095,492760,208048,985903
2023-04-22 18:53,985918,285099,492767,208052,985918
2023-04-22 18:54,985931,285109,492767,208055,985931
2023-04-22 18:55,985945,285116,492771,208058,985945
2023-04-22 18:57,985957,285127,492771,208059,985957
2023-04-22 18:58,985971,285131,492779,208061,985971
2023-04-22 18:59,985985,285142,492779,208064,985985
2023-04-22 19:00,985998,285142,492788,208068,985998
2023-04-22 19:01,986008,285152,492788,208068,986008
2023-04-22 19:02,986019,285156,492793,208070,986019
2023-04-22 19:03,986030,285162,492798,208070,986030
2023-04-22 19:04,986042,285161,492804,208077,986042
2023-04-22 19:05,986054,285173,492804,208077,986054
2023-04-22 19:06,986066,285176,492811,208079,986066
2023-04-22 19:07,986078,285185,492811,208082,986078
2023-04-22 19:08,986091,285189,492818,208084,986091
2023-04-22 19:09,986101,285197,492818,208086,986101
2023-04-22 19:10,986112,285201,492823,208088,986112
2023-04-22 19:11,986123,285202,492829,208092,986123
2023-04-22 19:12,986134,285209,492831,208094,986134
2023-04-22 19:13,986146,285218,492831,208097,986146
2023-04-22 19:14,986158,285218,492839,208101,986158
2023-04-22 19:15,986169,285223,492839,208107,986169
2023-04-22 19:16,986179,285222,492845,208112,986179
2023-04-22 19:17,986190,285232,492845,208113,986190
2023-04-22 19:18,986200,285235,492850,208115,986200
2023-04-22 19:19,986212,285246,492851,208115,986212
2023-04-22 19:20,986223,285252,492857,208114,986223
2023-04-22 19:21,986235,285262,492857,208116,986235
2023-04-22 19:22,986246,285264,492864,208118,986246
2023-04-22 19:23,986258,285275,492864,208119,986258
2023-04-22 19:24,986269,285277,492870,208122,986269
2023-04-22 19:25,986280,285285,492870,208125,986280
2023-04-22 19:26,986290,285292,492873,208125,986290
2023-04-22 19:27,986301,285295,492880,208126,986301
2023-04-22 19:28,986316,285308,492880,208128,986316
2023-04-22 19:29,986328,285314,492886,208128,986328
2023-04-22 19:30,986339,285325,492886,208128,986339
2023-04-22 19:31,986349,285327,492890,208132,986349
2023-04-22 19:32,986361,285337,492890,208134,986361
2023-04-22 19:33,986372,285339,492897,208136,986372
2023-04-22 19:34,986383,285348,492897,208138,986383
2023-04-22 19:35,986394,285348,492905,208141,986394
2023-04-22 19:36,986407,285361,492905,208141,986407
2023-04-22 19:37,986418,285367,492909,208142,986418
2023-04-22 19:38,986428,285375,492909,208144,986428
2023-04-22 19:39,986439,285381,492914,208144,986439
2023-04-22 19:40,986450,285390,492914,208146,986450
2023-04-22 19:41,986461,285393,492921,208147,986461
2023-04-22 19:42,986472,285401,492921,208150,986472
2023-04-22 19:44,986482,285404,492925,208153,986482
2023-04-22 19:45,986496,285416,492925,208155,986496
2023-04-22 19:46,986507,285423,492927,208157,986507
2023-04-22 19:47,986517,285431,492927,208159,986517
2023-04-22 19:48,986528,285434,492933,208161,986528
2023-04-22 19:49,986539,285444,492933,208162,986539
2023-04-22 19:50,986551,285451,492937,208163,986551
2023-04-22 19:51,986563,285458,492938,208167,986563
2023-04-22 19:52,986575,285460,492941,208174,986575
2023-04-22 19:53,986586,285463,492947,208176,986586
2023-04-22 19:54,986597,285473,492947,208177,986597
2023-04-22 19:55,986607,285475,492953,208179,986607
2023-04-22 19:56,986619,285485,492953,208181,986619
2023-04-22 19:57,986630,285490,492957,208183,986630
2023-04-22 19:58,986640,285498,492957,208185,986640
2023-04-22 19:59,986653,285502,492963,208188,986653
2023-04-22 20:00,986665,285512,492963,208190,986665
2023-04-22 20:01,986676,285522,492963,208191,986676
2023-04-22 20:02,986689,285533,492963,208193,986689
2023-04-22 20:03,986700,285543,492963,208194,986700
2023-04-22 20:04,986713,285554,492963,208196,986713
2023-04-22 20:05,986725,285564,492963,208198,986725
2023-04-22 20:06,986737,285570,492963,208204,986737
2023-04-22 20:07,986749,285578,492963,208208,986749
2023-04-22 20:08,986762,285588,492963,208211,986762
2023-04-22 20:09,986774,285582,492981,208211,986774
2023-04-22 20:10,986787,285591,492981,208215,986787
2023-04-22 20:11,986799,285598,492983,208218,986799
2023-04-22 20:12,986811,285608,492983,208220,986811
2023-04-22 20:13,986825,285616,492987,208222,986825
2023-04-22 20:14,986838,285625,492987,208226,986838
2023-04-22 20:15,986852,285632,492992,208228,986852
2023-04-22 20:16,986864,285637,492992,208235,986864
2023-04-22 20:17,986875,285647,492992,208236,986875
2023-04-22 20:18,986887,285656,492992,208239,986887
2023-04-22 20:19,986899,285667,492992,208240,986899
2023-04-22 20:20,986912,285675,492998,208239,986912
2023-04-22 20:21,986927,285681,493006,208240,986927
2023-04-22 20:22,986941,285693,493006,208242,986941
2023-04-22 20:23,986952,285701,493009,208242,986952
2023-04-22 20:24,986965,285711,493009,208245,986965
2023-04-22 20:25,986978,285723,493010,208245,986978
2023-04-22 20:26,986989,285733,493010,208246,986989
2023-04-22 20:27,987001,285739,493016,208246,987001
2023-04-22 20:28,987012,285748,493016,208248,987012
2023-04-22 20:29,987026,285757,493019,208250,987026
2023-04-22 20:31,987037,285766,493019,208252,987037
2023-04-22 20:32,987050,285778,493019,208253,987050
2023-04-22 20:33,987063,285780,493030,208253,987063
2023-04-22 20:34,987074,285792,493030,208252,987074
2023-04-22 20:35,987086,285798,493034,208254,987086
2023-04-22 20:36,987098,285807,493034,208257,987098
2023-04-22 20:37,987110,285809,493040,208261,987110
2023-04-22 20:38,987122,285821,493040,208261,987122
2023-04-22 20:39,987135,285832,493044,208259,987135
2023-04-22 20:40,987146,285842,493044,208260,987146
2023-04-22 20:41,987158,285845,493049,208264,987158
2023-04-22 20:42,987171,285857,493049,208265,987171
2023-04-22 20:43,987184,285870,493049,208265,987184
2023-04-22 20:44,987196,285874,493054,208268,987196
2023-04-22 20:45,987208,285884,493054,208270,987208
2023-04-22 20:46,987220,285886,493058,208276,987220
2023-04-22 20:47,987233,285897,493059,208277,987233
2023-04-22 20:48,987245,285907,493059,208279,987245
2023-04-22 20:49,987258,285915,493063,208280,987258
2023-04-22 20:50,987270,285923,493066,208281,987270
2023-04-22 20:51,987282,285934,493066,208282,987282
2023-04-22 20:52,987294,285940,493070,208284,987294
2023-04-22 20:53,987306,285948,493070,208288,987306
2023-04-22 20:54,987318,285952,493076,208290,987318
2023-04-22 20:55,987330,285962,493076,208292,987330
2023-04-22 20:56,987342,285964,493082,208296,987342
2023-04-22 20:57,987353,285973,493082,208298,987353
2023-04-22 20:58,987366,285978,493089,208299,987366
2023-04-22 20:59,987377,285986,493089,208302,987377
2023-04-22 21:00,987388,285992,493093,208303,987388
2023-04-22 21:01,987397,285998,493093,208306,987397
2023-04-22 21:02,987408,286005,493095,208308,987408
2023-04-22 21:03,987418,286007,493101,208310,987418
2023-04-22 21:04,987427,286013,493101,208313,987427
2023-04-22 21:05,987436,286014,493105,208317,987436
2023-04-22 21:06,987445,286021,493106,208318,987445
2023-04-22 21:07,987454,286029,493106,208319,987454
2023-04-22 21:08,987463,286033,493110,208320,987463
2023-04-22 21:09,987473,286042,493110,208321,987473
2023-04-22 21:10,987482,286043,493115,208324,987482
2023-04-22 21:11,987492,286052,493115,208325,987492
2023-04-22 21:12,987501,286058,493117,208326,987501
2023-04-22 21:13,987512,286067,493117,208328,987512
2023-04-22 21:14,987521,286067,493124,208330,987521
2023-04-22 21:15,987531,286075,493124,208332,987531
2023-04-22 21:16,987540,286076,493130,208334,987540
2023-04-22 21:18,987549,286082,493130,208337,987549
2023-04-22 21:19,987558,286084,493136,208338,987558
2023-04-22 21:20,987567,286091,493136,208340,987567
2023-04-22 21:21,987577,286094,493141,208342,987577
2023-04-22 21:22,987586,286098,493146,208342,987586
2023-04-22 21:23,987595,286104,493146,208345,987595
2023-04-22 21:24,987604,286102,493155,208347,987604
2023-04-22 21:25,987615,286108,493155,208352,987615
2023-04-22 21:26,987626,286111,493161,208354,987626
2023-04-22 21:27,987635,286116,493161,208358,987635
2023-04-22 21:28,987644,286117,493165,208362,987644
2023-04-22 21:29,987653,286123,493165,208365,987653
2023-04-22 21:30,987662,286126,493168,208368,987662
2023-04-22 21:31,987671,286133,493168,208370,987671
2023-04-22 21:32,987680,286136,493173,208371,987680
2023-04-22 21:33,987689,286145,493173,208371,987689
2023-04-22 21:34,987698,286143,493179,208376,987698
2023-04-22 21:35,987707,286148,493183,208376,987707
2023-04-22 21:36,987717,286155,493183,208379,987717
2023-04-22 21:37,987727,286160,493186,208381,987727
2023-04-22 21:38,987736,286161,493193,208382,987736
2023-04-22 21:39,987746,286168,493193,208385,987746
2023-04-22 21:40,987756,286164,493202,208390,987756
2023-04-22 21:41,987766,286175,493202,208389,987766
2023-04-22 21:42,987775,286176,493205,208394,987775
2023-04-22 21:43,987784,286184,493205,208395,987784
2023-04-22 21:44,987794,286188,493209,208397,987794
2023-04-22 21:45,987803,286197,493209,208397,987803
2023-04-22 21:46,987811,286200,493213,208398,987811
2023-04-22 21:47,987822,286208,493213,208401,987822
2023-04-22 21:48,987831,286209,493217,208405,987831
2023-04-22 21:49,987841,286218,493217,208406,987841
2023-04-22 21:50,987850,286222,493221,208407,987850
2023-04-22 21:51,987859,286230,493221,208408,987859
2023-04-22 21:52,987869,286227,493232,208410,987869
2023-04-22 21:53,987879,286230,493237,208412,987879
2023-04-22 21:54,987888,286234,493237,208417,987888
2023-04-22 21:55,987897,286237,493242,208418,987897
2023-04-22 21:56,987907,286245,493242,208420,987907
2023-04-22 21:57,987916,286240,493252,208424,987916
2023-04-22 21:58,987925,286245,493256,208424,987925
2023-04-22 21:59,987934,286249,493256,208429,987934
2023-04-22 22:00,987947,286246,493266,208435,987947
2023-04-22 22:01,987961,286259,493266,208436,987961
2023-04-22 22:02,987977,286266,493271,208440,987977
2023-04-22 22:03,987990,286276,493271,208443,987990
2023-04-22 22:05,988004,286282,493277,208445,988004
2023-04-22 22:06,988019,286297,493277,208445,988019
2023-04-22 22:07,988033,286304,493281,208448,988033
2023-04-22 22:08,988048,286315,493281,208452,988048
2023-04-22 22:09,988062,286324,493285,208453,988062
2023-04-22 22:10,988077,286339,493285,208453,988077
2023-04-22 22:11,988092,286343,493294,208455,988092
2023-04-22 22:12,988105,286356,493294,208455,988105
2023-04-22 22:13,988118,286358,493301,208459,988118
2023-04-22 22:14,988132,286371,493301,208460,988132
2023-04-22 22:15,988146,286379,493305,208462,988146
2023-04-22 22:16,988160,286386,493305,208469,988160
2023-04-22 22:17,988175,286394,493311,208470,988175
2023-04-22 22:18,988189,286407,493311,208471,988189
2023-04-22 22:19,988203,286416,493313,208474,988203
2023-04-22 22:20,988217,286427,493313,208477,988217
2023-04-22 22:21,988230,286434,493316,208480,988230
2023-04-22 22:22,988243,286445,493316,208482,988243
2023-04-22 22:23,988257,286452,493319,208486,988257
2023-04-22 22:24,988271,286461,493322,208488,988271
2023-04-22 22:25,988285,286473,493322,208490,988285
2023-04-22 22:26,988298,286482,493323,208493,988298
2023-04-22 22:27,988313,286491,493326,208496,988313
2023-04-22 22:28,988327,286497,493332,208498,988327
2023-04-22 22:29,988340,286506,493332,208502,988340
2023-04-22 22:30,988355,286517,493334,208504,988355
2023-04-22 22:31,988369,286528,493334,208507,988369
2023-04-22 22:32,988384,286533,493341,208510,988384
2023-04-22 22:33,988399,286544,493341,208514,988399
2023-04-22 22:34,988412,286553,493345,208514,988412
2023-04-22 22:35,988426,286564,493345,208517,988426
2023-04-22 22:36,988440,286572,493349,208519,988440
2023-04-22 22:37,988454,286585,493349,208520,988454
2023-04-22 22:38,988469,286588,493357,208524,988469
2023-04-22 22:39,988483,286600,493357,208526,988483
2023-04-22 22:40,988498,286608,493361,208529,988498
2023-04-22 22:41,988511,286620,493361,208530,988511
2023-04-22 22:42,988525,286624,493366,208535,988525
2023-04-22 22:43,988538,286628,493369,208541,988538
2023-04-22 22:44,988552,286637,493369,208546,988552
2023-04-22 22:45,988567,286643,493375,208549,988567
2023-04-22 22:46,988581,286649,493375,208557,988581
2023-04-22 22:47,988596,286650,493387,208559,988596
2023-04-22 22:48,988610,286660,493388,208562,988610
2023-04-22 22:49,988626,286669,493393,208564,988626
2023-04-22 22:50,988639,286679,493393,208567,988639
2023-04-22 22:51,988654,286684,493398,208572,988654
2023-04-22 22:53,988668,286698,493398,208572,988668
2023-04-22 22:54,988683,286705,493404,208574,988683
2023-04-22 22:55,988697,286719,493404,208574,988697
2023-04-22 22:56,988710,286729,493404,208577,988710
2023-04-22 22:57,988725,286743,493404,208578,988725
2023-04-22 22:58,988741,286751,493407,208583,988741
2023-04-22 22:59,988755,286761,493407,208587,988755
2023-04-22 23:00,988768,286765,493414,208589,988768
2023-04-22 23:01,988779,286772,493416,208591,988779
2023-04-22 23:02,988790,286781,493416,208593,988790
2023-04-22 23:03,988801,286787,493420,208594,988801
2023-04-22 23:04,988814,286799,493420,208595,988814
2023-04-22 23:05,988825,286800,493427,208598,988825
2023-04-22 23:06,988838,286811,493427,208600,988838
2023-04-22 23:07,988849,286818,493429,208602,988849
2023-04-22 23:08,988862,286828,493433,208601,988862
2023-04-22 23:09,988874,286839,493433,208602,988874
2023-04-22 23:10,988885,286842,493438,208605,988885
2023-04-22 23:11,988897,286851,493438,208608,988897
2023-04-22 23:12,988909,286852,493445,208612,988909
2023-04-22 23:13,988920,286862,493445,208613,988920
2023-04-22 23:14,988932,286868,493448,208616,988932
2023-04-22 23:15,988944,286880,493448,208616,988944
2023-04-22 23:16,988956,286886,493452,208618,988956
2023-04-22 23:17,988967,286894,493452,208621,988967
2023-04-22 23:18,988979,286898,493455,208626,988979
2023-04-22 23:19,988990,286907,493455,208628,988990
2023-04-22 23:20,989002,286915,493455,208632,989002
2023-04-22 23:21,989015,286923,493455,208637,989015
2023-04-22 23:22,989026,286930,493455,208641,989026
2023-04-22 23:23,989037,286926,493467,208644,989037
2023-04-22 23:24,989050,286935,493467,208648,989050
2023-04-22 23:25,989060,286935,493476,208649,989060
2023-04-22 23:26,989073,286947,493476,208650,989073
2023-04-22 23:27,989084,286948,493484,208652,989084
2023-04-22 23:28,989097,286960,493484,208653,989097
2023-04-22 23:29,989111,286966,493491,208654,989111
2023-04-22 23:30,989122,286975,493492,208655,989122
2023-04-22 23:31,989134,286982,493495,208657,989134
2023-04-22 23:32,989145,286991,493495,208659,989145
2023-04-22 23:33,989156,286997,493500,208659,989156
2023-04-22 23:34,989168,287007,493500,208661,989168
2023-04-22 23:35,989180,287007,493506,208667,989180
2023-04-22 23:36,989191,287014,493506,208671,989191
2023-04-22 23:37,989202,287014,493513,208675,989202
2023-04-22 23:39,989214,287024,493513,208677,989214
2023-04-22 23:40,989226,287028,493518,208680,989226
2023-04-22 23:41,989237,287038,493518,208681,989237
2023-04-22 23:42,989248,287041,493522,208685,989248
2023-04-22 23:43,989261,287052,493522,208687,989261
2023-04-22 23:44,989272,287058,493525,208689,989272
2023-04-22 23:45,989284,287066,493525,208693,989284
2023-04-22 23:46,989295,287069,493529,208697,989295
2023-04-22 23:47,989307,287076,493529,208702,989307
2023-04-22 23:48,989318,287078,493534,208706,989318
2023-04-22 23:49,989329,287085,493534,208710,989329
2023-04-22 23:50,989340,287085,493542,208713,989340
2023-04-22 23:51,989351,287094,493542,208715,989351
2023-04-22 23:52,989364,287098,493547,208719,989364
2023-04-22 23:53,989375,287106,493547,208722,989375
2023-04-22 23:54,989387,287113,493550,208724,989387
2023-04-22 23:55,989398,287120,493550,208728,989398
2023-04-22 23:56,989409,287125,493554,208730,989409
2023-04-22 23:57,989421,287133,493554,208734,989421
2023-04-22 23:58,989433,287139,493557,208737,989433
2023-04-22 23:59,989445,287148,493557,208740,989445
2023-04-23 00:00,989462,287154,493563,208745,989462
2023-04-23 00:01,989486,287176,493563,208747,989486
2023-04-23 00:02,989511,287192,493568,208751,989511
2023-04-23 00:03,989536,287212,493568,208756,989536
2023-04-23 00:04,989560,287231,493571,208758,989560
2023-04-23 00:05,989586,287254,493571,208761,989586
2023-04-23 00:06,989609,287270,493573,208766,989609
2023-04-23 00:07,989634,287288,493575,208771,989634
2023-04-23 00:08,989658,287311,493575,208772,989658
2023-04-23 00:09,989682,287324,493581,208777,989682
2023-04-23 00:10,989708,287346,493583,208779,989708
2023-04-23 00:11,989734,287369,493585,208780,989734
2023-04-23 00:12,989757,287391,493585,208781,989757
2023-04-23 00:13,989783,287410,493587,208786,989783
2023-04-23 00:14,989807,287432,493587,208788,989807
2023-04-23 00:15,989831,287448,493593,208790,989831
2023-04-23 00:16,989856,287472,493593,208791,989856
2023-04-23 00:17,989880,287484,493599,208797,989880
2023-04-23 00:18,989904,287505,493599,208800,989904
2023-04-23 00:19,989929,287519,493607,208803,989929
2023-04-23 00:20,989954,287543,493607,208804,989954
2023-04-23 00:21,989979,287563,493609,208807,989979
2023-04-23 00:22,990004,287588,493609,208807,990004
2023-04-23 00:23,990027,287605,493612,208810,990027
2023-04-23 00:25,990052,287629,493612,208811,990052
2023-04-23 00:26,990076,287646,493618,208812,990076
2023-04-23 00:27,990101,287669,493618,208814,990101
2023-04-23 00:28,990127,287687,493624,208816,990127
2023-04-23 00:29,990150,287706,493624,208820,990150
2023-04-23 00:30,990174,287727,493625,208822,990174
2023-04-23 00:31,990199,287746,493625,208828,990199
2023-04-23 00:32,990223,287764,493628,208831,990223
2023-04-23 00:33,990247,287785,493628,208834,990247
2023-04-23 00:34,990272,287807,493630,208835,990272
2023-04-23 00:35,990296,287828,493630,208838,990296
2023-04-23 00:36,990320,287846,493633,208841,990320
2023-04-23 00:37,990344,287866,493633,208845,990344
2023-04-23 00:38,990367,287881,493638,208848,990367
2023-04-23 00:39,990393,287907,493638,208848,990393
2023-04-23 00:40,990415,287924,493639,208852,990415
2023-04-23 00:41,990440,287945,493639,208856,990440
2023-04-23 00:42,990465,287962,493644,208859,990465
2023-04-23 00:43,990489,287981,493646,208862,990489
2023-04-23 00:44,990512,288002,493646,208864,990512
2023-04-23 00:45,990538,288023,493650,208865,990538
2023-04-23 00:46,990562,288045,493650,208867,990562
2023-04-23 00:47,990588,288068,493651,208869,990588
2023-04-23 00:48,990613,288093,493651,208869,990613
2023-04-23 00:49,990636,288112,493653,208871,990636
2023-04-23 00:50,990661,288134,493655,208872,990661
2023-04-23 00:51,990687,288156,493655,208876,990687
2023-04-23 00:52,990710,288173,493659,208878,990710
2023-04-23 00:53,990735,288191,493662,208882,990735
2023-04-23 00:54,990761,288215,493662,208884,990761
2023-04-23 00:55,990784,288233,493667,208884,990784
2023-04-23 00:56,990810,288258,493667,208885,990810
2023-04-23 00:57,990835,288272,493672,208891,990835
2023-04-23 00:58,990859,288293,493672,208894,990859
2023-04-23 00:59,990883,288316,493672,208895,990883
2023-04-23 01:00,990900,288332,493672,208896,990900
2023-04-23 01:01,990915,288338,493680,208897,990915
2023-04-23 01:02,990930,288353,493680,208897,990930
2023-04-23 01:03,990945,288364,493683,208898,990945
2023-04-23 01:04,990961,288377,493683,208901,990961
2023-04-23 01:05,990976,288389,493685,208902,990976
2023-04-23 01:06,990992,288401,493685,208906,990992
2023-04-23 01:07,991007,288409,493690,208908,991007
2023-04-23 01:08,991022,288420,493692,208910,991022
2023-04-23 01:09,991037,288432,493692,208913,991037
2023-04-23 01:10,991052,288446,493692,208914,991052
2023-04-23 01:11,991068,288461,493692,208915,991068
2023-04-23 01:13,991083,288470,493697,208916,991083
2023-04-23 01:14,991099,288483,493697,208919,991099
2023-04-23 01:15,991114,288493,493699,208922,991114
2023-04-23 01:16,991128,288505,493699,208924,991128
2023-04-23 01:17,991145,288517,493701,208927,991145
2023-04-23 01:18,991162,288534,493701,208927,991162
2023-04-23 01:19,991177,288546,493704,208927,991177
2023-04-23 01:20,991193,288561,493704,208928,991193
2023-04-23 01:21,991207,288569,493707,208931,991207
2023-04-23 01:22,991223,288584,493707,208932,991223
2023-04-23 01:23,991238,288593,493711,208934,991238
2023-04-23 01:24,991254,288608,493711,208935,991254
2023-04-23 01:25,991270,288622,493711,208937,991270
2023-04-23 01:26,991285,288635,493711,208939,991285
2023-04-23 01:27,991300,288644,493713,208943,991300
2023-04-23 01:28,991315,288659,493713,208943,991315
2023-04-23 01:29,991331,288671,493717,208943,991331
2023-04-23 01:30,991348,288686,493717,208945,991348
2023-04-23 01:31,991362,288696,493719,208947,991362
2023-04-23 01:32,991378,288711,493719,208948,991378
2023-04-23 01:33,991392,288721,493721,208950,991392
2023-04-23 01:34,991408,288735,493721,208952,991408
2023-04-23 01:35,991423,288742,493724,208957,991423
2023-04-23 01:36,991438,288757,493724,208957,991438
2023-04-23 01:37,991454,288769,493727,208958,991454
2023-04-23 01:38,991469,288779,493729,208961,991469
2023-04-23 01:39,991483,288793,493729,208961,991483
2023-04-23 01:40,991500,288809,493729,208962,991500
2023-04-23 01:41,991515,288824,493729,208962,991515
2023-04-23 01:42,991530,288838,493729,208963,991530
2023-04-23 01:43,991545,288853,493729,208963,991545
2023-04-23 01:44,991562,288870,493729,208963,991562
2023-04-23 01:45,991578,288886,493729,208963,991578
2023-04-23 01:46,991593,288896,493733,208964,991593
2023-04-23 01:47,991608,288908,493733,208967,991608
2023-04-23 01:48,991624,288922,493735,208967,991624
2023-04-23 01:49,991639,288937,493735,208967,991639
2023-04-23 01:50,991654,288950,493737,208967,991654
2023-04-23 01:51,991668,288964,493737,208967,991668
2023-04-23 01:52,991685,288980,493738,208967,991685
2023-04-23 01:53,991699,288994,493738,208967,991699
2023-04-23 01:54,991714,289003,493741,208970,991714
2023-04-23 01:55,991729,289018,493741,208970,991729
2023-04-23 01:56,991745,289027,493745,208973,991745
2023-04-23 01:57,991760,289042,493745,208973,991760
2023-04-23 01:58,991775,289050,493750,208975,991775
2023-04-23 01:59,991790,289065,493750,208975,991790
2023-04-23 02:00,991806,289078,493753,208975,991806
2023-04-23 02:01,991824,289096,493753,208975,991824
2023-04-23 02:03,991841,289109,493756,208976,991841
2023-04-23 02:04,991858,289123,493756,208979,991858
2023-04-23 02:05,991875,289139,493756,208980,991875
2023-04-23 02:06,991892,289153,493756,208983,991892
2023-04-23 02:07,991909,289167,493759,208983,991909
2023-04-23 02:08,991926,289184,493759,208983,991926
2023-04-23 02:09,991944,289201,493759,208984,991944
2023-04-23 02:10,991961,289217,493759,208985,991961
2023-04-23 02:11,991978,289229,493760,208989,991978
2023-04-23 02:12,991996,289245,493760,208991,991996
2023-04-23 02:13,992013,289259,493762,208992,992013
2023-04-23 02:14,992030,289275,493762,208993,992030
2023-04-23 02:15,992047,289291,493763,208993,992047
2023-04-23 02:16,992064,289306,493763,208995,992064
2023-04-23 02:17,992081,289321,493765,208995,992081
2023-04-23 02:18,992099,289338,493765,208996,992099
2023-04-23 02:19,992115,289353,493765,208997,992115
2023-04-23 02:20,992132,289370,493765,208997,992132
2023-04-23 02:21,992149,289386,493766,208997,992149
2023-04-23 02:22,992167,289404,493766,208997,992167
2023-04-23 02:23,992184,289418,493768,208998,992184
2023-04-23 02:24,992200,289433,493768,208999,992200
2023-04-23 02:25,992217,289448,493769,209000,992217
2023-04-23 02:26,992234,289464,493769,209001,992234
2023-04-23 02:27,992251,289479,493770,209002,992251
2023-04-23 02:28,992268,289496,493770,209002,992268
2023-04-23 02:29,992286,289514,493770,209002,992286
2023-04-23 02:30,992303,289529,493770,209004,992303
2023-04-23 02:31,992319,289546,493770,209003,992319
2023-04-23 02:32,992336,289563,493770,209003,992336
2023-04-23 02:33,992354,289580,493770,209004,992354
2023-04-23 02:34,992371,289595,493770,209006,992371
2023-04-23 02:35,992387,289610,493771,209006,992387
2023-04-23 02:36,992404,289625,493771,209008,992404
2023-04-23 02:37,992421,289641,493771,209009,992421
2023-04-23 02:38,992439,289658,493772,209009,992439
2023-04-23 02:39,992456,289675,493772,209009,992456
2023-04-23 02:40,992473,289692,493772,209009,992473
2023-04-23 02:41,992490,289708,493773,209009,992490
2023-04-23 02:42,992508,289726,493773,209009,992508
2023-04-23 02:43,992525,289743,493773,209009,992525
2023-04-23 02:44,992542,289759,493773,209010,992542
2023-04-23 02:45,992558,289774,493773,209011,992558
2023-04-23 02:46,992576,289792,493773,209011,992576
2023-04-23 02:47,992593,289807,493773,209013,992593
2023-04-23 02:48,992609,289823,493773,209013,992609
2023-04-23 02:50,992627,289840,493774,209013,992627
2023-04-23 02:51,992644,289857,493774,209013,992644
2023-04-23 02:52,992661,289871,493775,209015,992661
2023-04-23 02:53,992678,289887,493775,209016,992678
2023-04-23 02:54,992695,289902,493776,209017,992695
2023-04-23 02:55,992711,289918,493776,209017,992711
2023-04-23 02:56,992728,289934,493776,209018,992728
2023-04-23 02:57,992746,289950,493776,209020,992746
2023-04-23 02:58,992762,289963,493778,209021,992762
2023-04-23 02:59,992780,289980,493778,209022,992780
2023-04-23 03:00,992798,289998,493778,209022,992798
2023-04-23 03:01,992827,290027,493778,209022,992827
2023-04-23 03:02,992858,290056,493779,209023,992858
2023-04-23 03:03,992887,290084,493779,209024,992887
2023-04-23 03:04,992916,290113,493779,209024,992916
2023-04-23 03:05,992946,290143,493779,209024,992946
2023-04-23 03:06,992976,290173,493779,209024,992976
2023-04-23 03:07,993005,290202,493779,209024,993005
2023-04-23 03:08,993034,290231,493779,209024,993034
2023-04-23 03:09,993065,290262,493779,209024,993065
2023-04-23 03:10,993095,290291,493780,209024,993095
2023-04-23 03:11,993125,290321,493780,209024,993125
2023-04-23 03:12,993154,290348,493780,209026,993154
2023-04-23 03:13,993185,290377,493781,209027,993185
2023-04-23 03:14,993213,290404,493781,209028,993213
2023-04-23 03:15,993242,290431,493782,209029,993242
2023-04-23 03:16,993272,290461,493782,209029,993272
2023-04-23 03:17,993302,290490,493783,209029,993302
2023-04-23 03:18,993333,290521,493783,209029,993333
2023-04-23 03:19,993363,290549,493783,209031,993363
2023-04-23 03:20,993393,290578,493783,209032,993393
2023-04-23 03:21,993422,290606,493784,209032,993422
2023-04-23 03:22,993450,290634,493784,209032,993450
2023-04-23 03:23,993481,290665,493784,209032,993481
2023-04-23 03:24,993509,290692,493784,209033,993509
2023-04-23 03:25,993539,290722,493784,209033,993539
2023-04-23 03:26,993568,290750,493784,209034,993568
2023-04-23 03:27,993597,290776,493786,209035,993597
2023-04-23 03:28,993627,290806,493786,209035,993627
2023-04-23 03:29,993656,290834,493787,209035,993656
2023-04-23 03:30,993688,290866,493787,209035,993688
2023-04-23 03:31,993717,290893,493788,209036,993717
2023-04-23 03:32,993746,290922,493788,209036,993746
2023-04-23 03:33,993775,290950,493788,209037,993775
2023-04-23 03:34,993805,290980,493788,209037,993805
2023-04-23 03:35,993832,291006,493788,209038,993832
2023-04-23 03:37,993864,291035,493788,209041,993864
2023-04-23 03:38,993893,291062,493790,209041,993893
2023-04-23 03:39,993922,291090,493791,209041,993922
2023-04-23 03:40,993952,291120,493791,209041,993952
2023-04-23 03:41,993981,291147,493792,209042,993981
2023-04-23 03:42,994009,291173,493793,209043,994009
2023-04-23 03:43,994038,291202,493793,209043,994038
2023-04-23 03:44,994068,291232,493793,209043,994068
2023-04-23 03:45,994098,291261,493793,209044,994098
2023-04-23 03:46,994128,291291,493793,209044,994128
2023-04-23 03:47,994157,291319,493793,209045,994157
2023-04-23 03:48,994185,291347,493793,209045,994185
2023-04-23 03:49,994216,291378,493793,209045,994216
2023-04-23 03:50,994245,291407,493793,209045,994245
2023-04-23 03:51,994275,291436,493793,209046,994275
2023-04-23 03:52,994302,291458,493798,209046,994302
2023-04-23 03:53,994332,291488,493798,209046,994332
2023-04-23 03:54,994361,291516,493798,209047,994361
2023-04-23 03:55,994392,291547,493798,209047,994392
2023-04-23 03:56,994420,291575,493798,209047,994420
2023-04-23 03:57,994450,291604,493798,209048,994450
2023-04-23 03:58,994481,291635,493798,209048,994481
2023-04-23 03:59,994510,291664,493798,209048,994510
2023-04-23 04:00,994538,291692,493798,209048,994538
2023-04-23 04:01,994565,291715,493801,209049,994565
2023-04-23 04:02,994589,291738,493801,209050,994589
2023-04-23 04:03,994617,291766,493801,209050,994617
2023-04-23 04:04,994643,291792,493801,209050,994643
2023-04-23 04:05,994669,291818,493801,209050,994669
2023-04-23 04:06,994694,291843,493801,209050,994694
2023-04-23 04:07,994722,291869,493802,209051,994722
2023-04-23 04:08,994746,291891,493802,209053,994746
2023-04-23 04:09,994773,291916,493804,209053,994773
2023-04-23 04:10,994799,291941,493804,209054,994799
2023-04-23 04:11,994824,291966,493804,209054,994824
2023-04-23 04:12,994852,291993,493804,209055,994852
2023-04-23 04:13,994878,292017,493805,209056,994878
2023-04-23 04:14,994904,292043,493805,209056,994904
2023-04-23 04:15,994931,292070,493805,209056,994931
2023-04-23 04:16,994957,292096,493805,209056,994957
2023-04-23 04:17,994983,292121,493806,209056,994983
2023-04-23 04:18,995009,292146,493806,209057,995009
2023-04-23 04:19,995036,292170,493808,209058,995036
2023-04-23 04:20,995062,292196,493808,209058,995062
2023-04-23 04:21,995088,292221,493809,209058,995088
2023-04-23 04:22,995113,292246,493809,209058,995113
2023-04-23 04:24,995139,292272,493809,209058,995139
2023-04-23 04:25,995165,292298,493809,209058,995165
2023-04-23 04:26,995193,292325,493810,209058,995193
2023-04-23 04:27,995218,292350,493810,209058,995218
2023-04-23 04:28,995243,292374,493811,209058,995243
2023-04-23 04:29,995271,292402,493811,209058,995271
2023-04-23 04:30,995297,292427,493812,209058,995297
2023-04-23 04:31,995323,292453,493812,209058,995323
2023-04-23 04:32,995348,292478,493812,209058,995348
2023-04-23 04:33,995375,292505,493812,209058,995375
2023-04-23 04:34,995401,292530,493813,209058,995401
2023-04-23 04:35,995426,292555,493813,209058,995426
2023-04-23 04:36,995452,292580,493814,209058,995452
2023-04-23 04:37,995480,292608,493814,209058,995480
2023-04-23 04:38,995505,292633,493814,209058,995505
2023-04-23 04:39,995533,292660,493814,209059,995533
2023-04-23 04:40,995558,292686,493813,209059,995558
2023-04-23 04:41,995584,292712,493813,209059,995584
2023-04-23 04:42,995611,292739,493813,209059,995611
2023-04-23 04:43,995637,292763,493813,209061,995637
2023-04-23 04:44,995663,292789,493813,209061,995663
2023-04-23 04:45,995689,292815,493813,209061,995689
2023-04-23 04:46,995714,292840,493813,209061,995714
2023-04-23 04:47,995740,292866,493813,209061,995740
2023-04-23 04:48,995768,292893,493813,209062,995768
2023-04-23 04:49,995793,292918,493813,209062,995793
2023-04-23 04:50,995820,292945,493813,209062,995820
2023-04-23 04:51,995845,292970,493813,209062,995845
2023-04-23 04:52,995872,292995,493815,209062,995872
2023-04-23 04:53,995898,293021,493815,209062,995898
2023-04-23 04:54,995924,293047,493815,209062,995924
2023-04-23 04:55,995949,293070,493815,209064,995949
2023-04-23 04:56,995975,293094,493817,209064,995975
2023-04-23 04:57,996004,293122,493817,209065,996004
2023-04-23 04:58,996030,293148,493817,209065,996030
2023-04-23 04:59,996054,293172,493817,209065,996054
2023-04-23 05:00,996074,293192,493817,209065,996074
2023-04-23 05:01,996090,293207,493817,209066,996090
2023-04-23 05:02,996106,293223,493817,209066,996106
2023-04-23 05:03,996124,293241,493817,209066,996124
2023-04-23 05:04,996139,293256,493817,209066,996139
2023-04-23 05:05,996155,293272,493817,209066,996155
2023-04-23 05:06,996172,293288,493817,209067,996172
2023-04-23 05:07,996189,293304,493817,209068,996189
2023-04-23 05:08,996205,293319,493818,209068,996205
2023-04-23 05:09,996221,293335,493818,209068,996221
2023-04-23 05:10,996237,293352,493817,209068,996237
2023-04-23 05:12,996253,293368,493817,209068,996253
2023-04-23 05:13,996271,293384,493819,209068,996271
2023-04-23 05:14,996287,293400,493819,209068,996287
2023-04-23 05:15,996303,293415,493820,209068,996303
2023-04-23 05:16,996319,293430,493821,209068,996319
2023-04-23 05:17,996336,293447,493821,209068,996336
2023-04-23 05:18,996352,293462,493822,209068,996352
2023-04-23 05:19,996369,293479,493822,209068,996369
2023-04-23 05:20,996384,293493,493822,209069,996384
2023-04-23 05:21,996400,293508,493823,209069,996400
2023-04-23 05:22,996418,293526,493823,209069,996418
2023-04-23 05:23,996434,293542,493823,209069,996434
2023-04-23 05:24,996450,293557,493823,209070,996450
2023-04-23 05:25,996466,293573,493823,209070,996466
2023-04-23 05:26,996482,293589,493823,209070,996482
2023-04-23 05:27,996498,293604,493824,209070,996498
2023-04-23 05:28,996516,293622,493824,209070,996516
2023-04-23 05:29,996532,293638,493824,209070,996532
2023-04-23 05:30,996548,293654,493824,209070,996548
2023-04-23 05:31,996564,293669,493825,209070,996564
2023-04-23 05:32,996581,293684,493825,209072,996581
2023-04-23 05:33,996597,293699,493826,209072,996597
2023-04-23 05:34,996614,293716,493826,209072,996614
2023-04-23 05:35,996630,293731,493827,209072,996630
2023-04-23 05:36,996647,293748,493827,209072,996647
2023-04-23 05:37,996662,293761,493827,209074,996662
2023-04-23 05:38,996678,293777,493827,209074,996678
2023-04-23 05:39,996695,293794,493827,209074,996695
2023-04-23 05:40,996712,293811,493827,209074,996712
2023-04-23 05:41,996728,293824,493830,209074,996728
2023-04-23 05:42,996745,293841,493830,209074,996745
2023-04-23 05:43,996761,293855,493831,209075,996761
2023-04-23 05:44,996777,293871,493831,209075,996777
2023-04-23 05:45,996794,293888,493831,209075,996794
2023-04-23 05:46,996811,293905,493831,209075,996811
2023-04-23 05:47,996827,293921,493831,209075,996827
2023-04-23 05:48,996844,293937,493831,209076,996844
2023-04-23 05:49,996860,293951,493832,209077,996860
2023-04-23 05:50,996875,293967,493832,209076,996875
2023-04-23 05:51,996893,293984,493832,209077,996893
2023-04-23 05:52,996909,294000,493832,209077,996909
2023-04-23 05:53,996925,294015,493832,209078,996925
2023-04-23 05:54,996941,294029,493832,209080,996941
2023-04-23 05:55,996958,294046,493832,209080,996958
2023-04-23 05:56,996974,294062,493832,209080,996974
2023-04-23 05:57,996990,294077,493833,209080,996990
2023-04-23 05:59,997007,294093,493833,209081,997007
2023-04-23 06:00,997024,294110,493833,209081,997024
2023-04-23 06:01,997042,294127,493833,209082,997042
2023-04-23 06:02,997058,294140,493834,209084,997058
2023-04-23 06:03,997075,294157,493834,209084,997075
2023-04-23 06:04,997092,294173,493834,209085,997092
2023-04-23 06:05,997110,294191,493834,209085,997110
2023-04-23 06:06,997126,294206,493835,209085,997126
2023-04-23 06:07,997144,294223,493835,209086,997144
2023-04-23 06:08,997161,294240,493835,209086,997161
2023-04-23 06:09,997178,294256,493835,209087,997178
2023-04-23 06:10,997195,294270,493836,209089,997195
2023-04-23 06:11,997213,294288,493836,209089,997213
2023-04-23 06:12,997230,294303,493838,209089,997230
2023-04-23 06:13,997247,294319,493838,209090,997247
2023-04-23 06:14,997264,294334,493838,209092,997264
2023-04-23 06:15,997281,294348,493838,209095,997281
2023-04-23 06:16,997298,294365,493838,209095,997298
2023-04-23 06:17,997315,294381,493838,209096,997315
2023-04-23 06:18,997332,294394,493840,209098,997332
2023-04-23 06:19,997349,294410,493840,209099,997349
2023-04-23 06:20,997367,294427,493840,209100,997367
2023-04-23 06:21,997383,294442,493840,209101,997383
2023-04-23 06:22,997400,294457,493841,209102,997400
2023-04-23 06:23,997417,294474,493841,209102,997417
2023-04-23 06:24,997434,294488,493842,209104,997434
2023-04-23 06:25,997452,294506,493842,209104,997452
2023-04-23 06:26,997468,294520,493842,209106,997468
2023-04-23 06:27,997485,294537,493842,209106,997485
2023-04-23 06:28,997503,294552,493843,209108,997503
2023-04-23 06:29,997520,294568,493843,209109,997520
2023-04-23 06:30,997537,294584,493844,209109,997537
2023-04-23 06:31,997555,294601,493844,209110,997555
2023-04-23 06:32,997570,294614,493846,209110,997570
2023-04-23 06:33,997588,294632,493846,209110,997588
2023-04-23 06:34,997605,294649,493844,209112,997605
2023-04-23 06:35,997622,294666,493844,209112,997622
2023-04-23 06:36,997639,294683,493844,209112,997639
2023-04-23 06:37,997656,294699,493844,209113,997656
2023-04-23 06:38,997673,294716,493844,209113,997673
2023-04-23 06:39,997691,294734,493844,209113,997691
2023-04-23 06:40,997708,294749,493844,209115,997708
2023-04-23 06:41,997725,294766,493844,209115,997725
2023-04-23 06:42,997742,294779,493844,209119,997742
2023-04-23 06:43,997760,294796,493844,209120,997760
2023-04-23 06:44,997777,294812,493844,209121,997777
2023-04-23 06:46,997795,294829,493844,209122,997795
2023-04-23 06:47,997810,294843,493845,209122,997810
2023-04-23 06:48,997828,294859,493845,209124,997828
2023-04-23 06:49,997845,294875,493846,209124,997845
2023-04-23 06:50,997862,294889,493846,209127,997862
2023-04-23 06:51,997879,294903,493847,209129,997879
2023-04-23 06:52,997896,294918,493847,209131,997896
2023-04-23 06:53,997913,294932,493849,209132,997913
2023-04-23 06:54,997932,294950,493849,209133,997932
2023-04-23 06:55,997948,294965,493850,209133,997948
2023-04-23 06:56,997965,294981,493850,209134,997965
2023-04-23 06:57,997983,294996,493852,209135,997983
2023-04-23 06:58,998000,295013,493852,209135,998000
2023-04-23 06:59,998016,295027,493854,209135,998016
2023-04-23 07:00,998034,295044,493854,209136,998034
2023-04-23 07:01,998054,295061,493857,209136,998054
2023-04-23 07:02,998071,295078,493857,209136,998071
2023-04-23 07:03,998091,295096,493858,209137,998091
2023-04-23 07:04,998109,295111,493858,209140,998109
2023-04-23 07:05,998127,295127,493858,209142,998127
2023-04-23 07:06,998145,295144,493858,209143,998145
2023-04-23 07:07,998164,295160,493860,209144,998164
2023-04-23 07:08,998182,295177,493860,209145,998182
2023-04-23 07:09,998202,295193,493861,209148,998202
2023-04-23 07:10,998220,295210,493861,209149,998220
2023-04-23 07:11,998239,295225,493862,209152,998239
2023-04-23 07:12,998257,295242,493862,209153,998257
2023-04-23 07:13,998275,295256,493864,209155,998275
2023-04-23 07:14,998296,295273,493864,209159,998296
2023-04-23 07:15,998314,295290,493865,209159,998314
2023-04-23 07:16,998333,295307,493865,209161,998333
2023-04-23 07:17,998352,295321,493866,209165,998352
2023-04-23 07:18,998370,295335,493866,209169,998370
2023-04-23 07:19,998389,295353,493866,209170,998389
2023-04-23 07:20,998408,295370,493866,209172,998408
2023-04-23 07:21,998428,295388,493867,209173,998428
2023-04-23 07:22,998447,295407,493867,209173,998447
2023-04-23 07:23,998465,295419,493868,209178,998465
2023-04-23 07:24,998483,295436,493868,209179,998483
2023-04-23 07:25,998502,295455,493867,209180,998502
2023-04-23 07:26,998521,295472,493867,209182,998521
2023-04-23 07:27,998540,295488,493868,209184,998540
2023-04-23 07:28,998559,295507,493868,209184,998559
2023-04-23 07:29,998577,295522,493870,209185,998577
2023-04-23 07:30,998597,295540,493870,209187,998597
2023-04-23 07:31,998616,295556,493870,209190,998616
2023-04-23 07:33,998634,295573,493870,209191,998634
2023-04-23 07:34,998653,295590,493871,209192,998653
2023-04-23 07:35,998672,295608,493871,209193,998672
2023-04-23 07:36,998689,295624,493872,209193,998689
2023-04-23 07:37,998708,295641,493872,209195,998708
2023-04-23 07:38,998727,295657,493873,209197,998727
2023-04-23 07:39,998746,295675,493873,209198,998746
2023-04-23 07:40,998764,295689,493875,209200,998764
2023-04-23 07:41,998782,295706,493875,209201,998782
2023-04-23 07:42,998802,295723,493875,209204,998802
2023-04-23 07:43,998821,295740,493875,209206,998821
2023-04-23 07:44,998839,295752,493876,209211,998839
2023-04-23 07:45,998858,295769,493876,209213,998858
2023-04-23 07:46,998877,295785,493876,209216,998877
2023-04-23 07:47,998895,295801,493876,209218,998895
2023-04-23 07:48,998914,295819,493877,209218,998914
2023-04-23 07:49,998934,295838,493877,209219,998934
2023-04-23 07:50,998952,295855,493877,209220,998952
2023-04-23 07:51,998970,295871,493877,209222,998970
2023-04-23 07:52,998989,295887,493878,209224,998989
2023-04-23 07:53,999008,295904,493878,209226,999008
2023-04-23 07:54,999027,295920,493879,209228,999027
2023-04-23 07:55,999048,295940,493879,209229,999048
2023-04-23 07:56,999067,295958,493879,209230,999067
2023-04-23 07:57,999085,295970,493880,209235,999085
2023-04-23 07:58,999103,295987,493880,209236,999103
2023-04-23 07:59,999122,296003,493882,209237,999122
2023-04-23 08:00,999139,296019,493882,209238,999139
2023-04-23 08:01,999154,296031,493884,209239,999154
2023-04-23 08:02,999170,296044,493884,209242,999170
2023-04-23 08:03,999185,296056,493885,209244,999185
2023-04-23 08:04,999201,296066,493885,209250,999201
2023-04-23 08:05,999216,296079,493887,209250,999216
2023-04-23 08:06,999232,296094,493887,209251,999232
2023-04-23 08:07,999248,296106,493887,209255,999248
2023-04-23 08:08,999264,296121,493887,209256,999264
2023-04-23 08:09,999280,296126,493893,209261,999280
2023-04-23 08:10,999295,296140,493893,209262,999295
2023-04-23 08:11,999310,296146,493896,209268,999310
2023-04-23 08:12,999326,296159,493896,209271,999326
2023-04-23 08:13,999342,296169,493899,209274,999342
2023-04-23 08:14,999358,296181,493899,209278,999358
2023-04-23 08:15,999373,296195,493900,209278,999373
2023-04-23 08:16,999389,296210,493900,209279,999389
2023-04-23 08:17,999404,296225,493901,209278,999404
2023-04-23 08:18,999420,296241,493901,209278,999420
2023-04-23 08:19,999436,296253,493902,209281,999436
2023-04-23 08:21,999452,296268,493902,209282,999452
2023-04-23 08:22,999467,296282,493903,209282,999467
2023-04-23 08:23,999485,296297,493903,209285,999485
2023-04-23 08:24,999501,296311,493905,209285,999501
2023-04-23 08:25,999516,296325,493905,209286,999516
2023-04-23 08:26,999532,296338,493905,209289,999532
2023-04-23 08:27,999548,296353,493905,209290,999548
2023-04-23 08:28,999566,296366,493908,209292,999566
2023-04-23 08:29,999582,296378,493908,209296,999582
2023-04-23 08:30,999598,296392,493910,209296,999598
2023-04-23 08:31,999614,296406,493910,209298,999614
2023-04-23 08:32,999629,296416,493912,209301,999629
2023-04-23 08:33,999645,296432,493912,209301,999645
2023-04-23 08:34,999661,296446,493913,209302,999661
2023-04-23 08:35,999677,296461,493913,209303,999677
2023-04-23 08:36,999692,296476,493913,209303,999692
2023-04-23 08:37,999708,296490,493913,209305,999708
2023-04-23 08:38,999723,296503,493913,209307,999723
2023-04-23 08:39,999740,296519,493913,209308,999740
2023-04-23 08:40,999756,296533,493913,209310,999756
2023-04-23 08:41,999774,296547,493913,209314,999774
2023-04-23 08:42,999791,296561,493913,209317,999791
2023-04-23 08:43,999807,296575,493913,209319,999807
2023-04-23 08:44,999823,296588,493913,209322,999823
2023-04-23 08:45,999839,296600,493913,209326,999839
2023-04-23 08:46,999855,296610,493918,209327,999855
2023-04-23 08:47,999870,296623,493918,209329,999870
2023-04-23 08:48,999886,296637,493918,209331,999886
2023-04-23 08:49,999902,296651,493918,209333,999902
2023-04-23 08:50,999919,296665,493918,209336,999919
2023-04-23 08:51,999936,296681,493918,209337,999936
2023-04-23 08:52,999952,296695,493918,209339,999952
2023-04-23 08:53,999967,296701,493925,209341,999967
2023-04-23 08:54,999983,296714,493925,209344,999983
2023-04-23 08:55,999998,296729,493925,209344,999998
2023-04-23 08:56,1000015,296745,493925,209345,1000015
2023-04-23 08:57,1000030,296755,493928,209347,1000030
2023-04-23 08:58,1000046,296766,493929,209351,1000046
2023-04-23 08:59,1000061,296781,493929,209351,1000061
2023-04-23 09:00,1000085,296795,493933,209357,1000085
2023-04-23 09:01,1000114,296823,493933,209358,1000114
2023-04-23 09:02,1000140,296845,493933,209362,1000140
2023-04-23 09:03,1000168,296871,493933,209364,1000168
2023-04-23 09:04,1000194,296890,493936,209368,1000194
2023-04-23 09:05,1000221,296916,493936,209369,1000221
2023-04-23 09:06,1000248,296938,493940,209370,1000248
2023-04-23 09:07,1000274,296962,493940,209372,1000274
2023-04-23 09:09,1000301,296985,493943,209373,1000301
2023-04-23 09:10,1000329,297011,493943,209375,1000329
2023-04-23 09:11,1000356,297034,493945,209377,1000356
2023-04-23 09:12,1000384,297058,493948,209378,1000384
2023-04-23 09:13,1000410,297079,493948,209383,1000410
2023-04-23 09:14,1000438,297100,493953,209385,1000438
2023-04-23 09:15,1000466,297125,493954,209387,1000466
2023-04-23 09:16,1000492,297149,493954,209389,1000492
2023-04-23 09:17,1000518,297169,493958,209391,1000518
2023-04-23 09:18,1000545,297192,493960,209393,1000545
2023-04-23 09:19,1000574,297221,493960,209393,1000574
2023-04-23 09:20,1000602,297245,493962,209395,1000602
2023-04-23 09:21,1000628,297268,493962,209398,1000628
2023-04-23 09:22,1000655,297294,493962,209399,1000655
2023-04-23 09:23,1000682,297319,493962,209401,1000682
2023-04-23 09:24,1000708,297341,493962,209405,1000708
2023-04-23 09:25,1000734,297365,493962,209407,1000734
2023-04-23 09:26,1000761,297390,493962,209409,1000761
2023-04-23 09:27,1000789,297410,493969,209410,1000789
2023-04-23 09:28,1000817,297436,493969,209412,1000817
2023-04-23 09:29,1000843,297458,493971,209414,1000843
2023-04-23 09:30,1000870,297483,493971,209416,1000870
2023-04-23 09:31,1000899,297508,493974,209417,1000899
2023-04-23 09:32,1000925,297532,493974,209419,1000925
2023-04-23 09:33,1000951,297555,493975,209421,1000951
2023-04-23 09:34,1000980,297581,493976,209423,1000980
2023-04-23 09:35,1001008,297604,493976,209428,1001008
2023-04-23 09:36,1001033,297617,493982,209434,1001033
2023-04-23 09:37,1001061,297644,493982,209435,1001061
2023-04-23 09:38,1001088,297668,493983,209437,1001088
2023-04-23 09:39,1001116,297692,493983,209441,1001116
2023-04-23 09:40,1001141,297713,493984,209444,1001141
2023-04-23 09:41,1001169,297741,493984,209444,1001169
2023-04-23 09:42,1001196,297764,493986,209446,1001196
2023-04-23 09:43,1001224,297789,493986,209449,1001224
2023-04-23 09:44,1001249,297812,493987,209450,1001249
2023-04-23 09:45,1001275,297837,493987,209451,1001275
2023-04-23 09:46,1001305,297863,493988,209454,1001305
2023-04-23 09:47,1001331,297881,493988,209462,1001331
2023-04-23 09:48,1001360,297905,493988,209467,1001360
2023-04-23 09:49,1001389,297928,493988,209473,1001389
2023-04-23 09:50,1001420,297949,493993,209478,1001420
2023-04-23 09:51,1001446,297972,493993,209481,1001446
2023-04-23 09:52,1001471,297996,493994,209481,1001471
2023-04-23 09:53,1001500,298021,493994,209485,1001500
2023-04-23 09:54,1001526,298035,493998,209493,1001526
2023-04-23 09:56,1001553,298058,493998,209497,1001553
2023-04-23 09:57,1001580,298080,493998,209502,1001580
2023-04-23 09:58,1001608,298106,493998,209504,1001608
2023-04-23 09:59,1001637,298128,493999,209510,1001637
2023-04-23 10:00,1001662,298149,493999,209514,1001662
2023-04-23 10:01,1001674,298156,494003,209515,1001674
2023-04-23 10:02,1001685,298163,494003,209519,1001685
2023-04-23 10:03,1001696,298166,494006,209524,1001696
2023-04-23 10:04,1001708,298174,494006,209528,1001708
2023-04-23 10:05,1001720,298178,494011,209531,1001720
2023-04-23 10:06,1001732,298187,494011,209534,1001732
2023-04-23 10:07,1001743,298193,494012,209538,1001743
2023-04-23 10:08,1001757,298201,494012,209544,1001757
2023-04-23 10:09,1001768,298203,494015,209550,1001768
2023-04-23 10:10,1001780,298211,494015,209554,1001780
2023-04-23 10:11,1001792,298220,494017,209555,1001792
2023-04-23 10:12,1001803,298229,494017,209557,1001803
2023-04-23 10:13,1001815,298232,494020,209563,1001815
2023-04-23 10:14,1001827,298242,494020,209565,1001827
2023-04-23 10:15,1001838,298245,494022,209571,1001838
2023-04-23 10:16,1001849,298253,494022,209574,1001849
2023-04-23 10:17,1001862,298259,494023,209580,1001862
2023-04-23 10:18,1001874,298266,494023,209585,1001874
2023-04-23 10:19,1001885,298274,494024,209587,1001885
2023-04-23 10:20,1001897,298283,494024,209590,1001897
2023-04-23 10:21,1001908,298286,494026,209596,1001908
2023-04-23 10:22,1001921,298292,494026,209603,1001921
2023-04-23 10:23,1001933,298297,494030,209606,1001933
2023-04-23 10:24,1001945,298306,494030,209609,1001945
2023-04-23 10:25,1001958,298312,494032,209614,1001958
2023-04-23 10:26,1001969,298319,494032,209618,1001969
2023-04-23 10:27,1001980,298325,494034,209621,1001980
2023-04-23 10:28,1001992,298332,494034,209626,1001992
2023-04-23 10:29,1002003,298338,494035,209630,1002003
2023-04-23 10:30,1002015,298348,494035,209632,1002015
2023-04-23 10:31,1002027,298355,494037,209635,1002027
2023-04-23 10:32,1002038,298359,494037,209642,1002038
2023-04-23 10:33,1002050,298366,494038,209646,1002050
2023-04-23 10:34,1002062,298374,494038,209650,1002062
2023-04-23 10:35,1002074,298381,494041,209652,1002074
2023-04-23 10:36,1002087,298394,494041,209652,1002087
2023-04-23 10:37,1002098,298396,494044,209658,1002098
2023-04-23 10:38,1002109,298406,494044,209659,1002109
2023-04-23 10:39,1002121,298409,494049,209663,1002121
2023-04-23 10:40,1002132,298418,494049,209665,1002132
2023-04-23 10:41,1002144,298428,494049,209667,1002144
2023-04-23 10:43,1002156,298435,494050,209671,1002156
2023-04-23 10:44,1002169,298448,494050,209671,1002169
2023-04-23 10:45,1002181,298452,494055,209674,1002181
2023-04-23 10:46,1002194,298459,494055,209680,1002194
2023-04-23 10:47,1002207,298462,494058,209687,1002207
2023-04-23 10:48,1002219,298469,494058,209692,1002219
2023-04-23 10:49,1002230,298480,494058,209692,1002230
2023-04-23 10:50,1002242,298490,494058,209694,1002242
2023-04-23 10:51,1002255,298501,494059,209695,1002255
2023-04-23 10:52,1002266,298505,494060,209701,1002266
2023-04-23 10:53,1002278,298513,494060,209705,1002278
2023-04-23 10:54,1002289,298516,494063,209710,1002289
2023-04-23 10:55,1002301,298527,494063,209711,1002301
2023-04-23 10:56,1002313,298532,494069,209712,1002313
2023-04-23 10:57,1002326,298538,494069,209719,1002326
2023-04-23 10:58,1002337,298544,494071,209722,1002337
2023-04-23 10:59,1002350,298552,494071,209727,1002350
2023-04-23 11:00,1002362,298561,494073,209728,1002362
2023-04-23 11:01,1002375,298574,494073,209728,1002375
2023-04-23 11:02,1002390,298584,494074,209732,1002390
2023-04-23 11:03,1002406,298596,494074,209736,1002406
2023-04-23 11:04,1002420,298605,494076,209739,1002420
2023-04-23 11:05,1002435,298617,494076,209742,1002435
2023-04-23 11:06,1002450,298619,494079,209752,1002450
2023-04-23 11:07,1002464,298627,494079,209758,1002464
2023-04-23 11:08,1002480,298632,494079,209769,1002480
2023-04-23 11:09,1002494,298639,494079,209776,1002494
2023-04-23 11:10,1002507,298644,494079,209784,1002507
2023-04-23 11:11,1002522,298646,494079,209797,1002522
2023-04-23 11:12,1002537,298654,494082,209801,1002537
2023-04-23 11:13,1002552,298659,494082,209811,1002552
2023-04-23 11:14,1002566,298657,494085,209824,1002566
2023-04-23 11:15,1002581,298658,494085,209838,1002581
2023-04-23 11:16,1002593,298658,494088,209847,1002593
2023-04-23 11:17,1002608,298660,494088,209860,1002608
2023-04-23 11:18,1002624,298662,494091,209871,1002624
2023-04-23 11:19,1002640,298671,494091,209878,1002640
2023-04-23 11:20,1002653,298673,494097,209883,1002653
2023-04-23 11:21,1002667,298675,494097,209895,1002667
2023-04-23 11:22,1002680,298675,494102,209903,1002680
2023-04-23 11:23,1002694,298671,494102,209921,1002694
2023-04-23 11:24,1002708,298672,494105,209931,1002708
2023-04-23 11:25,1002725,298682,494105,209938,1002725
2023-04-23 11:26,1002737,298679,494108,209950,1002737
2023-04-23 11:27,1002754,298686,494108,209960,1002754
2023-04-23 11:28,1002770,298696,494107,209967,1002770
2023-04-23 11:30,1002784,298695,494107,209982,1002784
2023-04-23 11:31,1002800,298697,494112,209991,1002800
2023-04-23 11:32,1002814,298700,494112,210002,1002814
2023-04-23 11:33,1002828,298692,494121,210015,1002828
2023-04-23 11:34,1002843,298699,494121,210023,1002843
2023-04-23 11:35,1002857,298708,494121,210028,1002857
2023-04-23 11:36,1002871,298715,494121,210035,1002871
2023-04-23 11:37,1002886,298723,494121,210042,1002886
2023-04-23 11:38,1002900,298723,494121,210056,1002900
2023-04-23 11:39,1002915,298732,494121,210062,1002915
2023-04-23 11:40,1002930,298727,494134,210069,1002930
2023-04-23 11:41,1002944,298731,494134,210079,1002944
2023-04-23 11:42,1002957,298735,494137,210085,1002957
2023-04-23 11:43,1002971,298738,494137,210096,1002971
2023-04-23 11:44,1002985,298741,494140,210104,1002985
2023-04-23 11:45,1002999,298743,494140,210116,1002999
2023-04-23 11:46,1003013,298743,494144,210126,1003013
2023-04-23 11:47,1003027,298739,494146,210142,1003027
2023-04-23 11:48,1003042,298750,494146,210146,1003042
2023-04-23 11:49,1003059,298752,494150,210157,1003059
2023-04-23 11:50,1003074,298758,494153,210163,1003074
2023-04-23 11:51,1003089,298756,494153,210180,1003089
2023-04-23 11:52,1003102,298756,494155,210191,1003102
2023-04-23 11:53,1003117,298760,494155,210202,1003117
2023-04-23 11:54,1003133,298760,494162,210211,1003133
2023-04-23 11:55,1003148,298770,494162,210216,1003148
2023-04-23 11:56,1003161,298777,494161,210223,1003161
2023-04-23 11:57,1003176,298781,494161,210234,1003176
2023-04-23 11:58,1003190,298779,494170,210241,1003190
2023-04-23 11:59,1003205,298782,494170,210253,1003205
2023-04-23 12:00,1003214,298781,494170,210263,1003214
2023-04-23 12:01,1003222,298781,494170,210271,1003222
2023-04-23 12:02,1003229,298781,494170,210278,1003229
2023-04-23 12:03,1003237,298780,494170,210287,1003237
2023-04-23 12:04,1003244,298772,494180,210292,1003244
2023-04-23 12:05,1003252,298774,494180,210298,1003252
2023-04-23 12:06,1003260,298773,494182,210305,1003260
2023-04-23 12:07,1003266,298771,494182,210313,1003266
2023-04-23 12:08,1003273,298763,494186,210324,1003273
2023-04-23 12:09,1003280,298764,494186,210330,1003280
2023-04-23 12:10,1003287,298758,494192,210337,1003287
2023-04-23 12:11,1003295,298758,494192,210345,1003295
2023-04-23 12:12,1003302,298760,494189,210353,1003302
2023-04-23 12:13,1003311,298758,494189,210364,1003311
2023-04-23 12:14,1003318,298760,494190,210368,1003318
2023-04-23 12:16,1003328,298762,494190,210376,1003328
2023-04-23 12:17,1003335,298761,494190,210384,1003335
2023-04-23 12:18,1003342,298764,494190,210388,1003342
2023-04-23 12:19,1003348,298763,494191,210394,1003348
2023-04-23 12:20,1003356,298765,494191,210400,1003356
2023-04-23 12:21,1003364,298761,494194,210409,1003364
2023-04-23 12:22,1003370,298759,494194,210417,1003370
2023-04-23 12:23,1003379,298756,494198,210425,1003379
2023-04-23 12:24,1003387,298752,494198,210437,1003387
2023-04-23 12:25,1003395,298749,494206,210440,1003395
2023-04-23 12:26,1003404,298749,494206,210449,1003404
2023-04-23 12:27,1003415,298751,494210,210454,1003415
2023-04-23 12:28,1003423,298754,494212,210457,1003423
2023-04-23 12:29,1003432,298752,494212,210468,1003432
2023-04-23 12:30,1003438,298750,494214,210474,1003438
2023-04-23 12:31,1003445,298748,494214,210483,1003445
2023-04-23 12:32,1003453,298744,494218,210491,1003453
2023-04-23 12:33,1003460,298749,494218,210493,1003460
2023-04-23 12:34,1003470,298746,494220,210504,1003470
2023-04-23 12:35,1003477,298749,494220,210508,1003477
2023-04-23 12:36,1003484,298749,494222,210513,1003484
2023-04-23 12:37,1003492,298750,494222,210520,1003492
2023-04-23 12:38,1003500,298750,494227,210523,1003500
2023-04-23 12:39,1003507,298742,494230,210535,1003507
2023-04-23 12:40,1003515,298748,494230,210537,1003515
2023-04-23 12:41,1003521,298746,494232,210543,1003521
2023-04-23 12:42,1003528,298747,494232,210549,1003528
2023-04-23 12:43,1003535,298747,494235,210553,1003535
2023-04-23 12:44,1003541,298748,494235,210558,1003541
2023-04-23 12:45,1003549,298750,494238,210561,1003549
2023-04-23 12:46,1003556,298754,494238,210564,1003556
2023-04-23 12:47,1003563,298749,494238,210576,1003563
2023-04-23 12:48,1003570,298756,494238,210576,1003570
2023-04-23 12:49,1003577,298761,494238,210578,1003577
2023-04-23 12:50,1003585,298763,494238,210584,1003585
2023-04-23 12:51,1003592,298771,494238,210583,1003592
2023-04-23 12:52,1003600,298769,494242,210589,1003600
2023-04-23 12:53,1003607,298766,494242,210599,1003607
2023-04-23 12:54,1003614,298766,494244,210604,1003614
2023-04-23 12:55,1003622,298763,494244,210615,1003622
2023-04-23 12:56,1003629,298764,494243,210622,1003629
2023-04-23 12:57,1003635,298763,494243,210629,1003635
2023-04-23 12:58,1003642,298763,494243,210636,1003642
2023-04-23 12:59,1003649,298767,494243,210639,1003649
2023-04-23 13:00,1003665,298777,494245,210643,1003665
2023-04-23 13:02,1003683,298789,494245,210649,1003683
2023-04-23 13:03,1003700,298796,494249,210655,1003700
2023-04-23 13:04,1003717,298806,494250,210661,1003717
2023-04-23 13:05,1003733,298817,494249,210667,1003733
2023-04-23 13:06,1003749,298829,494249,210671,1003749
2023-04-23 13:07,1003765,298841,494252,210672,1003765
2023-04-23 13:08,1003782,298855,494252,210675,1003782
2023-04-23 13:09,1003800,298868,494254,210678,1003800
2023-04-23 13:10,1003817,298879,494254,210684,1003817
2023-04-23 13:11,1003833,298884,494257,210692,1003833
2023-04-23 13:12,1003850,298899,494257,210694,1003850
2023-04-23 13:13,1003866,298903,494263,210700,1003866
2023-04-23 13:14,1003882,298916,494263,210703,1003882
2023-04-23 13:15,1003898,298929,494263,210706,1003898
2023-04-23 13:16,1003917,298944,494263,210710,1003917
2023-04-23 13:17,1003933,298956,494265,210712,1003933
2023-04-23 13:18,1003949,298963,494265,210721,1003949
2023-04-23 13:19,1003965,298971,494271,210723,1003965
2023-04-23 13:20,1003981,298983,494271,210727,1003981
2023-04-23 13:21,1003999,298994,494275,210730,1003999
2023-04-23 13:22,1004016,299002,494277,210737,1004016
2023-04-23 13:23,1004031,299012,494277,210742,1004031
2023-04-23 13:24,1004051,299026,494277,210748,1004051
2023-04-23 13:25,1004067,299039,494277,210751,1004067
2023-04-23 13:26,1004085,299053,494277,210755,1004085
2023-04-23 13:27,1004102,299064,494277,210761,1004102
2023-04-23 13:28,1004119,299077,494279,210763,1004119
2023-04-23 13:29,1004136,299092,494279,210765,1004136
2023-04-23 13:30,1004152,299102,494281,210769,1004152
2023-04-23 13:31,1004169,299115,494281,210773,1004169
2023-04-23 13:32,1004186,299125,494283,210778,1004186
2023-04-23 13:33,1004204,299136,494283,210785,1004204
2023-04-23 13:34,1004223,299150,494284,210789,1004223
2023-04-23 13:35,1004239,299158,494287,210794,1004239
2023-04-23 13:36,1004255,299172,494287,210796,1004255
2023-04-23 13:37,1004272,299184,494291,210797,1004272
2023-04-23 13:38,1004288,299198,494291,210799,1004288
2023-04-23 13:39,1004305,299208,494292,210805,1004305
2023-04-23 13:40,1004323,299224,494292,210807,1004323
2023-04-23 13:41,1004339,299235,494293,210811,1004339
2023-04-23 13:42,1004356,299248,494293,210815,1004356
2023-04-23 13:43,1004375,299265,494293,210817,1004375
2023-04-23 13:44,1004391,299278,494293,210820,1004391
2023-04-23 13:45,1004406,299284,494297,210825,1004406
2023-04-23 13:46,1004426,299298,494297,210831,1004426
2023-04-23 13:47,1004441,299310,494297,210834,1004441
2023-04-23 13:49,1004457,299321,494298,210838,1004457
2023-04-23 13:50,1004473,299334,494298,210841,1004473
2023-04-23 13:51,1004490,299342,494302,210846,1004490
2023-04-23 13:52,1004508,299358,494302,210848,1004508
2023-04-23 13:53,1004524,299368,494305,210851,1004524
2023-04-23 13:54,1004543,299381,494305,210857,1004543
2023-04-23 13:55,1004559,299393,494306,210860,1004559
2023-04-23 13:56,1004575,299401,494307,210867,1004575
2023-04-23 13:57,1004591,299413,494307,210871,1004591
2023-04-23 13:58,1004607,299424,494308,210875,1004607
2023-04-23 13:59,1004624,299436,494308,210880,1004624
2023-04-23 14:00,1004640,299449,494308,210883,1004640
2023-04-23 14:01,1004650,299455,494308,210887,1004650
2023-04-23 14:02,1004659,299454,494314,210891,1004659
2023-04-23 14:03,1004669,299461,494314,210894,1004669
2023-04-23 14:04,1004678,299468,494312,210898,1004678
2023-04-23 14:05,1004687,299473,494312,210902,1004687
2023-04-23 14:06,1004696,299472,494315,210909,1004696
2023-04-23 14:07,1004705,299481,494315,210909,1004705
2023-04-23 14:08,1004713,299485,494316,210912,1004713
2023-04-23 14:09,1004724,299495,494316,210913,1004724
2023-04-23 14:10,1004734,299496,494319,210919,1004734
2023-04-23 14:11,1004746,299506,494319,210921,1004746
2023-04-23 14:12,1004756,299514,494319,210923,1004756
2023-04-23 14:13,1004765,299520,494319,210926,1004765
2023-04-23 14:14,1004775,299522,494321,210932,1004775
2023-04-23 14:15,1004784,299528,494321,210935,1004784
2023-04-23 14:16,1004794,299535,494323,210936,1004794
2023-04-23 14:17,1004803,299541,494323,210939,1004803
2023-04-23 14:18,1004814,299549,494324,210941,1004814
2023-04-23 14:19,1004823,299554,494324,210945,1004823
2023-04-23 14:20,1004831,299551,494328,210952,1004831
2023-04-23 14:21,1004840,299557,494328,210955,1004840
2023-04-23 14:22,1004849,299560,494332,210957,1004849
2023-04-23 14:23,1004858,299565,494335,210958,1004858
2023-04-23 14:24,1004867,299567,494335,210965,1004867
2023-04-23 14:25,1004876,299569,494338,210969,1004876
2023-04-23 14:26,1004886,299576,494338,210972,1004886
2023-04-23 14:27,1004895,299577,494342,210976,1004895
2023-04-23 14:28,1004905,299583,494342,210980,1004905
2023-04-23 14:29,1004915,299587,494346,210982,1004915
2023-04-23 14:30,1004923,299593,494346,210984,1004923
2023-04-23 14:31,1004933,299602,494345,210986,1004933
2023-04-23 14:32,1004942,299608,494345,210989,1004942
2023-04-23 14:33,1004951,299615,494346,210990,1004951
2023-04-23 14:34,1004959,299621,494346,210992,1004959
2023-04-23 14:35,1004970,299624,494349,210997,1004970
2023-04-23 14:37,1004979,299628,494349,211002,1004979
2023-04-23 14:38,1004988,299633,494352,211003,1004988
2023-04-23 14:39,1004998,299640,494352,211006,1004998
2023-04-23 14:40,1005006,299646,494352,211008,1005006
2023-04-23 14:41,1005015,299653,494350,211012,1005015
2023-04-23 14:42,1005025,299658,494351,211016,1005025
2023-04-23 14:43,1005035,299667,494351,211017,1005035
2023-04-23 14:44,1005044,299672,494354,211018,1005044
2023-04-23 14:45,1005055,299679,494354,211022,1005055
2023-04-23 14:46,1005065,299682,494357,211026,1005065
2023-04-23 14:47,1005074,299690,494357,211027,1005074
2023-04-23 14:48,1005083,299691,494363,211029,1005083
2023-04-23 14:49,1005092,299700,494363,211029,1005092
2023-04-23 14:50,1005102,299708,494363,211031,1005102
2023-04-23 14:51,1005112,299716,494363,211033,1005112
2023-04-23 14:52,1005122,299724,494363,211035,1005122
2023-04-23 14:53,1005131,299730,494363,211038,1005131
2023-04-23 14:54,1005140,299735,494363,211042,1005140
2023-04-23 14:55,1005149,299744,494363,211042,1005149
2023-04-23 14:56,1005158,299750,494363,211045,1005158
2023-04-23 14:57,1005167,299758,494363,211046,1005167
2023-04-23 14:58,1005178,299752,494377,211049,1005178
2023-04-23 14:59,1005187,299760,494377,211050,1005187
2023-04-23 15:00,1005198,299768,494377,211053,1005198
2023-04-23 15:01,1005209,299772,494377,211060,1005209
2023-04-23 15:02,1005218,299779,494377,211062,1005218
2023-04-23 15:03,1005228,299787,494377,211064,1005228
2023-04-23 15:04,1005239,299793,494377,211069,1005239
2023-04-23 15:05,1005249,299803,494377,211069,1005249
2023-04-23 15:06,1005259,299810,494377,211072,1005259
2023-04-23 15:07,1005269,299816,494377,211076,1005269
2023-04-23 15:08,1005280,299817,494384,211079,1005280
2023-04-23 15:09,1005290,299825,494384,211081,1005290
2023-04-23 15:10,1005300,299832,494384,211084,1005300
2023-04-23 15:11,1005310,299838,494384,211088,1005310
2023-04-23 15:12,1005320,299848,494384,211088,1005320
2023-04-23 15:13,1005329,299853,494384,211092,1005329
2023-04-23 15:14,1005339,299860,494384,211095,1005339
2023-04-23 15:15,1005349,299869,494384,211096,1005349
2023-04-23 15:16,1005359,299877,494384,211098,1005359
2023-04-23 15:17,1005368,299882,494384,211102,1005368
2023-04-23 15:18,1005379,299884,494392,211103,1005379
2023-04-23 15:19,1005389,299891,494392,211106,1005389
2023-04-23 15:20,1005398,299899,494392,211107,1005398
2023-04-23 15:21,1005410,299909,494392,211109,1005410
2023-04-23 15:22,1005420,299910,494398,211112,1005420
2023-04-23 15:24,1005430,299916,494398,211116,1005430
2023-04-23 15:25,1005440,299916,494404,211120,1005440
2023-04-23 15:26,1005450,299922,494404,211124,1005450
2023-04-23 15:27,1005461,299929,494405,211127,1005461
2023-04-23 15:28,1005471,299936,494405,211130,1005471
2023-04-23 15:29,1005481,299939,494407,211135,1005481
2023-04-23 15:30,1005491,299944,494407,211140,1005491
2023-04-23 15:31,1005502,299955,494405,211142,1005502
2023-04-23 15:32,1005512,299962,494405,211145,1005512
2023-04-23 15:33,1005522,299964,494410,211148,1005522
2023-04-23 15:34,1005532,299968,494413,211151,1005532
2023-04-23 15:35,1005542,299974,494414,211154,1005542
2023-04-23 15:36,1005553,299981,494414,211158,1005553
2023-04-23 15:37,1005564,299989,494417,211158,1005564
2023-04-23 15:38,1005574,299998,494417,211159,1005574
2023-04-23 15:39,1005584,300001,494421,211162,1005584
2023-04-23 15:40,1005594,300010,494421,211163,1005594
2023-04-23 15:41,1005605,300016,494422,211167,1005605
2023-04-23 15:42,1005616,300024,494422,211170,1005616
2023-04-23 15:43,1005626,300030,494423,211173,1005626
2023-04-23 15:44,1005637,300039,494423,211175,1005637
2023-04-23 15:45,1005646,300045,494424,211177,1005646
2023-04-23 15:46,1005657,300050,494425,211182,1005657
2023-04-23 15:47,1005667,300058,494425,211184,1005667
2023-04-23 15:48,1005677,300066,494427,211184,1005677
2023-04-23 15:49,1005687,300076,494427,211184,1005687
2023-04-23 15:50,1005697,300084,494428,211185,1005697
2023-04-23 15:51,1005707,300091,494428,211188,1005707
2023-04-23 15:52,1005716,300096,494429,211191,1005716
2023-04-23 15:53,1005726,300103,494429,211194,1005726
2023-04-23 15:54,1005738,300110,494431,211197,1005738
2023-04-23 15:55,1005749,300121,494431,211197,1005749
2023-04-23 15:56,1005759,300131,494431,211197,1005759
2023-04-23 15:57,1005769,300138,494431,211200,1005769
2023-04-23 15:58,1005779,300146,494432,211201,1005779
2023-04-23 15:59,1005789,300154,494432,211203,1005789
2023-04-23 16:00,1005802,300159,494437,211206,1005802
2023-04-23 16:01,1005818,300168,494437,211213,1005818
2023-04-23 16:02,1005834,300176,494439,211219,1005834
2023-04-23 16:03,1005849,300186,494439,211224,1005849
2023-04-23 16:04,1005866,300201,494440,211225,1005866
2023-04-23 16:05,1005882,300213,494440,211229,1005882
2023-04-23 16:06,1005897,300222,494440,211235,1005897
2023-04-23 16:07,1005912,300231,494443,211238,1005912
2023-04-23 16:08,1005928,300246,494443,211239,1005928
2023-04-23 16:09,1005944,300261,494442,211241,1005944
2023-04-23 16:10,1005959,300276,494442,211241,1005959
2023-04-23 16:12,1005975,300293,494442,211240,1005975
2023-04-23 16:13,1005993,300309,494442,211242,1005993
2023-04-23 16:14,1006008,300321,494443,211244,1006008
2023-04-23 16:15,1006023,300335,494443,211245,1006023
2023-04-23 16:16,1006039,300348,494445,211246,1006039
2023-04-23 16:17,1006055,300361,494445,211249,1006055
2023-04-23 16:18,1006070,300374,494447,211249,1006070
2023-04-23 16:19,1006086,300385,494447,211254,1006086
2023-04-23 16:20,1006102,300395,494449,211258,1006102
2023-04-23 16:21,1006119,300411,494449,211259,1006119
2023-04-23 16:22,1006135,300421,494450,211264,1006135
2023-04-23 16:23,1006150,300432,494450,211268,1006150
2023-04-23 16:24,1006166,300447,494451,211268,1006166
2023-04-23 16:25,1006182,300461,494451,211270,1006182
2023-04-23 16:26,1006198,300464,494457,211277,1006198
2023-04-23 16:27,1006214,300479,494457,211278,1006214
2023-04-23 16:28,1006230,300490,494459,211281,1006230
2023-04-23 16:29,1006245,300503,494459,211283,1006245
2023-04-23 16:30,1006263,300517,494459,211287,1006263
2023-04-23 16:31,1006278,300529,494459,211290,1006278
2023-04-23 16:32,1006294,300533,494464,211297,1006294
2023-04-23 16:33,1006309,300545,494464,211300,1006309
2023-04-23 16:34,1006325,300557,494465,211303,1006325
2023-04-23 16:35,1006342,300572,494465,211305,1006342
2023-04-23 16:36,1006357,300583,494468,211306,1006357
2023-04-23 16:37,1006373,300595,494468,211310,1006373
2023-04-23 16:38,1006388,300604,494472,211312,1006388
2023-04-23 16:39,1006404,300614,494472,211318,1006404
2023-04-23 16:40,1006420,300624,494476,211320,1006420
2023-04-23 16:41,1006436,300636,494476,211324,1006436
2023-04-23 16:42,1006452,300645,494480,211327,1006452
2023-04-23 16:43,1006468,300660,494480,211328,1006468
2023-04-23 16:44,1006483,300669,494484,211330,1006483
2023-04-23 16:45,1006499,300678,494487,211334,1006499
2023-04-23 16:46,1006514,300690,494487,211337,1006514
2023-04-23 16:47,1006531,300703,494488,211340,1006531
2023-04-23 16:48,1006546,300714,494490,211342,1006546
2023-04-23 16:49,1006563,300728,494490,211345,1006563
2023-04-23 16:50,1006578,300741,494490,211347,1006578
2023-04-23 16:51,1006594,300754,494493,211347,1006594
2023-04-23 16:52,1006610,300767,494493,211350,1006610
2023-04-23 16:53,1006626,300776,494497,211353,1006626
2023-04-23 16:54,1006643,300791,494497,211355,1006643
2023-04-23 16:55,1006659,300802,494499,211358,1006659
2023-04-23 16:56,1006676,300814,494499,211363,1006676
2023-04-23 16:57,1006691,300825,494502,211364,1006691
2023-04-23 16:59,1006706,300836,494502,211368,1006706
2023-04-23 17:00,1006723,300845,494506,211372,1006723
2023-04-23 17:01,1006747,300867,494506,211374,1006747
2023-04-23 17:02,1006773,300889,494507,211377,1006773
2023-04-23 17:03,1006798,300910,494507,211381,1006798
2023-04-23 17:04,1006822,300928,494508,211386,1006822
2023-04-23 17:05,1006846,300949,494508,211389,1006846
2023-04-23 17:06,1006871,300970,494511,211390,1006871
2023-04-23 17:07,1006896,300991,494511,211394,1006896
2023-04-23 17:08,1006922,301014,494511,211397,1006922
2023-04-23 17:09,1006946,301037,494511,211398,1006946
2023-04-23 17:10,1006972,301060,494512,211400,1006972
2023-04-23 17:11,1006998,301082,494512,211404,1006998
2023-04-23 17:12,1007022,301105,494513,211404,1007022
2023-04-23 17:13,1007046,301125,494513,211408,1007046
2023-04-23 17:14,1007073,301148,494514,211411,1007073
2023-04-23 17:15,1007097,301169,494514,211414,1007097
2023-04-23 17:16,1007121,301189,494516,211416,1007121
2023-04-23 17:17,1007145,301213,494516,211416,1007145
2023-04-23 17:18,1007169,301231,494520,211418,1007169
2023-04-23 17:19,1007195,301255,494520,211420,1007195
2023-04-23 17:20,1007220,301276,494521,211423,1007220
2023-04-23 17:21,1007246,301298,494522,211426,1007246
2023-04-23 17:22,1007270,301322,494522,211426,1007270
2023-04-23 17:23,1007294,301340,494522,211432,1007294
2023-04-23 17:24,1007318,301362,494522,211434,1007318
2023-04-23 17:25,1007342,301381,494523,211438,1007342
2023-04-23 17:26,1007366,301402,494523,211441,1007366
2023-04-23 17:27,1007392,301426,494524,211442,1007392
2023-04-23 17:28,1007417,301448,494524,211445,1007417
2023-04-23 17:29,1007441,301462,494528,211451,1007441
2023-04-23 17:30,1007465,301485,494528,211452,1007465
2023-04-23 17:31,1007490,301502,494534,211454,1007490
2023-04-23 17:32,1007516,301525,494534,211457,1007516
2023-04-23 17:33,1007540,301543,494535,211462,1007540
2023-04-23 17:34,1007563,301563,494535,211465,1007563
2023-04-23 17:35,1007588,301581,494539,211468,1007588
2023-04-23 17:36,1007612,301601,494539,211472,1007612
2023-04-23 17:37,1007636,301623,494541,211472,1007636
2023-04-23 17:38,1007661,301647,494541,211473,1007661
2023-04-23 17:39,1007687,301666,494544,211477,1007687
2023-04-23 17:40,1007711,301689,494545,211477,1007711
2023-04-23 17:41,1007735,301711,494545,211479,1007735
2023-04-23 17:42,1007760,301727,494549,211484,1007760
2023-04-23 17:43,1007786,301753,494549,211484,1007786
2023-04-23 17:44,1007811,301773,494552,211486,1007811
2023-04-23 17:46,1007835,301794,494552,211489,1007835
2023-04-23 17:47,1007859,301812,494557,211490,1007859
2023-04-23 17:48,1007883,301832,494558,211493,1007883
2023-04-23 17:49,1007908,301856,494558,211494,1007908
2023-04-23 17:50,1007932,301876,494558,211498,1007932
2023-04-23 17:51,1007957,301901,494558,211498,1007957
2023-04-23 17:52,1007981,301917,494562,211502,1007981
2023-04-23 17:53,1008006,301938,494562,211506,1008006
2023-04-23 17:54,1008030,301951,494571,211508,1008030
2023-04-23 17:55,1008056,301972,494571,211513,1008056
2023-04-23 17:56,1008081,301994,494571,211516,1008081
2023-04-23 17:57,1008105,302015,494571,211519,1008105
2023-04-23 17:58,1008129,302036,494574,211519,1008129
2023-04-23 17:59,1008154,302061,494574,211519,1008154
2023-04-23 18:00,1008175,302079,494575,211521,1008175
2023-04-23 18:01,1008187,302087,494575,211525,1008187
2023-04-23 18:02,1008199,302094,494578,211527,1008199
2023-04-23 18:03,1008211,302099,494578,211534,1008211
2023-04-23 18:04,1008226,302110,494579,211537,1008226
2023-04-23 18:05,1008237,302118,494579,211540,1008237
2023-04-23 18:06,1008249,302127,494579,211543,1008249
2023-04-23 18:07,1008260,302132,494579,211549,1008260
2023-04-23 18:08,1008272,302140,494580,211552,1008272
2023-04-23 18:09,1008285,302148,494580,211557,1008285
2023-04-23 18:10,1008297,302157,494580,211560,1008297
2023-04-23 18:11,1008309,302167,494580,211562,1008309
2023-04-23 18:12,1008322,302175,494582,211565,1008322
2023-04-23 18:13,1008333,302175,494587,211571,1008333
2023-04-23 18:14,1008345,302184,494587,211574,1008345
2023-04-23 18:15,1008355,302195,494586,211574,1008355
2023-04-23 18:16,1008367,302205,494586,211576,1008367
2023-04-23 18:17,1008381,302211,494590,211580,1008381
2023-04-23 18:18,1008391,302217,494590,211584,1008391
2023-04-23 18:19,1008403,302227,494590,211586,1008403
2023-04-23 18:20,1008414,302236,494590,211588,1008414
2023-04-23 18:21,1008425,302241,494594,211590,1008425
2023-04-23 18:22,1008436,302250,494594,211592,1008436
2023-04-23 18:23,1008447,302252,494599,211596,1008447
2023-04-23 18:24,1008458,302260,494599,211599,1008458
2023-04-23 18:25,1008469,302264,494601,211604,1008469
2023-04-23 18:26,1008481,302275,494601,211605,1008481
2023-04-23 18:27,1008494,302281,494604,211609,1008494
2023-04-23 18:28,1008505,302287,494604,211614,1008505
2023-04-23 18:29,1008519,302296,494606,211617,1008519
2023-04-23 18:30,1008532,302307,494606,211619,1008532
2023-04-23 18:32,1008545,302313,494612,211620,1008545
2023-04-23 18:33,1008557,302321,494612,211624,1008557
2023-04-23 18:34,1008571,302321,494621,211629,1008571
2023-04-23 18:35,1008583,302328,494621,211634,1008583
2023-04-23 18:36,1008597,302314,494648,211635,1008597
2023-04-23 18:37,1008612,302312,494659,211641,1008612
2023-04-23 18:38,1008622,302300,494674,211648,1008622
2023-04-23 18:39,1008635,302294,494688,211653,1008635
2023-04-23 18:40,1008647,302289,494701,211657,1008647
2023-04-23 18:41,1008659,302296,494705,211658,1008659
2023-04-23 18:42,1008670,302304,494705,211661,1008670
2023-04-23 18:43,1008681,302281,494734,211666,1008681
2023-04-23 18:44,1008695,302279,494746,211670,1008695
2023-04-23 18:45,1008708,302285,494746,211677,1008708
2023-04-23 18:46,1008723,302285,494756,211682,1008723
2023-04-23 18:47,1008736,302296,494756,211684,1008736
2023-04-23 18:48,1008749,302291,494771,211687,1008749
2023-04-23 18:49,1008761,302284,494787,211690,1008761
2023-04-23 18:50,1008771,302279,494795,211697,1008771
2023-04-23 18:51,1008784,302291,494795,211698,1008784
2023-04-23 18:52,1008799,302291,494807,211701,1008799
2023-04-23 18:53,1008811,302300,494807,211704,1008811
2023-04-23 18:54,1008822,302294,494821,211707,1008822
2023-04-23 18:55,1008837,302306,494821,211710,1008837
2023-04-23 18:56,1008852,302296,494841,211715,1008852
2023-04-23 18:57,1008864,302298,494849,211717,1008864
2023-04-23 18:58,1008875,302302,494853,211720,1008875
2023-04-23 18:59,1008890,302313,494856,211721,1008890
2023-04-23 19:00,1008908,302322,494862,211724,1008908
2023-04-23 19:01,1008928,302331,494867,211730,1008928
2023-04-23 19:02,1008952,302347,494873,211732,1008952
2023-04-23 19:03,1008978,302358,494881,211739,1008978
2023-04-23 19:04,1008999,302376,494881,211742,1008999
2023-04-23 19:05,1009022,302386,494893,211743,1009022
2023-04-23 19:06,1009042,302405,494893,211744,1009042
2023-04-23 19:07,1009064,302409,494907,211748,1009064
2023-04-23 19:08,1009082,302426,494907,211749,1009082
2023-04-23 19:09,1009106,302438,494916,211752,1009106
2023-04-23 19:10,1009129,302460,494916,211753,1009129
2023-04-23 19:11,1009154,302466,494931,211757,1009154
2023-04-23 19:12,1009178,302487,494933,211758,1009178
2023-04-23 19:13,1009200,302502,494938,211760,1009200
2023-04-23 19:14,1009222,302509,494950,211763,1009222
2023-04-23 19:15,1009243,302527,494950,211766,1009243
2023-04-23 19:16,1009266,302529,494969,211768,1009266
2023-04-23 19:18,1009287,302539,494977,211771,1009287
2023-04-23 19:19,1009308,302558,494977,211773,1009308
2023-04-23 19:20,1009330,302567,494985,211778,1009330
2023-04-23 19:21,1009349,302581,494985,211783,1009349
2023-04-23 19:22,1009374,302595,494994,211785,1009374
2023-04-23 19:23,1009396,302604,494997,211795,1009396
2023-04-23 19:24,1009418,302622,494997,211799,1009418
2023-04-23 19:25,1009441,302639,495000,211802,1009441
2023-04-23 19:26,1009462,302649,495009,211804,1009462
2023-04-23 19:27,1009483,302665,495013,211805,1009483
2023-04-23 19:28,1009504,302684,495013,211807,1009504
2023-04-23 19:29,1009529,302694,495026,211809,1009529
2023-04-23 19:30,1009550,302706,495032,211812,1009550
2023-04-23 19:31,1009570,302719,495038,211813,1009570
2023-04-23 19:32,1009591,302734,495042,211815,1009591
2023-04-23 19:33,1009615,302756,495042,211817,1009615
2023-04-23 19:34,1009635,302765,495051,211819,1009635
2023-04-23 19:35,1009656,302781,495054,211821,1009656
2023-04-23 19:36,1009682,302797,495060,211825,1009682
2023-04-23 19:37,1009703,302813,495060,211830,1009703
2023-04-23 19:38,1009724,302828,495063,211833,1009724
2023-04-23 19:39,1009747,302835,495076,211836,1009747
2023-04-23 19:40,1009768,302844,495085,211839,1009768
2023-04-23 19:41,1009790,302866,495085,211839,1009790
2023-04-23 19:42,1009811,302882,495087,211842,1009811
2023-04-23 19:43,1009834,302903,495089,211842,1009834
2023-04-23 19:44,1009856,302925,495089,211842,1009856
2023-04-23 19:45,1009882,302941,495097,211844,1009882
2023-04-23 19:46,1009904,302960,495097,211847,1009904
2023-04-23 19:47,1009923,302967,495108,211848,1009923
2023-04-23 19:48,1009946,302988,495108,211850,1009946
2023-04-23 19:49,1009967,303001,495114,211852,1009967
2023-04-23 19:50,1009986,303011,495117,211858,1009986
2023-04-23 19:51,1010009,303024,495126,211859,1010009
2023-04-23 19:52,1010036,303051,495126,211859,1010036
2023-04-23 19:53,1010060,303067,495132,211861,1010060
2023-04-23 19:54,1010081,303087,495132,211862,1010081
2023-04-23 19:55,1010106,303094,495149,211863,1010106
2023-04-23 19:56,1010129,303115,495149,211865,1010129
2023-04-23 19:57,1010151,303121,495163,211867,1010151
2023-04-23 19:58,1010172,303138,495166,211868,1010172
2023-04-23 19:59,1010193,303158,495166,211869,1010193
2023-04-23 20:00,1010218,303175,495172,211871,1010218
2023-04-23 20:01,1010241,303192,495172,211877,1010241
2023-04-23 20:02,1010266,303208,495178,211880,1010266
2023-04-23 20:04,1010292,303225,495184,211883,1010292
2023-04-23 20:05,1010314,303242,495188,211884,1010314
2023-04-23 20:06,1010337,303258,495194,211885,1010337
2023-04-23 20:07,1010359,303274,495196,211889,1010359
2023-04-23 20:08,1010382,303290,495201,211891,1010382
2023-04-23 20:09,1010406,303308,495201,211897,1010406
2023-04-23 20:10,1010429,303318,495212,211899,1010429
2023-04-23 20:11,1010453,303338,495212,211903,1010453
2023-04-23 20:12,1010476,303350,495220,211906,1010476
2023-04-23 20:13,1010499,303370,495220,211909,1010499
2023-04-23 20:14,1010523,303381,495230,211912,1010523
2023-04-23 20:15,1010546,303402,495230,211914,1010546
2023-04-23 20:16,1010570,303420,495234,211916,1010570
2023-04-23 20:17,1010595,303439,495235,211921,1010595
2023-04-23 20:18,1010617,303452,495241,211924,1010617
2023-04-23 20:19,1010641,303475,495241,211925,1010641
2023-04-23 20:20,1010664,303487,495248,211929,1010664
2023-04-23 20:21,1010685,303505,495248,211932,1010685
2023-04-23 20:22,1010707,303514,495259,211934,1010707
2023-04-23 20:23,1010731,303535,495259,211937,1010731
2023-04-23 20:24,1010754,303544,495269,211941,1010754
2023-04-23 20:25,1010775,303564,495269,211942,1010775
2023-04-23 20:26,1010800,303573,495283,211944,1010800
2023-04-23 20:27,1010823,303595,495283,211945,1010823
2023-04-23 20:28,1010844,303606,495293,211945,1010844
2023-04-23 20:29,1010867,303626,495293,211948,1010867
2023-04-23 20:30,1010891,303642,495300,211949,1010891
2023-04-23 20:31,1010915,303663,495300,211952,1010915
2023-04-23 20:32,1010936,303676,495304,211956,1010936
2023-04-23 20:33,1010961,303698,495304,211959,1010961
2023-04-23 20:34,1010985,303717,495307,211961,1010985
2023-04-23 20:35,1011006,303734,495307,211965,1011006
2023-04-23 20:36,1011029,303753,495310,211966,1011029
2023-04-23 20:37,1011051,303769,495310,211972,1011051
2023-04-23 20:38,1011075,303784,495316,211975,1011075
2023-04-23 20:39,1011097,303804,495316,211977,1011097
2023-04-23 20:40,1011120,303818,495321,211981,1011120
2023-04-23 20:41,1011143,303840,495321,211982,1011143
2023-04-23 20:42,1011165,303852,495328,211985,1011165
2023-04-23 20:43,1011189,303868,495332,211989,1011189
2023-04-23 20:44,1011214,303891,495332,211991,1011214
2023-04-23 20:45,1011236,303906,495337,211993,1011236
2023-04-23 20:46,1011259,303922,495342,211995,1011259
2023-04-23 20:47,1011280,303939,495344,211997,1011280
2023-04-23 20:48,1011304,303957,495347,212000,1011304
2023-04-23 20:49,1011325,303975,495347,212003,1011325
2023-04-23 20:50,1011347,303985,495357,212005,1011347
2023-04-23 20:52,1011369,304001,495360,212008,1011369
2023-04-23 20:53,1011392,304018,495365,212009,1011392
2023-04-23 20:54,1011414,304038,495365,212011,1011414
2023-04-23 20:55,1011438,304059,495366,212013,1011438
2023-04-23 20:56,1011459,304079,495366,212014,1011459
2023-04-23 20:57,1011483,304097,495371,212015,1011483
2023-04-23 20:58,1011503,304109,495377,212017,1011503
2023-04-23 20:59,1011526,304128,495377,212021,1011526
2023-04-23 21:00,1011548,304143,495382,212023,1011548
2023-04-23 21:01,1011564,304156,495382,212026,1011564
2023-04-23 21:02,1011581,304168,495387,212026,1011581
2023-04-23 21:03,1011599,304178,495391,212030,1011599
2023-04-23 21:04,1011616,304189,495392,212035,1011616
2023-04-23 21:05,1011636,304206,495392,212038,1011636
2023-04-23 21:06,1011651,304214,495395,212042,1011651
2023-04-23 21:07,1011668,304225,495399,212044,1011668
2023-04-23 21:08,1011686,304236,495402,212048,1011686
2023-04-23 21:09,1011703,304249,495405,212049,1011703
2023-04-23 21:10,1011721,304264,495405,212052,1011721
2023-04-23 21:11,1011739,304273,495409,212057,1011739
2023-04-23 21:12,1011757,304287,495409,212061,1011757
2023-04-23 21:13,1011775,304294,495417,212064,1011775
2023-04-23 21:14,1011790,304307,495417,212066,1011790
2023-04-23 21:15,1011808,304315,495424,212069,1011808
2023-04-23 21:16,1011827,304331,495424,212072,1011827
2023-04-23 21:17,1011844,304335,495434,212075,1011844
2023-04-23 21:18,1011862,304345,495434,212083,1011862
2023-04-23 21:19,1011879,304354,495438,212087,1011879
2023-04-23 21:20,1011897,304371,495438,212088,1011897
2023-04-23 21:21,1011914,304380,495444,212090,1011914
2023-04-23 21:22,1011934,304397,495444,212093,1011934
2023-04-23 21:23,1011952,304403,495452,212097,1011952
2023-04-23 21:24,1011970,304419,495452,212099,1011970
2023-04-23 21:25,1011987,304430,495457,212100,1011987
2023-04-23 21:26,1012006,304446,495457,212103,1012006
2023-04-23 21:27,1012023,304454,495462,212107,1012023
2023-04-23 21:28,1012042,304460,495462,212120,1012042
2023-04-23 21:29,1012058,304473,495463,212122,1012058
2023-04-23 21:30,1012074,304486,495463,212125,1012074
2023-04-23 21:31,1012092,304496,495468,212128,1012092
2023-04-23 21:32,1012109,304505,495473,212131,1012109
2023-04-23 21:33,1012125,304515,495476,212134,1012125
2023-04-23 21:34,1012142,304530,495476,212136,1012142
2023-04-23 21:35,1012159,304536,495484,212139,1012159
2023-04-23 21:36,1012177,304551,495484,212142,1012177
2023-04-23 21:37,1012196,304559,495493,212144,1012196
2023-04-23 21:39,1012212,304566,495496,212150,1012212
2023-04-23 21:40,1012230,304580,495496,212154,1012230
2023-04-23 21:41,1012247,304583,495507,212157,1012247
2023-04-23 21:42,1012264,304589,495513,212162,1012264
2023-04-23 21:43,1012283,304605,495513,212165,1012283
2023-04-23 21:44,1012303,304619,495518,212166,1012303
2023-04-23 21:45,1012320,304633,495519,212168,1012320
2023-04-23 21:46,1012338,304649,495520,212169,1012338
2023-04-23 21:47,1012354,304655,495527,212172,1012354
2023-04-23 21:48,1012374,304672,495527,212175,1012374
2023-04-23 21:49,1012393,304680,495535,212178,1012393
2023-04-23 21:50,1012409,304693,495535,212181,1012409
2023-04-23 21:51,1012428,304703,495543,212182,1012428
2023-04-23 21:52,1012446,304717,495543,212186,1012446
2023-04-23 21:53,1012470,304737,495543,212190,1012470
2023-04-23 21:54,1012486,304749,495543,212194,1012486
2023-04-23 21:55,1012502,304761,495543,212198,1012502
2023-04-23 21:56,1012521,304777,495543,212201,1012521
2023-04-23 21:57,1012539,304791,495543,212205,1012539
2023-04-23 21:58,1012557,304808,495543,212206,1012557
2023-04-23 21:59,1012574,304816,495543,212215,1012574
2023-04-23 22:00,1012593,304834,495543,212216,1012593
2023-04-23 22:01,1012624,304827,495573,212224,1012624
2023-04-23 22:02,1012657,304855,495573,212229,1012657
2023-04-23 22:03,1012685,304876,495576,212233,1012685
2023-04-23 22:04,1012712,304900,495576,212236,1012712
2023-04-23 22:05,1012739,304922,495581,212236,1012739
2023-04-23 22:06,1012767,304943,495581,212243,1012767
2023-04-23 22:07,1012798,304968,495587,212243,1012798
2023-04-23 22:08,1012827,304995,495587,212245,1012827
2023-04-23 22:09,1012857,305018,495588,212251,1012857
2023-04-23 22:10,1012882,305040,495588,212254,1012882
2023-04-23 22:11,1012911,305061,495592,212258,1012911
2023-04-23 22:12,1012939,305085,495592,212262,1012939
2023-04-23 22:13,1012966,305102,495599,212265,1012966
2023-04-23 22:14,1012994,305126,495599,212269,1012994
2023-04-23 22:15,1013023,305143,495604,212276,1013023
2023-04-23 22:16,1013051,305166,495604,212281,1013051
2023-04-23 22:17,1013081,305190,495606,212285,1013081
2023-04-23 22:18,1013108,305213,495606,212289,1013108
2023-04-23 22:19,1013136,305237,495606,212293,1013136
2023-04-23 22:20,1013162,305262,495606,212294,1013162
2023-04-23 22:21,1013191,305285,495611,212295,1013191
2023-04-23 22:22,1013221,305313,495611,212297,1013221
2023-04-23 22:23,1013251,305333,495616,212302,1013251
2023-04-23 22:24,1013280,305360,495616,212304,1013280
2023-04-23 22:25,1013306,305375,495625,212306,1013306
2023-04-23 22:27,1013334,305396,495625,212313,1013334
2023-04-23 22:28,1013364,305423,495627,212314,1013364
2023-04-23 22:29,1013395,305450,495627,212318,1013395
2023-04-23 22:30,1013421,305463,495634,212324,1013421
2023-04-23 22:31,1013452,305490,495634,212328,1013452
2023-04-23 22:32,1013479,305511,495639,212329,1013479
2023-04-23 22:33,1013508,305535,495639,212334,1013508
2023-04-23 22:34,1013534,305545,495648,212341,1013534
2023-04-23 22:35,1013564,305569,495648,212347,1013564
2023-04-23 22:36,1013592,305591,495653,212348,1013592
2023-04-23 22:37,1013619,305610,495658,212351,1013619
2023-04-23 22:38,1013650,305639,495658,212353,1013650
2023-04-23 22:39,1013677,305651,495668,212358,1013677
2023-04-23 22:40,1013707,305673,495668,212366,1013707
2023-04-23 22:41,1013733,305688,495677,212368,1013733
2023-04-23 22:42,1013761,305710,495677,212374,1013761
2023-04-23 22:43,1013789,305729,495680,212380,1013789
2023-04-23 22:44,1013818,305755,495680,212383,1013818
2023-04-23 22:45,1013846,305774,495685,212387,1013846
2023-04-23 22:46,1013873,305793,495685,212395,1013873
2023-04-23 22:47,1013905,305816,495689,212400,1013905
2023-04-23 22:48,1013934,305840,495689,212405,1013934
2023-04-23 22:49,1013963,305861,495694,212408,1013963
2023-04-23 22:50,1013990,305882,495694,212414,1013990
2023-04-23 22:51,1014019,305898,495702,212419,1014019
2023-04-23 22:52,1014046,305918,495702,212426,1014046
2023-04-23 22:53,1014074,305938,495708,212428,1014074
2023-04-23 22:54,1014103,305964,495708,212431,1014103
2023-04-23 22:55,1014130,305978,495714,212438,1014130
2023-04-23 22:56,1014159,305998,495716,212445,1014159
2023-04-23 22:57,1014187,306023,495716,212448,1014187
2023-04-23 22:58,1014213,306037,495723,212453,1014213
2023-04-23 22:59,1014242,306061,495723,212458,1014242
2023-04-23 23:00,1014265,306076,495726,212463,1014265
2023-04-23 23:01,1014283,306092,495728,212463,1014283
2023-04-23 23:02,1014299,306106,495728,212465,1014299
2023-04-23 23:03,1014318,306116,495732,212470,1014318
2023-04-23 23:04,1014334,306128,495732,212474,1014334
2023-04-23 23:05,1014353,306134,495741,212478,1014353
2023-04-23 23:06,1014370,306147,495741,212482,1014370
2023-04-23 23:07,1014388,306162,495741,212485,1014388
2023-04-23 23:08,1014406,306178,495741,212487,1014406
2023-04-23 23:09,1014424,306194,495741,212489,1014424
2023-04-23 23:10,1014442,306199,495752,212491,1014442
2023-04-23 23:11,1014459,306213,495752,212494,1014459
2023-04-23 23:12,1014477,306223,495755,212499,1014477
2023-04-23 23:13,1014493,306235,495755,212503,1014493
2023-04-23 23:15,1014512,306239,495763,212510,1014512
2023-04-23 23:16,1014532,306255,495763,212514,1014532
2023-04-23 23:17,1014549,306270,495764,212515,1014549
2023-04-23 23:18,1014568,306279,495770,212519,1014568
2023-04-23 23:19,1014585,306291,495770,212524,1014585
2023-04-23 23:20,1014604,306301,495777,212526,1014604
2023-04-23 23:21,1014623,306315,495777,212531,1014623
2023-04-23 23:22,1014641,306324,495783,212534,1014641
2023-04-23 23:23,1014660,306335,495783,212542,1014660
2023-04-23 23:24,1014677,306348,495783,212546,1014677
2023-04-23 23:25,1014695,306362,495783,212550,1014695
2023-04-23 23:26,1014714,306372,495788,212554,1014714
2023-04-23 23:27,1014732,306388,495788,212556,1014732
2023-04-23 23:28,1014751,306395,495795,212561,1014751
2023-04-23 23:29,1014767,306404,495798,212565,1014767
2023-04-23 23:30,1014785,306421,495798,212566,1014785
2023-04-23 23:31,1014803,306432,495802,212569,1014803
2023-04-23 23:32,1014821,306447,495802,212572,1014821
2023-04-23 23:33,1014838,306456,495808,212574,1014838
2023-04-23 23:34,1014855,306470,495808,212577,1014855
2023-04-23 23:35,1014874,306482,495812,212580,1014874
2023-04-23 23:36,1014894,306496,495814,212584,1014894
2023-04-23 23:37,1014912,306509,495814,212589,1014912
2023-04-23 23:38,1014928,306514,495822,212592,1014928
2023-04-23 23:39,1014946,306528,495822,212596,1014946
2023-04-23 23:40,1014963,306540,495825,212598,1014963
2023-04-23 23:41,1014981,306560,495825,212596,1014981
2023-04-23 23:42,1014999,306570,495833,212596,1014999
2023-04-23 23:43,1015018,306587,495833,212598,1015018
2023-04-23 23:44,1015036,306596,495839,212601,1015036
2023-04-23 23:45,1015052,306610,495839,212603,1015052
2023-04-23 23:46,1015070,306622,495842,212606,1015070
2023-04-23 23:47,1015091,306641,495842,212608,1015091
2023-04-23 23:48,1015109,306649,495848,212612,1015109
2023-04-23 23:49,1015128,306665,495848,212615,1015128
2023-04-23 23:50,1015147,306681,495849,212617,1015147
2023-04-23 23:51,1015164,306693,495852,212619,1015164
2023-04-23 23:52,1015183,306705,495852,212626,1015183
2023-04-23 23:53,1015200,306710,495860,212630,1015200
2023-04-23 23:54,1015219,306724,495860,212635,1015219
2023-04-23 23:55,1015237,306732,495868,212637,1015237
2023-04-23 23:56,1015254,306749,495868,212637,1015254
2023-04-23 23:57,1015272,306759,495871,212642,1015272
2023-04-23 23:58,1015291,306774,495871,212646,1015291
2023-04-23 23:59,1015311,306784,495877,212650,1015311
2023-04-24 00:00,1015332,306800,495881,212651,1015332
2023-04-24 00:02,1015353,306818,495884,212651,1015353
2023-04-24 00:03,1015375,306837,495884,212654,1015375
2023-04-24 00:04,1015398,306848,495894,212656,1015398
2023-04-24 00:05,1015420,306865,495894,212661,1015420
2023-04-24 00:06,1015444,306881,495898,212665,1015444
2023-04-24 00:07,1015467,306898,495902,212667,1015467
2023-04-24 00:08,1015489,306917,495902,212670,1015489
2023-04-24 00:09,1015510,306928,495908,212674,1015510
2023-04-24 00:10,1015532,306943,495908,212681,1015532
2023-04-24 00:11,1015556,306964,495910,212682,1015556
2023-04-24 00:12,1015577,306982,495910,212685,1015577
2023-04-24 00:13,1015599,306998,495913,212688,1015599
2023-04-24 00:14,1015623,307018,495913,212692,1015623
2023-04-24 00:15,1015646,307034,495919,212693,1015646
2023-04-24 00:16,1015668,307053,495919,212696,1015668
2023-04-24 00:17,1015690,307069,495922,212699,1015690
2023-04-24 00:18,1015714,307091,495922,212701,1015714
2023-04-24 00:19,1015735,307097,495934,212704,1015735
2023-04-24 00:20,1015760,307120,495934,212706,1015760
2023-04-24 00:21,1015781,307136,495936,212709,1015781
2023-04-24 00:22,1015804,307156,495938,212710,1015804
2023-04-24 00:23,1015827,307177,495938,212712,1015827
2023-04-24 00:24,1015849,307197,495939,212713,1015849
2023-04-24 00:25,1015871,307215,495939,212717,1015871
2023-04-24 00:26,1015895,307230,495945,212720,1015895
2023-04-24 00:27,1015916,307247,495945,212724,1015916
2023-04-24 00:28,1015938,307258,495950,212730,1015938
2023-04-24 00:29,1015960,307279,495950,212731,1015960
2023-04-24 00:30,1015981,307290,495954,212737,1015981
2023-04-24 00:31,1016003,307309,495954,212740,1016003
2023-04-24 00:32,1016026,307324,495959,212743,1016026
2023-04-24 00:33,1016047,307344,495959,212744,1016047
2023-04-24 00:34,1016070,307360,495962,212748,1016070
2023-04-24 00:35,1016091,307380,495962,212749,1016091
2023-04-24 00:36,1016114,307395,495967,212752,1016114
2023-04-24 00:37,1016134,307414,495967,212753,1016134
2023-04-24 00:38,1016157,307432,495967,212758,1016157
2023-04-24 00:39,1016179,307453,495967,212759,1016179
2023-04-24 00:40,1016202,307474,495968,212760,1016202
2023-04-24 00:41,1016225,307494,495968,212763,1016225
2023-04-24 00:42,1016247,307511,495970,212766,1016247
2023-04-24 00:43,1016269,307531,495970,212768,1016269
2023-04-24 00:44,1016294,307554,495971,212769,1016294
2023-04-24 00:45,1016319,307577,495971,212771,1016319
2023-04-24 00:46,1016340,307594,495973,212773,1016340
2023-04-24 00:47,1016363,307615,495973,212775,1016363
2023-04-24 00:49,1016386,307631,495975,212780,1016386
2023-04-24 00:50,1016407,307649,495975,212783,1016407
2023-04-24 00:51,1016432,307669,495977,212786,1016432
2023-04-24 00:52,1016453,307690,495977,212786,1016453
2023-04-24 00:53,1016477,307709,495982,212786,1016477
2023-04-24 00:54,1016499,307729,495982,212788,1016499
2023-04-24 00:55,1016521,307750,495982,212789,1016521
2023-04-24 00:56,1016543,307770,495982,212791,1016543
2023-04-24 00:57,1016568,307786,495986,212796,1016568
2023-04-24 00:58,1016588,307801,495986,212801,1016588
2023-04-24 00:59,1016610,307819,495987,212804,1016610
2023-04-24 01:00,1016632,307840,495987,212805,1016632
2023-04-24 01:01,1016651,307857,495987,212807,1016651
2023-04-24 01:02,1016672,307874,495987,212811,1016672
2023-04-24 01:03,1016691,307890,495990,212811,1016691
2023-04-24 01:04,1016712,307909,495990,212813,1016712
2023-04-24 01:05,1016731,307924,495991,212816,1016731
2023-04-24 01:06,1016751,307944,495991,212816,1016751
2023-04-24 01:07,1016770,307960,495993,212817,1016770
2023-04-24 01:08,1016789,307975,495993,212821,1016789
2023-04-24 01:09,1016809,307992,495995,212822,1016809
2023-04-24 01:10,1016829,308006,495997,212826,1016829
2023-04-24 01:11,1016848,308023,495997,212828,1016848
2023-04-24 01:12,1016867,308040,495998,212829,1016867
2023-04-24 01:13,1016886,308058,495998,212830,1016886
2023-04-24 01:14,1016906,308073,496003,212830,1016906
2023-04-24 01:15,1016927,308093,496003,212831,1016927
2023-04-24 01:16,1016946,308110,496004,212832,1016946
2023-04-24 01:17,1016966,308128,496004,212834,1016966
2023-04-24 01:18,1016986,308144,496008,212834,1016986
2023-04-24 01:19,1017004,308160,496008,212836,1017004
2023-04-24 01:20,1017024,308174,496011,212839,1017024
2023-04-24 01:21,1017043,308191,496011,212841,1017043
2023-04-24 01:22,1017062,308205,496015,212842,1017062
2023-04-24 01:23,1017083,308225,496015,212843,1017083
2023-04-24 01:24,1017100,308238,496016,212846,1017100
2023-04-24 01:25,1017121,308256,496016,212849,1017121
2023-04-24 01:26,1017140,308273,496018,212849,1017140
2023-04-24 01:27,1017160,308293,496018,212849,1017160
2023-04-24 01:28,1017180,308309,496021,212850,1017180
2023-04-24 01:29,1017200,308328,496021,212851,1017200
2023-04-24 01:30,1017218,308342,496024,212852,1017218
2023-04-24 01:31,1017239,308362,496024,212853,1017239
2023-04-24 01:32,1017258,308379,496025,212854,1017258
2023-04-24 01:33,1017277,308396,496025,212856,1017277
2023-04-24 01:34,1017296,308414,496025,212857,1017296
2023-04-24 01:35,1017316,308434,496025,212857,1017316
2023-04-24 01:36,1017335,308449,496026,212860,1017335
2023-04-24 01:38,1017353,308466,496026,212861,1017353
2023-04-24 01:39,1017372,308478,496029,212865,1017372
2023-04-24 01:40,1017391,308497,496029,212865,1017391
2023-04-24 01:41,1017413,308516,496032,212865,1017413
2023-04-24 01:42,1017432,308534,496032,212866,1017432
2023-04-24 01:43,1017452,308552,496032,212868,1017452
2023-04-24 01:44,1017472,308569,496032,212871,1017472
2023-04-24 01:45,1017491,308585,496035,212871,1017491
2023-04-24 01:46,1017510,308601,496036,212873,1017510
2023-04-24 01:47,1017529,308618,496036,212875,1017529
2023-04-24 01:48,1017549,308635,496039,212875,1017549
2023-04-24 01:49,1017568,308654,496039,212875,1017568
2023-04-24 01:50,1017587,308667,496041,212879,1017587
2023-04-24 01:51,1017606,308683,496041,212882,1017606
2023-04-24 01:52,1017626,308701,496043,212882,1017626
2023-04-24 01:53,1017647,308722,496043,212882,1017647
2023-04-24 01:54,1017668,308742,496044,212882,1017668
2023-04-24 01:55,1017687,308761,496044,212882,1017687
2023-04-24 01:56,1017707,308780,496045,212882,1017707
2023-04-24 01:57,1017725,308798,496045,212882,1017725
2023-04-24 01:58,1017746,308817,496045,212884,1017746
2023-04-24 01:59,1017766,308836,496045,212885,1017766
2023-04-24 02:00,1017787,308857,496045,212885,1017787
2023-04-24 02:01,1017812,308881,496045,212886,1017812
2023-04-24 02:02,1017835,308903,496045,212887,1017835
2023-04-24 02:03,1017861,308927,496045,212889,1017861
2023-04-24 02:04,1017884,308947,496046,212891,1017884
2023-04-24 02:05,1017909,308971,496046,212892,1017909
2023-04-24 02:06,1017933,308994,496046,212893,1017933
2023-04-24 02:07,1017957,309018,496046,212893,1017957
2023-04-24 02:08,1017981,309039,496047,212895,1017981
2023-04-24 02:09,1018005,309063,496047,212895,1018005
2023-04-24 02:10,1018031,309085,496048,212898,1018031
2023-04-24 02:11,1018055,309109,496048,212898,1018055
2023-04-24 02:12,1018079,309133,496048,212898,1018079
2023-04-24 02:13,1018103,309156,496048,212899,1018103
2023-04-24 02:14,1018127,309178,496049,212900,1018127
2023-04-24 02:15,1018150,309199,496049,212902,1018150
2023-04-24 02:16,1018175,309220,496052,212903,1018175
2023-04-24 02:17,1018199,309242,496052,212905,1018199
2023-04-24 02:18,1018224,309263,496056,212905,1018224
2023-04-24 02:19,1018247,309282,496056,212909,1018247
2023-04-24 02:20,1018270,309304,496057,212909,1018270
2023-04-24 02:21,1018294,309328,496057,212909,1018294
2023-04-24 02:22,1018323,309350,496062,212911,1018323
2023-04-24 02:23,1018345,309372,496062,212911,1018345
2023-04-24 02:24,1018369,309396,496061,212912,1018369
2023-04-24 02:26,1018395,309420,496061,212914,1018395
2023-04-24 02:27,1018419,309444,496062,212913,1018419
2023-04-24 02:28,1018443,309466,496062,212915,1018443
2023-04-24 02:29,1018468,309489,496063,212916,1018468
2023-04-24 02:30,1018491,309511,496063,212917,1018491
2023-04-24 02:31,1018516,309533,496065,212918,1018516
2023-04-24 02:32,1018541,309558,496065,212918,1018541
2023-04-24 02:33,1018564,309577,496066,212921,1018564
2023-04-24 02:34,1018588,309598,496066,212924,1018588
2023-04-24 02:35,1018613,309622,496066,212925,1018613
2023-04-24 02:36,1018636,309645,496066,212925,1018636
2023-04-24 02:37,1018661,309669,496067,212925,1018661
2023-04-24 02:38,1018685,309690,496067,212928,1018685
2023-04-24 02:39,1018710,309713,496068,212929,1018710
2023-04-24 02:40,1018732,309733,496068,212931,1018732
2023-04-24 02:41,1018757,309756,496070,212931,1018757
2023-04-24 02:42,1018780,309777,496070,212933,1018780
2023-04-24 02:43,1018806,309803,496070,212933,1018806
2023-04-24 02:44,1018830,309827,496070,212933,1018830
2023-04-24 02:45,1018854,309847,496073,212934,1018854
2023-04-24 02:46,1018879,309869,496073,212937,1018879
2023-04-24 02:47,1018904,309892,496074,212938,1018904
2023-04-24 02:48,1018927,309915,496074,212938,1018927
2023-04-24 02:49,1018952,309940,496074,212938,1018952
2023-04-24 02:50,1018976,309964,496074,212938,1018976
2023-04-24 02:51,1019000,309988,496074,212938,1019000
2023-04-24 02:52,1019025,310011,496074,212940,1019025
2023-04-24 02:53,1019049,310034,496075,212940,1019049
2023-04-24 02:54,1019073,310057,496075,212941,1019073
2023-04-24 02:55,1019097,310081,496075,212941,1019097
2023-04-24 02:56,1019123,310107,496075,212941,1019123
2023-04-24 02:57,1019146,310130,496075,212941,1019146
2023-04-24 02:58,1019171,310154,496075,212942,1019171
2023-04-24 02:59,1019195,310177,496076,212942,1019195
2023-04-24 03:00,1019211,310193,496076,212942,1019211
2023-04-24 03:01,1019223,310203,496078,212942,1019223
2023-04-24 03:02,1019234,310212,496078,212944,1019234
2023-04-24 03:03,1019246,310224,496078,212944,1019246
2023-04-24 03:04,1019257,310235,496078,212944,1019257
2023-04-24 03:05,1019269,310244,496079,212946,1019269
2023-04-24 03:06,1019281,310254,496079,212948,1019281
2023-04-24 03:07,1019292,310264,496080,212948,1019292
2023-04-24 03:08,1019304,310276,496080,212948,1019304
2023-04-24 03:09,1019315,310286,496080,212949,1019315
2023-04-24 03:10,1019326,310297,496080,212949,1019326
2023-04-24 03:11,1019338,310307,496081,212950,1019338
2023-04-24 03:13,1019350,310319,496081,212950,1019350
2023-04-24 03:14,1019362,310330,496082,212950,1019362
2023-04-24 03:15,1019374,310342,496082,212950,1019374
2023-04-24 03:16,1019386,310353,496082,212951,1019386
2023-04-24 03:17,1019397,310364,496082,212951,1019397
2023-04-24 03:18,1019410,310377,496082,212951,1019410
2023-04-24 03:19,1019422,310388,496082,212952,1019422
2023-04-24 03:20,1019433,310398,496083,212952,1019433
2023-04-24 03:21,1019444,310409,496083,212952,1019444
2023-04-24 03:22,1019456,310420,496084,212952,1019456
2023-04-24 03:23,1019467,310431,496084,212952,1019467
2023-04-24 03:24,1019479,310441,496085,212953,1019479
2023-04-24 03:25,1019490,310452,496085,212953,1019490
2023-04-24 03:26,1019502,310464,496085,212953,1019502
2023-04-24 03:27,1019514,310476,496085,212953,1019514
2023-04-24 03:28,1019526,310488,496085,212953,1019526
2023-04-24 03:29,1019539,310501,496085,212953,1019539
2023-04-24 03:30,1019551,310513,496085,212953,1019551
2023-04-24 03:31,1019562,310522,496085,212955,1019562
2023-04-24 03:32,1019574,310533,496085,212956,1019574
2023-04-24 03:33,1019585,310544,496085,212956,1019585
2023-04-24 03:34,1019596,310556,496085,212955,1019596
2023-04-24 03:35,1019609,310568,496085,212956,1019609
2023-04-24 03:36,1019620,310578,496086,212956,1019620
2023-04-24 03:37,1019631,310588,496086,212957,1019631
2023-04-24 03:38,1019643,310598,496088,212957,1019643
2023-04-24 03:39,1019655,310610,496088,212957,1019655
2023-04-24 03:40,1019668,310622,496088,212958,1019668
2023-04-24 03:41,1019678,310631,496088,212959,1019678
2023-04-24 03:42,1019691,310643,496089,212959,1019691
2023-04-24 03:43,1019703,310655,496089,212959,1019703
2023-04-24 03:44,1019715,310667,496089,212959,1019715
2023-04-24 03:45,1019726,310676,496089,212961,1019726
2023-04-24 03:46,1019738,310685,496091,212962,1019738
2023-04-24 03:47,1019750,310697,496091,212962,1019750
2023-04-24 03:48,1019761,310708,496091,212962,1019761
2023-04-24 03:49,1019772,310719,496091,212962,1019772
2023-04-24 03:50,1019785,310728,496094,212963,1019785
2023-04-24 03:51,1019797,310739,496094,212964,1019797
2023-04-24 03:52,1019808,310749,496094,212965,1019808
2023-04-24 03:53,1019822,310763,496094,212965,1019822
2023-04-24 03:54,1019834,310774,496095,212965,1019834
2023-04-24 03:55,1019845,310785,496095,212965,1019845
2023-04-24 03:56,1019858,310798,496095,212965,1019858
2023-04-24 03:57,1019869,310809,496095,212965,1019869
2023-04-24 03:58,1019881,310821,496095,212965,1019881
2023-04-24 04:00,1019893,310833,496095,212965,1019893
2023-04-24 04:01,1019909,310847,496095,212967,1019909
2023-04-24 04:02,1019927,310864,496095,212968,1019927
2023-04-24 04:03,1019942,310878,496096,212968,1019942
2023-04-24 04:04,1019959,310895,496096,212968,1019959
2023-04-24 04:05,1019975,310911,496096,212968,1019975
2023-04-24 04:06,1019991,310927,496096,212968,1019991
2023-04-24 04:07,1020006,310942,496096,212968,1020006
2023-04-24 04:08,1020023,310959,496096,212968,1020023
2023-04-24 04:09,1020038,310974,496096,212968,1020038
2023-04-24 04:10,1020054,310988,496096,212970,1020054
2023-04-24 04:11,1020071,311004,496097,212970,1020071
2023-04-24 04:12,1020086,311018,496097,212971,1020086
2023-04-24 04:13,1020103,311035,496097,212971,1020103
2023-04-24 04:14,1020119,311051,496097,212971,1020119
2023-04-24 04:15,1020134,311064,496098,212972,1020134
2023-04-24 04:16,1020150,311080,496098,212972,1020150
2023-04-24 04:17,1020166,311096,496098,212972,1020166
2023-04-24 04:18,1020182,311112,496098,212972,1020182
2023-04-24 04:19,1020198,311128,496098,212972,1020198
2023-04-24 04:20,1020213,311143,496098,212972,1020213
2023-04-24 04:21,1020230,311159,496098,212973,1020230
2023-04-24 04:22,1020244,311173,496098,212973,1020244
2023-04-24 04:23,1020260,311189,496098,212973,1020260
2023-04-24 04:24,1020276,311205,496098,212973,1020276
2023-04-24 04:25,1020293,311220,496100,212973,1020293
2023-04-24 04:26,1020308,311235,496100,212973,1020308
2023-04-24 04:27,1020325,311252,496100,212973,1020325
2023-04-24 04:28,1020342,311269,496100,212973,1020342
2023-04-24 04:29,1020356,311282,496100,212974,1020356
2023-04-24 04:30,1020374,311300,496100,212974,1020374
2023-04-24 04:31,1020391,311316,496101,212974,1020391
2023-04-24 04:32,1020407,311332,496101,212974,1020407
2023-04-24 04:33,1020422,311347,496101,212974,1020422
2023-04-24 04:34,1020438,311362,496101,212975,1020438
2023-04-24 04:35,1020454,311377,496101,212976,1020454
2023-04-24 04:36,1020470,311393,496101,212976,1020470
2023-04-24 04:37,1020486,311409,496101,212976,1020486
2023-04-24 04:38,1020501,311424,496101,212976,1020501
2023-04-24 04:39,1020517,311440,496101,212976,1020517
2023-04-24 04:40,1020534,311457,496101,212976,1020534
2023-04-24 04:41,1020549,311472,496101,212976,1020549
2023-04-24 04:42,1020566,311489,496101,212976,1020566
2023-04-24 04:43,1020582,311504,496102,212976,1020582
2023-04-24 04:44,1020598,311520,496102,212976,1020598
2023-04-24 04:45,1020614,311534,496104,212976,1020614
2023-04-24 04:47,1020629,311548,496104,212977,1020629
2023-04-24 04:48,1020645,311562,496105,212978,1020645
2023-04-24 04:49,1020661,311577,496105,212979,1020661
2023-04-24 04:50,1020676,311590,496105,212981,1020676
2023-04-24 04:51,1020693,311607,496105,212981,1020693
2023-04-24 04:52,1020709,311623,496105,212981,1020709
2023-04-24 04:53,1020725,311638,496105,212982,1020725
2023-04-24 04:54,1020741,311653,496106,212982,1020741
2023-04-24 04:55,1020757,311669,496106,212982,1020757
2023-04-24 04:56,1020773,311685,496106,212982,1020773
2023-04-24 04:57,1020789,311700,496106,212983,1020789
2023-04-24 04:58,1020804,311714,496106,212984,1020804
2023-04-24 04:59,1020821,311731,496106,212984,1020821
2023-04-24 05:00,1020837,311746,496107,212984,1020837
2023-04-24 05:01,1020858,311767,496107,212984,1020858
2023-04-24 05:02,1020878,311784,496109,212985,1020878
2023-04-24 05:03,1020898,311804,496109,212985,1020898
2023-04-24 05:04,1020918,311824,496109,212985,1020918
2023-04-24 05:05,1020939,311845,496109,212985,1020939
2023-04-24 05:06,1020959,311865,496109,212985,1020959
2023-04-24 05:07,1020980,311886,496109,212985,1020980
2023-04-24 05:08,1021000,311906,496109,212985,1021000
2023-04-24 05:09,1021020,311926,496109,212985,1021020
2023-04-24 05:10,1021041,311946,496110,212985,1021041
2023-04-24 05:11,1021063,311968,496110,212985,1021063
2023-04-24 05:12,1021083,311984,496111,212988,1021083
2023-04-24 05:13,1021103,312004,496111,212988,1021103
2023-04-24 05:14,1021123,312024,496111,212988,1021123
2023-04-24 05:15,1021144,312045,496111,212988,1021144
2023-04-24 05:16,1021165,312066,496111,212988,1021165
2023-04-24 05:17,1021185,312086,496111,212988,1021185
2023-04-24 05:18,1021204,312105,496111,212988,1021204
2023-04-24 05:19,1021226,312127,496111,212988,1021226
2023-04-24 05:20,1021244,312145,496111,212988,1021244
2023-04-24 05:21,1021265,312166,496111,212988,1021265
2023-04-24 05:22,1021286,312186,496112,212988,1021286
2023-04-24 05:23,1021306,312205,496112,212989,1021306
2023-04-24 05:24,1021326,312224,496113,212989,1021326
2023-04-24 05:25,1021347,312245,496113,212989,1021347
2023-04-24 05:26,1021367,312265,496113,212989,1021367
2023-04-24 05:27,1021387,312285,496113,212989,1021387
2023-04-24 05:28,1021408,312305,496114,212989,1021408
2023-04-24 05:29,1021429,312326,496114,212989,1021429
2023-04-24 05:30,1021450,312347,496114,212989,1021450
2023-04-24 05:31,1021472,312369,496114,212989,1021472
2023-04-24 05:32,1021492,312387,496116,212989,1021492
2023-04-24 05:34,1021512,312406,496116,212990,1021512
2023-04-24 05:35,1021532,312426,496116,212990,1021532
2023-04-24 05:36,1021553,312447,496116,212990,1021553
2023-04-24 05:37,1021573,312466,496117,212990,1021573
2023-04-24 05:38,1021593,312486,496117,212990,1021593
2023-04-24 05:39,1021613,312506,496117,212990,1021613
2023-04-24 05:40,1021633,312526,496117,212990,1021633
2023-04-24 05:41,1021654,312547,496117,212990,1021654
2023-04-24 05:42,1021675,312568,496117,212990,1021675
2023-04-24 05:43,1021695,312588,496117,212990,1021695
2023-04-24 05:44,1021715,312607,496117,212991,1021715
2023-04-24 05:45,1021735,312626,496118,212991,1021735
2023-04-24 05:46,1021756,312647,496118,212991,1021756
2023-04-24 05:47,1021776,312666,496119,212991,1021776
2023-04-24 05:48,1021796,312686,496119,212991,1021796
2023-04-24 05:49,1021816,312704,496120,212992,1021816
2023-04-24 05:50,1021838,312724,496120,212994,1021838
2023-04-24 05:51,1021858,312744,496120,212994,1021858
2023-04-24 05:52,1021878,312764,496120,212994,1021878
2023-04-24 05:53,1021898,312784,496120,212994,1021898
2023-04-24 05:54,1021918,312804,496120,212994,1021918
2023-04-24 05:55,1021940,312826,496120,212994,1021940
2023-04-24 05:56,1021960,312846,496120,212994,1021960
2023-04-24 05:57,1021980,312866,496120,212994,1021980
2023-04-24 05:58,1022000,312885,496120,212995,1022000
2023-04-24 05:59,1022021,312905,496121,212995,1022021
2023-04-24 06:00,1022037,312920,496121,212996,1022037
2023-04-24 06:01,1022048,312932,496120,212996,1022048
2023-04-24 06:02,1022058,312942,496120,212996,1022058
2023-04-24 06:03,1022069,312952,496120,212997,1022069
2023-04-24 06:04,1022079,312961,496120,212998,1022079
2023-04-24 06:05,1022089,312969,496121,212999,1022089
2023-04-24 06:06,1022099,312978,496121,213000,1022099
2023-04-24 06:07,1022109,312987,496122,213000,1022109
2023-04-24 06:08,1022120,312997,496123,213000,1022120
2023-04-24 06:09,1022130,313007,496123,213000,1022130
2023-04-24 06:10,1022140,313016,496124,213000,1022140
2023-04-24 06:11,1022150,313024,496125,213001,1022150
2023-04-24 06:12,1022160,313034,496125,213001,1022160
2023-04-24 06:13,1022170,313042,496127,213001,1022170
2023-04-24 06:14,1022180,313052,496127,213001,1022180
2023-04-24 06:15,1022191,313063,496127,213001,1022191
2023-04-24 06:16,1022201,313073,496127,213001,1022201
2023-04-24 06:17,1022211,313083,496127,213001,1022211
2023-04-24 06:18,1022221,313093,496127,213001,1022221
2023-04-24 06:19,1022230,313101,496127,213002,1022230
2023-04-24 06:21,1022240,313111,496127,213002,1022240
2023-04-24 06:22,1022250,313121,496127,213002,1022250
2023-04-24 06:23,1022260,313130,496127,213003,1022260
2023-04-24 06:24,1022271,313138,496130,213003,1022271
2023-04-24 06:25,1022281,313148,496130,213003,1022281
2023-04-24 06:26,1022291,313156,496131,213004,1022291
2023-04-24 06:27,1022301,313166,496131,213004,1022301
2023-04-24 06:28,1022311,313176,496131,213004,1022311
2023-04-24 06:29,1022321,313185,496131,213005,1022321
2023-04-24 06:30,1022331,313195,496131,213005,1022331
2023-04-24 06:31,1022341,313204,496131,213006,1022341
2023-04-24 06:32,1022352,313215,496131,213006,1022352
2023-04-24 06:33,1022363,313226,496131,213006,1022363
2023-04-24 06:34,1022376,313235,496132,213009,1022376
2023-04-24 06:35,1022386,313244,496132,213010,1022386
2023-04-24 06:36,1022397,313253,496133,213011,1022397
2023-04-24 06:37,1022407,313263,496133,213011,1022407
2023-04-24 06:38,1022417,313273,496133,213011,1022417
2023-04-24 06:39,1022427,313280,496134,213013,1022427
2023-04-24 06:40,1022437,313287,496134,213016,1022437
2023-04-24 06:41,1022449,313298,496135,213016,1022449
2023-04-24 06:42,1022459,313307,496135,213017,1022459
2023-04-24 06:43,1022470,313316,496136,213018,1022470
2023-04-24 06:44,1022479,313324,496136,213019,1022479
2023-04-24 06:45,1022489,313334,496136,213019,1022489
2023-04-24 06:46,1022499,313344,496136,213019,1022499
2023-04-24 06:47,1022511,313357,496135,213019,1022511
2023-04-24 06:48,1022522,313366,496135,213021,1022522
2023-04-24 06:49,1022533,313375,496136,213022,1022533
2023-04-24 06:50,1022544,313385,496136,213023,1022544
2023-04-24 06:51,1022554,313392,496138,213024,1022554
2023-04-24 06:52,1022564,313402,496138,213024,1022564
2023-04-24 06:53,1022574,313411,496138,213025,1022574
2023-04-24 06:54,1022584,313419,496138,213027,1022584
2023-04-24 06:55,1022595,313428,496140,213027,1022595
2023-04-24 06:56,1022607,313440,496140,213027,1022607
2023-04-24 06:57,1022617,313450,496140,213027,1022617
2023-04-24 06:58,1022628,313457,496140,213031,1022628
2023-04-24 06:59,1022639,313467,496140,213032,1022639
2023-04-24 07:00,1022647,313475,496140,213032,1022647
2023-04-24 07:01,1022655,313480,496140,213035,1022655
2023-04-24 07:02,1022664,313488,496140,213036,1022664
2023-04-24 07:03,1022672,313495,496140,213037,1022672
2023-04-24 07:04,1022680,313502,496140,213038,1022680
2023-04-24 07:05,1022689,313511,496140,213038,1022689
2023-04-24 07:06,1022697,313517,496142,213038,1022697
2023-04-24 07:08,1022705,313523,496142,213040,1022705
2023-04-24 07:09,1022714,313532,496142,213040,1022714
2023-04-24 07:10,1022723,313540,496142,213041,1022723
2023-04-24 07:11,1022733,313550,496142,213041,1022733
2023-04-24 07:12,1022741,313556,496142,213043,1022741
2023-04-24 07:13,1022750,313564,496142,213044,1022750
2023-04-24 07:14,1022759,313571,496142,213046,1022759
2023-04-24 07:15,1022768,313578,496142,213048,1022768
2023-04-24 07:16,1022776,313581,496146,213049,1022776
2023-04-24 07:17,1022784,313588,496146,213050,1022784
2023-04-24 07:18,1022792,313596,496146,213050,1022792
2023-04-24 07:19,1022802,313605,496146,213051,1022802
2023-04-24 07:20,1022810,313609,496146,213055,1022810
2023-04-24 07:21,1022819,313617,496146,213056,1022819
2023-04-24 07:22,1022828,313625,496146,213057,1022828
2023-04-24 07:23,1022836,313630,496146,213060,1022836
2023-04-24 07:24,1022845,313639,496146,213060,1022845
2023-04-24 07:25,1022855,313649,496146,213060,1022855
2023-04-24 07:26,1022862,313651,496151,213060,1022862
2023-04-24 07:27,1022870,313657,496151,213062,1022870
2023-04-24 07:28,1022878,313665,496151,213062,1022878
2023-04-24 07:29,1022888,313676,496151,213061,1022888
2023-04-24 07:30,1022896,313682,496152,213062,1022896
2023-04-24 07:31,1022905,313688,496152,213065,1022905
2023-04-24 07:32,1022916,313699,496152,213065,1022916
2023-04-24 07:33,1022925,313708,496152,213065,1022925
2023-04-24 07:34,1022937,313719,496153,213065,1022937
2023-04-24 07:35,1022945,313724,496153,213068,1022945
2023-04-24 07:36,1022953,313729,496155,213069,1022953
2023-04-24 07:37,1022961,313737,496155,213069,1022961
2023-04-24 07:38,1022969,313739,496157,213073,1022969
2023-04-24 07:39,1022979,313749,496157,213073,1022979
2023-04-24 07:40,1022988,313755,496159,213074,1022988
2023-04-24 07:41,1022998,313765,496159,213074,1022998
2023-04-24 07:42,1023006,313769,496161,213076,1023006
2023-04-24 07:43,1023016,313778,496161,213077,1023016
2023-04-24 07:44,1023024,313785,496161,213078,1023024
2023-04-24 07:45,1023033,313794,496161,213078,1023033
2023-04-24 07:46,1023045,313804,496163,213078,1023045
2023-04-24 07:47,1023055,313811,496163,213081,1023055
2023-04-24 07:48,1023064,313819,496164,213081,1023064
2023-04-24 07:49,1023073,313826,496164,213083,1023073
2023-04-24 07:50,1023083,313833,496166,213084,1023083
2023-04-24 07:51,1023092,313840,496166,213086,1023092
2023-04-24 07:52,1023100,313846,496167,213087,1023100
2023-04-24 07:54,1023112,313858,496167,213087,1023112
2023-04-24 07:55,1023121,313865,496169,213087,1023121
2023-04-24 07:56,1023130,313871,496169,213090,1023130
2023-04-24 07:57,1023137,313876,496170,213091,1023137
2023-04-24 07:58,1023148,313887,496170,213091,1023148
2023-04-24 07:59,1023156,313892,496171,213093,1023156
2023-04-24 08:00,1023166,313901,496171,213094,1023166
2023-04-24 08:01,1023190,313923,496173,213094,1023190
2023-04-24 08:02,1023217,313950,496173,213094,1023217
2023-04-24 08:03,1023243,313973,496173,213097,1023243
2023-04-24 08:04,1023267,313996,496173,213098,1023267
2023-04-24 08:05,1023292,314018,496176,213098,1023292
2023-04-24 08:06,1023317,314041,496176,213100,1023317
2023-04-24 08:07,1023343,314066,496176,213101,1023343
2023-04-24 08:08,1023372,314092,496176,213104,1023372
2023-04-24 08:09,1023399,314118,496176,213105,1023399
2023-04-24 08:10,1023425,314142,496176,213107,1023425
2023-04-24 08:11,1023448,314161,496180,213107,1023448
2023-04-24 08:12,1023476,314189,496180,213107,1023476
2023-04-24 08:13,1023504,314215,496181,213108,1023504
2023-04-24 08:14,1023531,314241,496181,213109,1023531
2023-04-24 08:15,1023556,314264,496183,213109,1023556
2023-04-24 08:16,1023582,314289,496183,213110,1023582
2023-04-24 08:17,1023608,314313,496184,213111,1023608
2023-04-24 08:18,1023634,314336,496184,213114,1023634
2023-04-24 08:19,1023661,314361,496186,213114,1023661
2023-04-24 08:20,1023686,314386,496186,213114,1023686
2023-04-24 08:21,1023711,314409,496186,213116,1023711
2023-04-24 08:22,1023737,314434,496186,213117,1023737
2023-04-24 08:23,1023765,314456,496189,213120,1023765
2023-04-24 08:24,1023790,314480,496189,213121,1023790
2023-04-24 08:25,1023815,314500,496193,213122,1023815
2023-04-24 08:26,1023843,314528,496193,213122,1023843
2023-04-24 08:27,1023868,314551,496193,213124,1023868
2023-04-24 08:28,1023893,314574,496193,213126,1023893
2023-04-24 08:29,1023921,314600,496194,213127,1023921
2023-04-24 08:30,1023948,314624,496194,213130,1023948
2023-04-24 08:31,1023976,314649,496194,213133,1023976
2023-04-24 08:32,1024002,314675,496194,213133,1024002
2023-04-24 08:33,1024027,314693,496196,213138,1024027
2023-04-24 08:34,1024052,314717,496196,213139,1024052
2023-04-24 08:35,1024081,314742,496197,213142,1024081
2023-04-24 08:36,1024105,314765,496197,213143,1024105
2023-04-24 08:37,1024135,314790,496197,213148,1024135
2023-04-24 08:38,1024160,314813,496197,213150,1024160
2023-04-24 08:39,1024187,314837,496199,213151,1024187
2023-04-24 08:41,1024214,314863,496199,213152,1024214
2023-04-24 08:42,1024241,314887,496202,213152,1024241
2023-04-24 08:43,1024266,314910,496202,213154,1024266
2023-04-24 08:44,1024295,314939,496202,213154,1024295
2023-04-24 08:45,1024321,314964,496202,213155,1024321
2023-04-24 08:46,1024347,314987,496204,213156,1024347
2023-04-24 08:47,1024372,315011,496204,213157,1024372
2023-04-24 08:48,1024398,315037,496204,213157,1024398
2023-04-24 08:49,1024424,315061,496205,213158,1024424
2023-04-24 08:50,1024450,315087,496205,213158,1024450
2023-04-24 08:51,1024476,315110,496208,213158,1024476
2023-04-24 08:52,1024503,315136,496208,213159,1024503
2023-04-24 08:53,1024529,315156,496211,213162,1024529
2023-04-24 08:54,1024554,315177,496211,213166,1024554
2023-04-24 08:55,1024580,315201,496213,213166,1024580
2023-04-24 08:56,1024604,315225,496213,213166,1024604
2023-04-24 08:57,1024630,315247,496216,213167,1024630
2023-04-24 08:58,1024655,315272,496216,213167,1024655
2023-04-24 08:59,1024680,315292,496218,213170,1024680
2023-04-24 09:00,1024699,315310,496218,213171,1024699
2023-04-24 09:01,1024710,315321,496218,213171,1024710
2023-04-24 09:02,1024720,315327,496218,213175,1024720
2023-04-24 09:03,1024736,315341,496219,213176,1024736
2023-04-24 09:04,1024747,315350,496219,213178,1024747
2023-04-24 09:05,1024756,315357,496220,213179,1024756
2023-04-24 09:06,1024766,315361,496220,213185,1024766
2023-04-24 09:07,1024778,315370,496222,213186,1024778
2023-04-24 09:08,1024790,315382,496222,213186,1024790
2023-04-24 09:09,1024801,315389,496224,213188,1024801
2023-04-24 09:10,1024811,315399,496224,213188,1024811
2023-04-24 09:11,1024820,315406,496226,213188,1024820
2023-04-24 09:12,1024832,315417,496226,213189,1024832
2023-04-24 09:13,1024842,315423,496228,213191,1024842
2023-04-24 09:14,1024853,315434,496228,213191,1024853
2023-04-24 09:15,1024865,315445,496229,213191,1024865
2023-04-24 09:16,1024876,315454,496229,213193,1024876
2023-04-24 09:17,1024886,315458,496232,213196,1024886
2023-04-24 09:18,1024895,315465,496232,213198,1024895
2023-04-24 09:19,1024909,315476,496235,213198,1024909
2023-04-24 09:20,1024921,315484,496235,213202,1024921
2023-04-24 09:21,1024932,315495,496234,213203,1024932
2023-04-24 09:22,1024943,315501,496236,213206,1024943
2023-04-24 09:23,1024955,315513,496236,213206,1024955
2023-04-24 09:24,1024965,315520,496237,213208,1024965
2023-04-24 09:25,1024978,315532,496237,213209,1024978
2023-04-24 09:26,1024989,315540,496237,213212,1024989
2023-04-24 09:28,1025000,315548,496237,213215,1025000
2023-04-24 09:29,1025010,315556,496238,213216,1025010
2023-04-24 09:30,1025023,315567,496238,213218,1025023
2023-04-24 09:31,1025034,315574,496240,213220,1025034
2023-04-24 09:32,1025048,315588,496240,213220,1025048
2023-04-24 09:33,1025059,315598,496240,213221,1025059
2023-04-24 09:34,1025070,315609,496240,213221,1025070
2023-04-24 09:35,1025082,315617,496243,213222,1025082
2023-04-24 09:36,1025091,315625,496243,213223,1025091
2023-04-24 09:37,1025102,315637,496242,213223,1025102
2023-04-24 09:38,1025114,315649,496242,213223,1025114
2023-04-24 09:39,1025124,315656,496244,213224,1025124
2023-04-24 09:40,1025134,315665,496244,213225,1025134
2023-04-24 09:41,1025144,315671,496246,213227,1025144
2023-04-24 09:42,1025155,315680,496246,213229,1025155
2023-04-24 09:43,1025166,315682,496253,213231,1025166
2023-04-24 09:44,1025175,315690,496253,213232,1025175
2023-04-24 09:45,1025187,315695,496257,213235,1025187
2023-04-24 09:46,1025197,315703,496257,213237,1025197
2023-04-24 09:47,1025208,315711,496258,213239,1025208
2023-04-24 09:48,1025219,315718,496258,213243,1025219
2023-04-24 09:49,1025230,315723,496261,213246,1025230
2023-04-24 09:50,1025241,315732,496261,213248,1025241
2023-04-24 09:51,1025251,315738,496262,213251,1025251
2023-04-24 09:52,1025262,315748,496262,213252,1025262
2023-04-24 09:53,1025272,315756,496263,213253,1025272
2023-04-24 09:54,1025283,315764,496263,213256,1025283
2023-04-24 09:55,1025293,315769,496265,213259,1025293
2023-04-24 09:56,1025302,315778,496265,213259,1025302
2023-04-24 09:57,1025312,315783,496269,213260,1025312
2023-04-24 09:58,1025324,315792,496269,213263,1025324
2023-04-24 09:59,1025335,315801,496270,213264,1025335
2023-04-24 10:00,1025347,315811,496270,213266,1025347
2023-04-24 10:01,1025365,315824,496274,213267,1025365
2023-04-24 10:02,1025381,315839,496274,213268,1025381
2023-04-24 10:03,1025397,315850,496275,213272,1025397
2023-04-24 10:04,1025412,315861,496276,213275,1025412
2023-04-24 10:05,1025429,315876,496276,213277,1025429
2023-04-24 10:06,1025443,315886,496278,213279,1025443
2023-04-24 10:07,1025460,315899,496278,213283,1025460
2023-04-24 10:08,1025475,315908,496282,213285,1025475
2023-04-24 10:09,1025491,315923,496282,213286,1025491
2023-04-24 10:10,1025505,315934,496282,213289,1025505
2023-04-24 10:11,1025522,315948,496282,213292,1025522
2023-04-24 10:12,1025536,315962,496282,213292,1025536
2023-04-24 10:13,1025551,315977,496282,213292,1025551
2023-04-24 10:14,1025565,315988,496282,213295,1025565
2023-04-24 10:16,1025580,316003,496282,213295,1025580
2023-04-24 10:17,1025594,316015,496282,213297,1025594
2023-04-24 10:18,1025609,316028,496282,213299,1025609
2023-04-24 10:19,1025625,316035,496290,213300,1025625
2023-04-24 10:20,1025640,316050,496290,213300,1025640
2023-04-24 10:21,1025655,316062,496291,213302,1025655
2023-04-24 10:22,1025672,316072,496296,213304,1025672
2023-04-24 10:23,1025686,316084,496296,213306,1025686
2023-04-24 10:24,1025701,316095,496298,213308,1025701
2023-04-24 10:25,1025716,316107,496298,213311,1025716
2023-04-24 10:26,1025731,316120,496300,213311,1025731
2023-04-24 10:27,1025745,316133,496300,213312,1025745
2023-04-24 10:28,1025760,316145,496300,213315,1025760
2023-04-24 10:29,1025774,316156,496301,213317,1025774
2023-04-24 10:30,1025791,316172,496301,213318,1025791
2023-04-24 10:31,1025805,316182,496302,213321,1025805
2023-04-24 10:32,1025821,316195,496302,213324,1025821
2023-04-24 10:33,1025835,316205,496305,213325,1025835
2023-04-24 10:34,1025850,316220,496305,213325,1025850
2023-04-24 10:35,1025865,316234,496306,213325,1025865
2023-04-24 10:36,1025880,316247,496306,213327,1025880
2023-04-24 10:37,1025895,316256,496311,213328,1025895
2023-04-24 10:38,1025912,316271,496311,213330,1025912
2023-04-24 10:39,1025927,316281,496314,213332,1025927
2023-04-24 10:40,1025942,316295,496314,213333,1025942
2023-04-24 10:41,1025957,316302,496318,213337,1025957
2023-04-24 10:42,1025974,316316,496318,213340,1025974
2023-04-24 10:43,1025990,316328,496320,213342,1025990
2023-04-24 10:44,1026008,316343,496320,213345,1026008
2023-04-24 10:45,1026022,316352,496325,213345,1026022
2023-04-24 10:46,1026037,316363,496325,213349,1026037
2023-04-24 10:47,1026052,316377,496326,213349,1026052
2023-04-24 10:48,1026070,316393,496326,213351,1026070
2023-04-24 10:49,1026085,316401,496330,213354,1026085
2023-04-24 10:50,1026099,316411,496330,213358,1026099
2023-04-24 10:51,1026116,316420,496332,213364,1026116
2023-04-24 10:53,1026133,316432,496332,213369,1026133
2023-04-24 10:54,1026153,316447,496334,213372,1026153
2023-04-24 10:55,1026169,316461,496334,213374,1026169
2023-04-24 10:56,1026183,316472,496334,213377,1026183
2023-04-24 10:57,1026197,316482,496334,213381,1026197
2023-04-24 10:58,1026212,316496,496334,213382,1026212
2023-04-24 10:59,1026226,316508,496334,213384,1026226
2023-04-24 11:00,1026244,316522,496334,213388,1026244
2023-04-24 11:01,1026265,316539,496334,213392,1026265
2023-04-24 11:02,1026287,316557,496334,213396,1026287
2023-04-24 11:03,1026317,316584,496334,213399,1026317
2023-04-24 11:04,1026339,316588,496349,213402,1026339
2023-04-24 11:05,1026361,316606,496349,213406,1026361
2023-04-24 11:06,1026382,316625,496349,213408,1026382
2023-04-24 11:07,1026405,316642,496349,213414,1026405
2023-04-24 11:08,1026427,316659,496349,213419,1026427
2023-04-24 11:11,1026448,316661,496360,213427,1026448
2023-04-24 11:12,1026507,316715,496360,213432,1026507
2023-04-24 11:13,1026529,316730,496363,213436,1026529
2023-04-24 11:14,1026552,316751,496363,213438,1026552
2023-04-24 11:15,1026576,316768,496366,213442,1026576
2023-04-24 11:16,1026597,316788,496366,213443,1026597
2023-04-24 11:17,1026619,316804,496369,213446,1026619
2023-04-24 11:18,1026642,316825,496369,213448,1026642
2023-04-24 11:20,1026662,316836,496373,213453,1026662
2023-04-24 11:21,1026706,316877,496373,213456,1026706
2023-04-24 11:23,1026730,316891,496378,213461,1026730
2023-04-24 11:25,1026760,316918,496378,213464,1026760
2023-04-24 11:27,1026812,316965,496380,213467,1026812
2023-04-24 11:28,1026859,317010,496380,213469,1026859
2023-04-24 11:29,1026880,317020,496383,213477,1026880
2023-04-24 11:30,1026906,317044,496383,213479,1026906
2023-04-24 11:31,1026926,317064,496384,213478,1026926
2023-04-24 11:32,1026947,317083,496384,213480,1026947
2023-04-24 11:33,1026972,317103,496386,213483,1026972
2023-04-24 11:34,1026994,317125,496386,213483,1026994
2023-04-24 11:35,1027017,317143,496387,213487,1027017
2023-04-24 11:36,1027039,317164,496387,213488,1027039
2023-04-24 11:37,1027061,317179,496390,213492,1027061
2023-04-24 11:38,1027084,317202,496390,213492,1027084
2023-04-24 11:40,1027105,317218,496393,213494,1027105
2023-04-24 11:41,1027128,317236,496393,213499,1027128
2023-04-24 11:42,1027150,317255,496396,213499,1027150
2023-04-24 11:43,1027170,317274,496396,213500,1027170
2023-04-24 11:44,1027192,317295,496397,213500,1027192
2023-04-24 11:45,1027215,317316,496397,213502,1027215
2023-04-24 11:46,1027237,317334,496399,213504,1027237
2023-04-24 11:47,1027258,317351,496399,213508,1027258
2023-04-24 11:48,1027282,317370,496402,213510,1027282
2023-04-24 11:49,1027303,317388,496402,213513,1027303
2023-04-24 11:50,1027325,317406,496402,213517,1027325
2023-04-24 11:51,1027349,317427,496402,213520,1027349
2023-04-24 11:52,1027372,317444,496405,213523,1027372
2023-04-24 11:53,1027393,317459,496405,213529,1027393
2023-04-24 11:54,1027415,317475,496408,213532,1027415
2023-04-24 11:55,1027438,317495,496408,213535,1027438
2023-04-24 11:56,1027459,317507,496413,213539,1027459
2023-04-24 11:57,1027480,317528,496413,213539,1027480
2023-04-24 11:58,1027503,317549,496415,213539,1027503
2023-04-24 11:59,1027525,317570,496415,213540,1027525
2023-04-24 12:00,1027548,317588,496420,213540,1027548
2023-04-24 12:01,1027572,317608,496420,213544,1027572
2023-04-24 12:02,1027593,317625,496421,213547,1027593
2023-04-24 12:03,1027617,317648,496421,213548,1027617
2023-04-24 12:04,1027640,317669,496421,213550,1027640
2023-04-24 12:05,1027663,317692,496421,213550,1027663
2023-04-24 12:06,1027685,317710,496425,213550,1027685
2023-04-24 12:07,1027709,317732,496425,213552,1027709
2023-04-24 12:08,1027732,317748,496428,213556,1027732
2023-04-24 12:09,1027756,317769,496428,213559,1027756
2023-04-24 12:10,1027778,317790,496429,213559,1027778
2023-04-24 12:11,1027801,317809,496431,213561,1027801
2023-04-24 12:12,1027824,317825,496435,213564,1027824
2023-04-24 12:13,1027848,317847,496435,213566,1027848
2023-04-24 12:14,1027871,317866,496437,213568,1027871
2023-04-24 12:15,1027895,317886,496437,213572,1027895
2023-04-24 12:16,1027918,317903,496441,213574,1027918
2023-04-24 12:17,1027942,317927,496441,213574,1027942
2023-04-24 12:18,1027965,317943,496446,213576,1027965
2023-04-24 12:19,1027989,317967,496446,213576,1027989
2023-04-24 12:20,1028010,317982,496450,213578,1028010
2023-04-24 12:21,1028036,318005,496450,213581,1028036
2023-04-24 12:22,1028059,318025,496451,213583,1028059
2023-04-24 12:23,1028081,318043,496451,213587,1028081
2023-04-24 12:24,1028104,318056,496457,213591,1028104
2023-04-24 12:25,1028126,318077,496457,213592,1028126
2023-04-24 12:27,1028151,318097,496458,213596,1028151
2023-04-24 12:28,1028173,318114,496458,213601,1028173
2023-04-24 12:29,1028197,318135,496460,213602,1028197
2023-04-24 12:30,1028219,318154,496460,213605,1028219
2023-04-24 12:31,1028243,318167,496467,213609,1028243
2023-04-24 12:32,1028265,318186,496467,213612,1028265
2023-04-24 12:33,1028288,318204,496470,213614,1028288
2023-04-24 12:34,1028310,318226,496470,213614,1028310
2023-04-24 12:35,1028334,318242,496474,213618,1028334
2023-04-24 12:36,1028354,318256,496474,213624,1028354
2023-04-24 12:37,1028379,318271,496481,213627,1028379
2023-04-24 12:38,1028402,318292,496481,213629,1028402
2023-04-24 12:39,1028424,318305,496487,213632,1028424
2023-04-24 12:40,1028448,318327,496487,213634,1028448
2023-04-24 12:41,1028472,318347,496489,213636,1028472
2023-04-24 12:42,1028495,318367,496489,213639,1028495
2023-04-24 12:43,1028519,318388,496491,213640,1028519
2023-04-24 12:44,1028542,318409,496491,213642,1028542
2023-04-24 12:45,1028566,318426,496492,213648,1028566
2023-04-24 12:46,1028590,318446,496492,213652,1028590
2023-04-24 12:47,1028614,318461,496497,213656,1028614
2023-04-24 12:48,1028638,318484,496497,213657,1028638
2023-04-24 12:49,1028659,318497,496501,213661,1028659
2023-04-24 12:50,1028683,318520,496501,213662,1028683
2023-04-24 12:51,1028705,318536,496503,213666,1028705
2023-04-24 12:52,1028727,318557,496503,213667,1028727
2023-04-24 12:53,1028751,318577,496504,213670,1028751
2023-04-24 12:54,1028771,318594,496504,213673,1028771
2023-04-24 12:55,1028796,318617,496505,213674,1028796
2023-04-24 12:56,1028820,318639,496505,213676,1028820
2023-04-24 12:57,1028842,318656,496509,213677,1028842
2023-04-24 12:58,1028865,318675,496509,213681,1028865
2023-04-24 12:59,1028887,318692,496513,213682,1028887
2023-04-24 13:00,1028901,318704,496513,213684,1028901
2023-04-24 13:01,1028910,318706,496515,213689,1028910
2023-04-24 13:02,1028918,318712,496515,213691,1028918
2023-04-24 13:03,1028928,318719,496517,213692,1028928
2023-04-24 13:05,1028936,318724,496517,213695,1028936
2023-04-24 13:06,1028951,318736,496518,213697,1028951
2023-04-24 13:07,1028959,318743,496518,213698,1028959
2023-04-24 13:08,1028967,318748,496519,213700,1028967
2023-04-24 13:09,1028976,318754,496519,213703,1028976
2023-04-24 13:10,1028983,318755,496524,213704,1028983
2023-04-24 13:11,1028992,318762,496524,213706,1028992
2023-04-24 13:12,1029001,318767,496526,213708,1029001
2023-04-24 13:13,1029010,318773,496526,213711,1029010
2023-04-24 13:14,1029021,318775,496530,213716,1029021
2023-04-24 13:15,1029029,318782,496530,213717,1029029
2023-04-24 13:16,1029038,318786,496536,213716,1029038
2023-04-24 13:17,1029047,318794,496536,213717,1029047
2023-04-24 13:18,1029055,318797,496539,213719,1029055
2023-04-24 13:19,1029063,318801,496539,213723,1029063
2023-04-24 13:20,1029072,318806,496542,213724,1029072
2023-04-24 13:21,1029082,318811,496542,213729,1029082
2023-04-24 13:22,1029091,318816,496542,213733,1029091
2023-04-24 13:25,1029099,318816,496542,213741,1029099
2023-04-24 13:26,1029118,318832,496542,213744,1029118
2023-04-24 13:27,1029126,318838,496543,213745,1029126
2023-04-24 13:28,1029136,318841,496543,213752,1029136
2023-04-24 13:29,1029145,318845,496547,213753,1029145
2023-04-24 13:30,1029155,318854,496547,213754,1029155
2023-04-24 13:31,1029164,318857,496551,213756,1029164
2023-04-24 13:32,1029174,318866,496551,213757,1029174
2023-04-24 13:33,1029182,318872,496550,213760,1029182
2023-04-24 13:34,1029190,318877,496550,213763,1029190
2023-04-24 13:35,1029199,318881,496553,213765,1029199
2023-04-24 13:36,1029207,318889,496553,213765,1029207
2023-04-24 13:37,1029216,318894,496554,213768,1029216
2023-04-24 13:38,1029224,318902,496554,213768,1029224
2023-04-24 13:39,1029233,318905,496555,213773,1029233
2023-04-24 13:40,1029240,318911,496555,213774,1029240
2023-04-24 13:41,1029251,318918,496557,213776,1029251
2023-04-24 13:42,1029259,318925,496557,213777,1029259
2023-04-24 13:43,1029267,318927,496558,213782,1029267
2023-04-24 13:44,1029275,318936,496558,213781,1029275
2023-04-24 13:45,1029283,318937,496561,213785,1029283
2023-04-24 13:46,1029291,318943,496561,213787,1029291
2023-04-24 13:47,1029299,318946,496564,213789,1029299
2023-04-24 13:48,1029307,318950,496564,213793,1029307
2023-04-24 13:49,1029315,318954,496567,213794,1029315
2023-04-24 13:50,1029323,318958,496567,213798,1029323
2023-04-24 13:51,1029331,318963,496569,213799,1029331
2023-04-24 13:52,1029339,318967,496569,213803,1029339
2023-04-24 13:53,1029349,318978,496569,213802,1029349
2023-04-24 13:54,1029358,318986,496569,213803,1029358
2023-04-24 13:55,1029368,318991,496572,213805,1029368
2023-04-24 13:56,1029376,318996,496572,213808,1029376
2023-04-24 13:58,1029384,319000,496574,213810,1029384
2023-04-24 13:59,1029394,319010,496574,213810,1029394
2023-04-24 14:00,1029403,319013,496578,213812,1029403
2023-04-24 14:01,1029422,319032,496578,213812,1029422
2023-04-24 14:02,1029440,319045,496578,213817,1029440
2023-04-24 14:03,1029458,319061,496578,213819,1029458
2023-04-24 14:04,1029475,319071,496583,213821,1029475
2023-04-24 14:05,1029493,319088,496584,213821,1029493
2023-04-24 14:06,1029511,319105,496584,213822,1029511
2023-04-24 14:07,1029532,319124,496584,213824,1029532
2023-04-24 14:08,1029551,319144,496584,213823,1029551
2023-04-24 14:09,1029570,319162,496583,213825,1029570
2023-04-24 14:10,1029588,319174,496583,213831,1029588
2023-04-24 14:11,1029606,319186,496584,213836,1029606
2023-04-24 14:12,1029624,319202,496584,213838,1029624
2023-04-24 14:13,1029641,319216,496586,213839,1029641
2023-04-24 14:14,1029660,319227,496588,213845,1029660
2023-04-24 14:15,1029680,319247,496588,213845,1029680
2023-04-24 14:16,1029698,319262,496591,213845,1029698
2023-04-24 14:17,1029716,319279,496591,213846,1029716
2023-04-24 14:18,1029736,319294,496593,213849,1029736
2023-04-24 14:19,1029755,319310,496593,213852,1029755
2023-04-24 14:20,1029774,319324,496593,213857,1029774
2023-04-24 14:21,1029790,319337,496593,213860,1029790
2023-04-24 14:22,1029810,319355,496594,213861,1029810
2023-04-24 14:23,1029828,319370,496594,213864,1029828
2023-04-24 14:24,1029846,319382,496598,213866,1029846
2023-04-24 14:25,1029865,319400,496598,213867,1029865
2023-04-24 14:26,1029883,319410,496602,213871,1029883
2023-04-24 14:27,1029902,319426,496602,213874,1029902
2023-04-24 14:28,1029918,319438,496605,213875,1029918
2023-04-24 14:29,1029936,319452,496605,213879,1029936
2023-04-24 14:30,1029954,319467,496605,213882,1029954
2023-04-24 14:31,1029972,319483,496605,213884,1029972
2023-04-24 14:32,1029989,319497,496606,213886,1029989
2023-04-24 14:33,1030006,319511,496606,213889,1030006
2023-04-24 14:34,1030025,319526,496608,213891,1030025
2023-04-24 14:35,1030045,319541,496608,213896,1030045
2023-04-24 14:36,1030062,319555,496610,213897,1030062
2023-04-24 14:37,1030081,319572,496610,213899,1030081
2023-04-24 14:38,1030099,319588,496611,213900,1030099
2023-04-24 14:39,1030116,319604,496611,213901,1030116
2023-04-24 14:40,1030134,319619,496613,213902,1030134
2023-04-24 14:41,1030152,319637,496613,213902,1030152
2023-04-24 14:42,1030171,319652,496615,213904,1030171
2023-04-24 14:43,1030190,319670,496615,213905,1030190
2023-04-24 14:45,1030207,319682,496619,213906,1030207
2023-04-24 14:46,1030225,319695,496621,213909,1030225
2023-04-24 14:47,1030243,319709,496621,213913,1030243
2023-04-24 14:48,1030260,319722,496624,213914,1030260
2023-04-24 14:49,1030279,319737,496624,213918,1030279
2023-04-24 14:50,1030296,319749,496627,213920,1030296
2023-04-24 14:51,1030316,319768,496628,213920,1030316
2023-04-24 14:52,1030334,319783,496628,213923,1030334
2023-04-24 14:53,1030352,319798,496629,213925,1030352
2023-04-24 14:54,1030370,319816,496629,213925,1030370
2023-04-24 14:55,1030388,319829,496633,213926,1030388
2023-04-24 14:56,1030406,319847,496633,213926,1030406
2023-04-24 14:57,1030424,319857,496638,213929,1030424
2023-04-24 14:58,1030443,319873,496638,213932,1030443
2023-04-24 14:59,1030459,319886,496639,213934,1030459
2023-04-24 15:00,1030476,319901,496639,213936,1030476
2023-04-24 15:01,1030487,319910,496639,213938,1030487
2023-04-24 15:02,1030496,319918,496639,213939,1030496
2023-04-24 15:03,1030507,319925,496642,213940,1030507
2023-04-24 15:04,1030517,319933,496642,213942,1030517
2023-04-24 15:05,1030527,319940,496644,213943,1030527
2023-04-24 15:06,1030536,319947,496644,213945,1030536
2023-04-24 15:07,1030547,319954,496646,213947,1030547
2023-04-24 15:08,1030557,319964,496646,213947,1030557
2023-04-24 15:09,1030567,319971,496646,213950,1030567
2023-04-24 15:10,1030576,319977,496646,213953,1030576
2023-04-24 15:11,1030586,319982,496648,213956,1030586
2023-04-24 15:12,1030595,319987,496648,213960,1030595
2023-04-24 15:13,1030605,319993,496651,213961,1030605
2023-04-24 15:14,1030614,320001,496651,213962,1030614
2023-04-24 15:15,1030623,320008,496652,213963,1030623
2023-04-24 15:16,1030634,320016,496654,213964,1030634
2023-04-24 15:17,1030644,320025,496654,213965,1030644
2023-04-24 15:18,1030654,320031,496658,213965,1030654
2023-04-24 15:19,1030663,320038,496658,213967,1030663
2023-04-24 15:20,1030674,320046,496659,213969,1030674
2023-04-24 15:21,1030683,320054,496659,213970,1030683
2023-04-24 15:22,1030692,320056,496664,213972,1030692
2023-04-24 15:23,1030703,320065,496664,213974,1030703
2023-04-24 15:24,1030712,320070,496665,213977,1030712
2023-04-24 15:25,1030722,320079,496665,213978,1030722
2023-04-24 15:26,1030732,320086,496667,213979,1030732
2023-04-24 15:27,1030742,320095,496667,213980,1030742
2023-04-24 15:28,1030751,320101,496670,213980,1030751
2023-04-24 15:29,1030761,320109,496670,213982,1030761
2023-04-24 15:30,1030770,320118,496670,213982,1030770
2023-04-24 15:31,1030779,320126,496670,213983,1030779
2023-04-24 15:33,1030789,320131,496671,213987,1030789
2023-04-24 15:34,1030800,320138,496671,213991,1030800
2023-04-24 15:35,1030811,320145,496672,213994,1030811
2023-04-24 15:36,1030820,320154,496672,213994,1030820
2023-04-24 15:37,1030830,320159,496674,213997,1030830
2023-04-24 15:38,1030841,320171,496674,213996,1030841
2023-04-24 15:39,1030852,320174,496677,214001,1030852
2023-04-24 15:40,1030863,320178,496678,214007,1030863
2023-04-24 15:41,1030873,320186,496678,214009,1030873
2023-04-24 15:42,1030883,320194,496678,214011,1030883
2023-04-24 15:43,1030892,320202,496678,214012,1030892
2023-04-24 15:44,1030901,320208,496678,214015,1030901
2023-04-24 15:45,1030911,320217,496678,214016,1030911
2023-04-24 15:46,1030921,320226,496678,214017,1030921
2023-04-24 15:47,1030932,320225,496688,214019,1030932
2023-04-24 15:48,1030942,320232,496688,214022,1030942
2023-04-24 15:49,1030952,320238,496690,214024,1030952
2023-04-24 15:50,1030961,320246,496690,214025,1030961
2023-04-24 15:51,1030970,320254,496692,214024,1030970
2023-04-24 15:52,1030979,320261,496692,214026,1030979
2023-04-24 15:53,1030988,320270,496691,214027,1030988
2023-04-24 15:54,1030997,320279,496691,214027,1030997
2023-04-24 15:55,1031006,320285,496693,214028,1031006
2023-04-24 15:56,1031015,320291,496694,214030,1031015
2023-04-24 15:57,1031024,320299,496694,214031,1031024
2023-04-24 15:58,1031033,320306,496695,214032,1031033
2023-04-24 15:59,1031043,320315,496695,214033,1031043
2023-04-24 16:00,1031054,320319,496698,214037,1031054
2023-04-24 16:01,1031066,320329,496699,214038,1031066
2023-04-24 16:02,1031079,320336,496701,214042,1031079
2023-04-24 16:03,1031093,320349,496701,214043,1031093
2023-04-24 16:04,1031106,320361,496702,214043,1031106
2023-04-24 16:05,1031117,320371,496702,214044,1031117
2023-04-24 16:06,1031129,320376,496705,214048,1031129
2023-04-24 16:07,1031143,320389,496705,214049,1031143
2023-04-24 16:08,1031154,320397,496706,214051,1031154
2023-04-24 16:09,1031168,320408,496708,214052,1031168
2023-04-24 16:10,1031179,320417,496708,214054,1031179
2023-04-24 16:11,1031193,320429,496708,214056,1031193
2023-04-24 16:12,1031205,320438,496708,214059,1031205
2023-04-24 16:13,1031217,320450,496708,214059,1031217
2023-04-24 16:14,1031232,320464,496708,214060,1031232
2023-04-24 16:15,1031246,320467,496716,214063,1031246
2023-04-24 16:16,1031259,320478,496716,214065,1031259
2023-04-24 16:17,1031272,320488,496718,214066,1031272
2023-04-24 16:18,1031285,320500,496718,214067,1031285
2023-04-24 16:19,1031296,320506,496719,214071,1031296
2023-04-24 16:21,1031309,320516,496720,214073,1031309
2023-04-24 16:22,1031320,320523,496720,214077,1031320
2023-04-24 16:23,1031332,320533,496722,214077,1031332
2023-04-24 16:24,1031344,320543,496722,214079,1031344
2023-04-24 16:25,1031357,320554,496722,214081,1031357
2023-04-24 16:26,1031368,320563,496722,214083,1031368
2023-04-24 16:27,1031381,320570,496725,214086,1031381
2023-04-24 16:28,1031394,320579,496725,214090,1031394
2023-04-24 16:29,1031407,320585,496728,214094,1031407
2023-04-24 16:30,1031419,320594,496728,214097,1031419
2023-04-24 16:31,1031430,320599,496731,214100,1031430
2023-04-24 16:32,1031443,320608,496735,214100,1031443
2023-04-24 16:33,1031454,320619,496735,214100,1031454
2023-04-24 16:34,1031467,320630,496735,214102,1031467
2023-04-24 16:35,1031479,320640,496735,214104,1031479
2023-04-24 16:36,1031491,320650,496736,214105,1031491
2023-04-24 16:37,1031504,320661,496736,214107,1031504
2023-04-24 16:38,1031515,320671,496737,214107,1031515
2023-04-24 16:39,1031529,320683,496737,214109,1031529
2023-04-24 16:40,1031542,320689,496743,214110,1031542
2023-04-24 16:41,1031554,320700,496743,214111,1031554
2023-04-24 16:42,1031566,320709,496743,214114,1031566
2023-04-24 16:43,1031579,320722,496743,214114,1031579
2023-04-24 16:44,1031590,320723,496748,214119,1031590
2023-04-24 16:45,1031602,320731,496748,214123,1031602
2023-04-24 16:46,1031614,320740,496750,214124,1031614
2023-04-24 16:47,1031625,320750,496750,214125,1031625
2023-04-24 16:48,1031637,320758,496750,214129,1031637
2023-04-24 16:49,1031649,320766,496752,214131,1031649
2023-04-24 16:50,1031661,320776,496752,214133,1031661
2023-04-24 16:51,1031673,320785,496754,214134,1031673
2023-04-24 16:52,1031685,320793,496754,214138,1031685
2023-04-24 16:53,1031696,320804,496754,214138,1031696
2023-04-24 16:54,1031709,320812,496754,214143,1031709
2023-04-24 16:55,1031724,320823,496756,214145,1031724
2023-04-24 16:56,1031736,320834,496756,214146,1031736
2023-04-24 16:57,1031749,320840,496759,214150,1031749
2023-04-24 16:58,1031761,320851,496759,214151,1031761
2023-04-24 16:59,1031773,320856,496762,214155,1031773
2023-04-24 17:00,1031779,320860,496762,214157,1031779
2023-04-24 17:01,1031785,320861,496767,214157,1031785
2023-04-24 17:02,1031790,320863,496767,214160,1031790
2023-04-24 17:03,1031794,320864,496768,214162,1031794
2023-04-24 17:04,1031799,320869,496768,214162,1031799
2023-04-24 17:05,1031805,320871,496770,214164,1031805
2023-04-24 17:06,1031811,320873,496770,214168,1031811
2023-04-24 17:07,1031816,320877,496771,214168,1031816
2023-04-24 17:09,1031822,320882,496771,214169,1031822
2023-04-24 17:10,1031827,320882,496773,214172,1031827
2023-04-24 17:11,1031833,320887,496773,214173,1031833
2023-04-24 17:12,1031839,320892,496773,214174,1031839
2023-04-24 17:13,1031844,320897,496773,214174,1031844
2023-04-24 17:14,1031849,320896,496778,214175,1031849
2023-04-24 17:15,1031855,320901,496778,214176,1031855
2023-04-24 17:16,1031862,320903,496780,214179,1031862
2023-04-24 17:17,1031868,320906,496780,214182,1031868
2023-04-24 17:18,1031874,320906,496782,214186,1031874
2023-04-24 17:19,1031879,320907,496782,214190,1031879
2023-04-24 17:20,1031885,320909,496784,214192,1031885
2023-04-24 17:21,1031890,320910,496784,214196,1031890
2023-04-24 17:22,1031895,320910,496786,214199,1031895
2023-04-24 17:23,1031901,320914,496786,214201,1031901
2023-04-24 17:24,1031908,320916,496789,214203,1031908
2023-04-24 17:25,1031915,320921,496789,214205,1031915
2023-04-24 17:26,1031919,320922,496792,214205,1031919
2023-04-24 17:27,1031925,320927,496792,214206,1031925
2023-04-24 17:28,1031931,320930,496792,214209,1031931
2023-04-24 17:29,1031935,320933,496792,214210,1031935
2023-04-24 17:30,1031941,320933,496795,214213,1031941
2023-04-24 17:31,1031946,320935,496795,214216,1031946
2023-04-24 17:32,1031952,320935,496800,214217,1031952
2023-04-24 17:33,1031957,320940,496800,214217,1031957
2023-04-24 17:34,1031961,320940,496802,214219,1031961
2023-04-24 17:35,1031967,320945,496802,214220,1031967
2023-04-24 17:36,1031972,320943,496807,214222,1031972
2023-04-24 17:37,1031977,320945,496807,214225,1031977
2023-04-24 17:38,1031982,320947,496808,214227,1031982
2023-04-24 17:39,1031987,320952,496808,214227,1031987
2023-04-24 17:40,1031992,320953,496811,214228,1031992
2023-04-24 17:41,1031997,320958,496811,214228,1031997
2023-04-24 17:42,1032002,320960,496814,214228,1032002
2023-04-24 17:43,1032006,320961,496814,214231,1032006
2023-04-24 17:44,1032012,320966,496814,214232,1032012
2023-04-24 17:45,1032019,320970,496814,214235,1032019
2023-04-24 17:46,1032025,320978,496814,214233,1032025
2023-04-24 17:47,1032030,320980,496814,214236,1032030
2023-04-24 17:48,1032036,320982,496816,214238,1032036
2023-04-24 17:49,1032041,320985,496816,214240,1032041
2023-04-24 17:50,1032046,320987,496817,214242,1032046
2023-04-24 17:51,1032050,320989,496817,214244,1032050
2023-04-24 17:52,1032057,320989,496821,214247,1032057
2023-04-24 17:53,1032063,320990,496821,214252,1032063
2023-04-24 17:54,1032068,320990,496824,214254,1032068
2023-04-24 17:56,1032074,320996,496824,214254,1032074
2023-04-24 17:57,1032079,321001,496823,214255,1032079
2023-04-24 17:58,1032084,321005,496823,214256,1032084
2023-04-24 17:59,1032090,321006,496827,214257,1032090
2023-04-24 18:00,1032095,321011,496827,214257,1032095
2023-04-24 18:01,1032118,321028,496830,214260,1032118
2023-04-24 18:02,1032140,321050,496830,214260,1032140
2023-04-24 18:03,1032165,321066,496834,214265,1032165
2023-04-24 18:04,1032188,321087,496834,214267,1032188
2023-04-24 18:05,1032212,321105,496837,214270,1032212
2023-04-24 18:06,1032236,321125,496837,214274,1032236
2023-04-24 18:07,1032258,321146,496837,214275,1032258
2023-04-24 18:08,1032284,321168,496841,214275,1032284
2023-04-24 18:09,1032304,321185,496841,214278,1032304
2023-04-24 18:10,1032330,321208,496842,214280,1032330
2023-04-24 18:11,1032354,321229,496842,214283,1032354
2023-04-24 18:12,1032376,321249,496843,214284,1032376
2023-04-24 18:13,1032398,321271,496843,214284,1032398
2023-04-24 18:14,1032420,321289,496844,214287,1032420
2023-04-24 18:15,1032443,321307,496844,214292,1032443
2023-04-24 18:16,1032466,321326,496846,214294,1032466
2023-04-24 18:17,1032488,321345,496846,214297,1032488
2023-04-24 18:18,1032513,321363,496847,214303,1032513
2023-04-24 18:19,1032534,321382,496847,214305,1032534
2023-04-24 18:20,1032558,321400,496849,214309,1032558
2023-04-24 18:21,1032581,321423,496849,214309,1032581
2023-04-24 18:22,1032606,321443,496852,214311,1032606
2023-04-24 18:23,1032628,321458,496857,214313,1032628
2023-04-24 18:24,1032652,321480,496857,214315,1032652
2023-04-24 18:25,1032676,321501,496858,214317,1032676
2023-04-24 18:26,1032697,321518,496858,214321,1032697
2023-04-24 18:27,1032720,321539,496859,214322,1032720
2023-04-24 18:28,1032745,321564,496859,214322,1032745
2023-04-24 18:29,1032769,321583,496863,214323,1032769
2023-04-24 18:30,1032791,321601,496863,214327,1032791
2023-04-24 18:31,1032814,321622,496863,214329,1032814
2023-04-24 18:32,1032838,321641,496863,214334,1032838
2023-04-24 18:33,1032860,321662,496863,214335,1032860
2023-04-24 18:34,1032883,321684,496863,214336,1032883
2023-04-24 18:35,1032908,321705,496863,214340,1032908
2023-04-24 18:36,1032931,321729,496863,214339,1032931
2023-04-24 18:37,1032956,321750,496863,214343,1032956
2023-04-24 18:38,1032982,321776,496863,214343,1032982
2023-04-24 18:39,1033004,321782,496878,214344,1033004
2023-04-24 18:40,1033025,321801,496878,214346,1033025
2023-04-24 18:41,1033049,321824,496878,214347,1033049
2023-04-24 18:42,1033072,321844,496878,214350,1033072
2023-04-24 18:44,1033094,321866,496878,214350,1033094
2023-04-24 18:45,1033119,321888,496878,214353,1033119
2023-04-24 18:46,1033142,321902,496887,214353,1033142
2023-04-24 18:47,1033165,321921,496888,214356,1033165
2023-04-24 18:48,1033187,321938,496888,214361,1033187
2023-04-24 18:49,1033210,321954,496892,214364,1033210
2023-04-24 18:50,1033234,321976,496892,214366,1033234
2023-04-24 18:51,1033256,321998,496892,214366,1033256
2023-04-24 18:52,1033278,322018,496892,214368,1033278
2023-04-24 18:53,1033301,322032,496897,214372,1033301
2023-04-24 18:54,1033324,322055,496897,214372,1033324
2023-04-24 18:55,1033347,322076,496896,214375,1033347
2023-04-24 18:56,1033370,322098,496896,214376,1033370
2023-04-24 18:57,1033392,322120,496897,214375,1033392
2023-04-24 18:58,1033415,322140,496897,214378,1033415
2023-04-24 18:59,1033438,322159,496898,214381,1033438
2023-04-24 19:00,1033458,322177,496898,214383,1033458
2023-04-24 19:01,1033472,322182,496901,214389,1033472
2023-04-24 19:02,1033487,322196,496901,214390,1033487
2023-04-24 19:03,1033500,322207,496903,214390,1033500
2023-04-24 19:04,1033514,322217,496903,214394,1033514
2023-04-24 19:05,1033527,322227,496904,214396,1033527
2023-04-24 19:06,1033542,322241,496904,214397,1033542
2023-04-24 19:07,1033556,322252,496903,214401,1033556
2023-04-24 19:08,1033569,322264,496903,214402,1033569
2023-04-24 19:09,1033583,322271,496906,214406,1033583
2023-04-24 19:10,1033598,322285,496906,214407,1033598
2023-04-24 19:11,1033611,322295,496908,214408,1033611
2023-04-24 19:12,1033625,322305,496908,214412,1033625
2023-04-24 19:13,1033638,322313,496909,214416,1033638
2023-04-24 19:14,1033653,322326,496909,214418,1033653
2023-04-24 19:15,1033666,322337,496911,214418,1033666
2023-04-24 19:16,1033681,322350,496911,214420,1033681
2023-04-24 19:17,1033694,322358,496914,214422,1033694
2023-04-24 19:18,1033710,322373,496914,214423,1033710
2023-04-24 19:19,1033724,322382,496915,214427,1033724
2023-04-24 19:20,1033737,322390,496915,214432,1033737
2023-04-24 19:21,1033753,322400,496920,214433,1033753
2023-04-24 19:22,1033768,322412,496920,214436,1033768
2023-04-24 19:23,1033783,322428,496917,214438,1033783
2023-04-24 19:24,1033795,322437,496917,214441,1033795
2023-04-24 19:25,1033809,322448,496918,214443,1033809
2023-04-24 19:26,1033823,322461,496918,214444,1033823
2023-04-24 19:27,1033836,322471,496920,214445,1033836
2023-04-24 19:28,1033850,322483,496920,214447,1033850
2023-04-24 19:29,1033863,322488,496924,214451,1033863
2023-04-24 19:31,1033876,322500,496924,214452,1033876
2023-04-24 19:32,1033892,322509,496928,214455,1033892
2023-04-24 19:33,1033905,322519,496929,214457,1033905
2023-04-24 19:34,1033920,322531,496929,214460,1033920
2023-04-24 19:35,1033934,322537,496933,214464,1033934
2023-04-24 19:36,1033949,322550,496933,214466,1033949
2023-04-24 19:37,1033962,322559,496934,214469,1033962
2023-04-24 19:38,1033975,322570,496934,214471,1033975
2023-04-24 19:39,1033989,322580,496936,214473,1033989
2023-04-24 19:40,1034003,322593,496936,214474,1034003
2023-04-24 19:41,1034017,322601,496941,214475,1034017
2023-04-24 19:42,1034031,322608,496941,214482,1034031
2023-04-24 19:43,1034044,322620,496942,214482,1034044
2023-04-24 19:44,1034057,322630,496942,214485,1034057
2023-04-24 19:45,1034072,322640,496944,214488,1034072
2023-04-24 19:46,1034086,322650,496944,214492,1034086
2023-04-24 19:47,1034098,322658,496945,214495,1034098
2023-04-24 19:48,1034112,322671,496945,214496,1034112
2023-04-24 19:49,1034126,322683,496947,214496,1034126
2023-04-24 19:50,1034140,322696,496947,214497,1034140
2023-04-24 19:51,1034155,322708,496949,214498,1034155
2023-04-24 19:52,1034168,322719,496949,214500,1034168
2023-04-24 19:53,1034182,322727,496954,214501,1034182
2023-04-24 19:54,1034196,322735,496954,214507,1034196
2023-04-24 19:55,1034209,322748,496953,214508,1034209
2023-04-24 19:56,1034223,322758,496956,214509,1034223
2023-04-24 19:57,1034237,322770,496956,214511,1034237
2023-04-24 19:58,1034252,322782,496959,214511,1034252
2023-04-24 19:59,1034265,322792,496959,214514,1034265
2023-04-24 20:00,1034283,322809,496960,214514,1034283
2023-04-24 20:01,1034303,322826,496960,214517,1034303
2023-04-24 20:02,1034322,322842,496961,214519,1034322
2023-04-24 20:03,1034342,322859,496961,214522,1034342
2023-04-24 20:04,1034362,322880,496961,214521,1034362
2023-04-24 20:05,1034382,322898,496961,214523,1034382
2023-04-24 20:06,1034405,322919,496961,214525,1034405
2023-04-24 20:07,1034424,322935,496961,214528,1034424
2023-04-24 20:08,1034446,322955,496961,214530,1034446
2023-04-24 20:09,1034464,322966,496964,214534,1034464
2023-04-24 20:10,1034485,322987,496964,214534,1034485
2023-04-24 20:11,1034505,322999,496970,214536,1034505
2023-04-24 20:12,1034526,323019,496970,214537,1034526
2023-04-24 20:13,1034546,323035,496972,214539,1034546
2023-04-24 20:14,1034565,323053,496972,214540,1034565
2023-04-24 20:15,1034586,323068,496975,214543,1034586
2023-04-24 20:16,1034605,323087,496975,214543,1034605
2023-04-24 20:17,1034625,323106,496975,214544,1034625
2023-04-24 20:19,1034644,323122,496976,214546,1034644
2023-04-24 20:20,1034665,323138,496976,214551,1034665
2023-04-24 20:21,1034686,323157,496978,214551,1034686
2023-04-24 20:22,1034706,323174,496978,214554,1034706
2023-04-24 20:23,1034727,323189,496980,214558,1034727
2023-04-24 20:24,1034746,323205,496980,214561,1034746
2023-04-24 20:25,1034766,323221,496983,214562,1034766
2023-04-24 20:26,1034786,323235,496988,214563,1034786
2023-04-24 20:27,1034806,323255,496988,214563,1034806
2023-04-24 20:28,1034826,323269,496992,214565,1034826
2023-04-24 20:29,1034846,323289,496992,214565,1034846
2023-04-24 20:30,1034865,323307,496993,214565,1034865
2023-04-24 20:31,1034884,323324,496993,214567,1034884
2023-04-24 20:32,1034905,323339,496996,214570,1034905
2023-04-24 20:33,1034924,323355,496996,214573,1034924
2023-04-24 20:34,1034944,323370,497000,214574,1034944
2023-04-24 20:35,1034964,323386,497000,214578,1034964
2023-04-24 20:36,1034984,323403,497001,214580,1034984
2023-04-24 20:37,1035003,323418,497001,214584,1035003
2023-04-24 20:38,1035024,323434,497004,214586,1035024
2023-04-24 20:39,1035044,323452,497004,214588,1035044
2023-04-24 20:40,1035064,323469,497006,214589,1035064
2023-04-24 20:41,1035084,323488,497006,214590,1035084
2023-04-24 20:42,1035105,323505,497009,214591,1035105
2023-04-24 20:43,1035125,323522,497009,214594,1035125
2023-04-24 20:44,1035145,323540,497009,214596,1035145
2023-04-24 20:45,1035166,323553,497014,214599,1035166
2023-04-24 20:46,1035186,323569,497016,214601,1035186
2023-04-24 20:47,1035207,323588,497016,214603,1035207
2023-04-24 20:48,1035226,323602,497020,214604,1035226
2023-04-24 20:49,1035246,323619,497020,214607,1035246
2023-04-24 20:50,1035266,323632,497025,214609,1035266
2023-04-24 20:51,1035285,323651,497025,214609,1035285
2023-04-24 20:52,1035305,323663,497030,214612,1035305
2023-04-24 20:53,1035326,323683,497030,214613,1035326
2023-04-24 20:54,1035345,323692,497034,214619,1035345
2023-04-24 20:55,1035365,323705,497038,214622,1035365
2023-04-24 20:56,1035384,323724,497038,214622,1035384
2023-04-24 20:57,1035404,323741,497040,214623,1035404
2023-04-24 20:58,1035425,323761,497040,214624,1035425
2023-04-24 20:59,1035446,323781,497040,214625,1035446
2023-04-24 21:00,1035459,323791,497040,214628,1035459
2023-04-24 21:01,1035468,323796,497043,214629,1035468
2023-04-24 21:02,1035479,323796,497043,214640,1035479
2023-04-24 21:03,1035490,323800,497047,214643,1035490
2023-04-24 21:04,1035501,323808,497048,214645,1035501
2023-04-24 21:05,1035515,323821,497048,214646,1035515
2023-04-24 21:07,1035525,323828,497051,214646,1035525
2023-04-24 21:08,1035536,323838,497051,214647,1035536
2023-04-24 21:09,1035545,323844,497054,214647,1035545
2023-04-24 21:10,1035556,323853,497054,214649,1035556
2023-04-24 21:11,1035566,323859,497058,214649,1035566
2023-04-24 21:12,1035577,323866,497061,214650,1035577
2023-04-24 21:13,1035589,323875,497061,214653,1035589
2023-04-24 21:14,1035599,323878,497065,214656,1035599
2023-04-24 21:15,1035609,323886,497065,214658,1035609
2023-04-24 21:16,1035620,323894,497067,214659,1035620
2023-04-24 21:17,1035631,323901,497067,214663,1035631
2023-04-24 21:18,1035641,323908,497069,214664,1035641
2023-04-24 21:19,1035651,323917,497069,214665,1035651
2023-04-24 21:20,1035660,323920,497072,214668,1035660
2023-04-24 21:21,1035672,323931,497072,214669,1035672
2023-04-24 21:22,1035681,323932,497074,214675,1035681
2023-04-24 21:23,1035691,323934,497081,214676,1035691
2023-04-24 21:24,1035703,323944,497081,214678,1035703
2023-04-24 21:25,1035714,323949,497084,214681,1035714
2023-04-24 21:26,1035724,323957,497084,214683,1035724
2023-04-24 21:27,1035734,323964,497086,214684,1035734
2023-04-24 21:28,1035744,323972,497086,214686,1035744
2023-04-24 21:29,1035754,323977,497089,214688,1035754
2023-04-24 21:30,1035764,323986,497089,214689,1035764
2023-04-24 21:31,1035773,323985,497095,214693,1035773
2023-04-24 21:32,1035784,323993,497095,214696,1035784
2023-04-24 21:33,1035794,323997,497099,214698,1035794
2023-04-24 21:34,1035804,324006,497099,214699,1035804
2023-04-24 21:35,1035813,324011,497101,214701,1035813
2023-04-24 21:36,1035824,324021,497101,214702,1035824
2023-04-24 21:37,1035834,324026,497106,214702,1035834
2023-04-24 21:38,1035843,324034,497106,214703,1035843
2023-04-24 21:39,1035854,324033,497114,214707,1035854
2023-04-24 21:40,1035864,324042,497114,214708,1035864
2023-04-24 21:41,1035876,324047,497120,214709,1035876
2023-04-24 21:42,1035887,324054,497120,214713,1035887
2023-04-24 21:43,1035897,324058,497125,214714,1035897
2023-04-24 21:44,1035906,324064,497125,214717,1035906
2023-04-24 21:45,1035916,324072,497126,214718,1035916
2023-04-24 21:46,1035927,324080,497126,214721,1035927
2023-04-24 21:47,1035938,324087,497130,214721,1035938
2023-04-24 21:48,1035949,324096,497130,214723,1035949
2023-04-24 21:49,1035959,324095,497136,214728,1035959
2023-04-24 21:50,1035968,324103,497136,214729,1035968
2023-04-24 21:51,1035979,324108,497139,214732,1035979
2023-04-24 21:52,1035990,324114,497142,214734,1035990
2023-04-24 21:54,1036000,324120,497142,214738,1036000
2023-04-24 21:55,1036010,324119,497147,214744,1036010
2023-04-24 21:56,1036020,324126,497147,214747,1036020
2023-04-24 21:57,1036030,324132,497150,214748,1036030
2023-04-24 21:58,1036039,324140,497150,214749,1036039
2023-04-24 21:59,1036049,324142,497154,214753,1036049
2023-04-24 22:00,1036060,324152,497154,214754,1036060
2023-04-24 22:01,1036079,324166,497157,214756,1036079
2023-04-24 22:02,1036098,324180,497157,214761,1036098
2023-04-24 22:03,1036119,324194,497161,214764,1036119
2023-04-24 22:04,1036138,324210,497161,214767,1036138
2023-04-24 22:05,1036157,324215,497170,214772,1036157
2023-04-24 22:06,1036177,324229,497170,214778,1036177
2023-04-24 22:07,1036197,324244,497172,214781,1036197
2023-04-24 22:08,1036218,324261,497172,214785,1036218
2023-04-24 22:09,1036237,324269,497177,214791,1036237
2023-04-24 22:10,1036256,324285,497177,214794,1036256
2023-04-24 22:11,1036276,324302,497179,214795,1036276
2023-04-24 22:12,1036294,324319,497179,214796,1036294
2023-04-24 22:13,1036315,324331,497184,214800,1036315
2023-04-24 22:14,1036335,324343,497184,214808,1036335
2023-04-24 22:15,1036355,324356,497188,214811,1036355
2023-04-24 22:16,1036375,324374,497188,214813,1036375
2023-04-24 22:17,1036394,324386,497191,214817,1036394
2023-04-24 22:18,1036415,324404,497191,214820,1036415
2023-04-24 22:19,1036436,324423,497191,214822,1036436
2023-04-24 22:20,1036455,324442,497191,214822,1036455
2023-04-24 22:21,1036476,324455,497194,214827,1036476
2023-04-24 22:22,1036494,324468,497194,214832,1036494
2023-04-24 22:23,1036516,324487,497195,214834,1036516
2023-04-24 22:24,1036534,324501,497195,214838,1036534
2023-04-24 22:25,1036554,324515,497198,214841,1036554
2023-04-24 22:26,1036574,324535,497198,214841,1036574
2023-04-24 22:27,1036593,324546,497203,214844,1036593
2023-04-24 22:28,1036614,324562,497204,214848,1036614
2023-04-24 22:29,1036633,324578,497204,214851,1036633
2023-04-24 22:30,1036653,324594,497206,214853,1036653
2023-04-24 22:31,1036672,324611,497206,214855,1036672
2023-04-24 22:32,1036692,324623,497210,214859,1036692
2023-04-24 22:33,1036712,324640,497210,214862,1036712
2023-04-24 22:34,1036731,324652,497215,214864,1036731
2023-04-24 22:35,1036753,324670,497215,214868,1036753
2023-04-24 22:36,1036773,324682,497219,214872,1036773
2023-04-24 22:37,1036792,324698,497222,214872,1036792
2023-04-24 22:38,1036814,324714,497225,214875,1036814
2023-04-24 22:39,1036834,324723,497233,214878,1036834
2023-04-24 22:40,1036854,324737,497233,214884,1036854
2023-04-24 22:42,1036876,324754,497236,214886,1036876
2023-04-24 22:43,1036896,324769,497236,214891,1036896
2023-04-24 22:44,1036916,324785,497238,214893,1036916
2023-04-24 22:45,1036936,324797,497238,214901,1036936
2023-04-24 22:46,1036955,324808,497242,214905,1036955
2023-04-24 22:47,1036974,324824,497242,214908,1036974
2023-04-24 22:48,1036995,324842,497245,214908,1036995
2023-04-24 22:49,1037014,324859,497245,214910,1037014
2023-04-24 22:50,1037034,324870,497251,214913,1037034
2023-04-24 22:51,1037053,324886,497251,214916,1037053
2023-04-24 22:52,1037073,324906,497251,214916,1037073
2023-04-24 22:53,1037094,324921,497251,214922,1037094
2023-04-24 22:54,1037113,324932,497251,214930,1037113
2023-04-24 22:55,1037134,324950,497251,214933,1037134
2023-04-24 22:56,1037156,324972,497251,214933,1037156
2023-04-24 22:57,1037175,324989,497251,214935,1037175
2023-04-24 22:58,1037196,325007,497251,214938,1037196
2023-04-24 22:59,1037216,325006,497268,214942,1037216
2023-04-24 23:00,1037236,325023,497268,214945,1037236
2023-04-24 23:01,1037250,325031,497269,214950,1037250
2023-04-24 23:02,1037266,325044,497269,214953,1037266
2023-04-24 23:03,1037283,325045,497279,214959,1037283
2023-04-24 23:04,1037298,325057,497279,214962,1037298
2023-04-24 23:05,1037314,325067,497282,214965,1037314
2023-04-24 23:06,1037329,325077,497282,214970,1037329
2023-04-24 23:07,1037344,325085,497285,214974,1037344
2023-04-24 23:08,1037358,325095,497285,214978,1037358
2023-04-24 23:09,1037374,325107,497286,214981,1037374
2023-04-24 23:10,1037389,325118,497286,214985,1037389
2023-04-24 23:11,1037404,325130,497286,214988,1037404
2023-04-24 23:12,1037420,325141,497286,214993,1037420
2023-04-24 23:13,1037436,325150,497289,214997,1037436
2023-04-24 23:14,1037451,325160,497293,214998,1037451
2023-04-24 23:15,1037466,325173,497293,215000,1037466
2023-04-24 23:16,1037483,325184,497295,215004,1037483
2023-04-24 23:17,1037499,325196,497295,215008,1037499
2023-04-24 23:18,1037515,325205,497300,215010,1037515
2023-04-24 23:19,1037530,325212,497303,215015,1037530
2023-04-24 23:20,1037546,325224,497303,215019,1037546
2023-04-24 23:21,1037562,325229,497309,215024,1037562
2023-04-24 23:22,1037580,325243,497312,215025,1037580
2023-04-24 23:23,1037594,325255,497312,215027,1037594
2023-04-24 23:24,1037611,325267,497314,215030,1037611
2023-04-24 23:25,1037625,325278,497314,215033,1037625
2023-04-24 23:26,1037640,325287,497316,215037,1037640
2023-04-24 23:28,1037655,325297,497316,215042,1037655
2023-04-24 23:29,1037673,325311,497316,215046,1037673
2023-04-24 23:30,1037689,325323,497316,215050,1037689
2023-04-24 23:31,1037704,325334,497318,215052,1037704
2023-04-24 23:32,1037720,325348,497318,215054,1037720
2023-04-24 23:33,1037735,325356,497322,215057,1037735
2023-04-24 23:34,1037750,325368,497322,215060,1037750
2023-04-24 23:35,1037764,325379,497325,215060,1037764
2023-04-24 23:36,1037781,325395,497325,215061,1037781
2023-04-24 23:37,1037797,325408,497328,215061,1037797
2023-04-24 23:38,1037815,325420,497330,215065,1037815
2023-04-24 23:39,1037830,325433,497330,215067,1037830
2023-04-24 23:40,1037845,325444,497333,215068,1037845
2023-04-24 23:41,1037862,325461,497333,215068,1037862
2023-04-24 23:42,1037876,325470,497337,215069,1037876
2023-04-24 23:43,1037892,325483,497337,215072,1037892
2023-04-24 23:44,1037907,325496,497338,215073,1037907
2023-04-24 23:45,1037921,325508,497338,215075,1037921
2023-04-24 23:46,1037938,325524,497339,215075,1037938
2023-04-24 23:47,1037952,325536,497339,215077,1037952
2023-04-24 23:48,1037968,325545,497344,215079,1037968
2023-04-24 23:49,1037983,325555,497344,215084,1037983
2023-04-24 23:50,1037999,325565,497346,215088,1037999
2023-04-24 23:51,1038015,325579,497346,215090,1038015
2023-04-24 23:52,1038031,325590,497350,215091,1038031
2023-04-24 23:53,1038047,325602,497350,215095,1038047
2023-04-24 23:54,1038064,325613,497354,215097,1038064
2023-04-24 23:55,1038079,325628,497354,215097,1038079
2023-04-24 23:56,1038094,325636,497356,215102,1038094
2023-04-24 23:57,1038109,325646,497356,215107,1038109
2023-04-24 23:58,1038124,325656,497358,215110,1038124
2023-04-24 23:59,1038139,325666,497358,215115,1038139
2023-04-25 00:00,1038145,325665,497361,215119,1038145
2023-04-25 00:01,1038146,325663,497361,215122,1038146
2023-04-25 00:02,1038146,325656,497365,215125,1038146
2023-04-25 00:03,1038147,325657,497365,215125,1038147
2023-04-25 00:04,1038147,325643,497375,215129,1038147
2023-04-25 00:05,1038148,325642,497375,215131,1038148
2023-04-25 00:06,1038149,325637,497379,215133,1038149
2023-04-25 00:07,1038149,325636,497379,215134,1038149
2023-04-25 00:08,1038150,325632,497381,215137,1038150
2023-04-25 00:09,1038150,325631,497381,215138,1038150
2023-04-25 00:10,1038150,325625,497383,215142,1038150
2023-04-25 00:11,1038152,325627,497383,215142,1038152
2023-04-25 00:12,1038153,325623,497387,215143,1038153
2023-04-25 00:13,1038153,325620,497387,215146,1038153
2023-04-25 00:15,1038153,325616,497389,215148,1038153
2023-04-25 00:16,1038153,325614,497389,215150,1038153
2023-04-25 00:17,1038154,325610,497393,215151,1038154
2023-04-25 00:18,1038156,325611,497393,215152,1038156
2023-04-25 00:19,1038156,325608,497394,215154,1038156
2023-04-25 00:20,1038156,325607,497394,215155,1038156
2023-04-25 00:21,1038156,325607,497394,215155,1038156
2023-04-25 00:22,1038157,325607,497394,215156,1038157
2023-04-25 00:23,1038160,325607,497395,215158,1038160
2023-04-25 00:24,1038162,325605,497395,215162,1038162
2023-04-25 00:25,1038164,325600,497398,215166,1038164
2023-04-25 00:26,1038165,325598,497398,215169,1038165
2023-04-25 00:27,1038165,325595,497399,215171,1038165
2023-04-25 00:28,1038165,325594,497399,215172,1038165
2023-04-25 00:29,1038166,325591,497401,215174,1038166
2023-04-25 00:30,1038166,325585,497403,215178,1038166
2023-04-25 00:31,1038167,325584,497403,215180,1038167
2023-04-25 00:32,1038167,325575,497407,215185,1038167
2023-04-25 00:33,1038169,325576,497407,215186,1038169
2023-04-25 00:34,1038170,325575,497409,215186,1038170
2023-04-25 00:35,1038170,325573,497409,215188,1038170
2023-04-25 00:36,1038171,325566,497417,215188,1038171
2023-04-25 00:37,1038171,325563,497417,215191,1038171
2023-04-25 00:38,1038171,325556,497422,215193,1038171
2023-04-25 00:39,1038171,325555,497422,215194,1038171
2023-04-25 00:40,1038172,325552,497424,215196,1038172
2023-04-25 00:41,1038173,325552,497424,215197,1038173
2023-04-25 00:42,1038174,325544,497428,215202,1038174
2023-04-25 00:43,1038174,325542,497428,215204,1038174
2023-04-25 00:44,1038174,325535,497433,215206,1038174
2023-04-25 00:45,1038174,325532,497433,215209,1038174
2023-04-25 00:46,1038175,325528,497437,215210,1038175
2023-04-25 00:47,1038176,325527,497437,215212,1038176
2023-04-25 00:48,1038178,325528,497437,215213,1038178
2023-04-25 00:49,1038178,325526,497437,215215,1038178
2023-04-25 00:50,1038178,325521,497441,215216,1038178
2023-04-25 00:51,1038179,325521,497441,215217,1038179
2023-04-25 00:52,1038180,325515,497446,215219,1038180
2023-04-25 00:53,1038180,325512,497446,215222,1038180
2023-04-25 00:54,1038180,325508,497448,215224,1038180
2023-04-25 00:55,1038180,325504,497448,215228,1038180
2023-04-25 00:56,1038180,325500,497449,215231,1038180
2023-04-25 00:57,1038180,325500,497449,215231,1038180
2023-04-25 00:58,1038180,325496,497450,215234,1038180
2023-04-25 00:59,1038180,325495,497450,215235,1038180
2023-04-25 01:01,1038180,325489,497453,215238,1038180
2023-04-25 01:02,1038180,325488,497453,215239,1038180
2023-04-25 01:03,1038180,325487,497454,215239,1038180
2023-04-25 01:04,1038180,325483,497455,215242,1038180
2023-04-25 01:05,1038180,325482,497455,215243,1038180
2023-04-25 01:06,1038182,325481,497456,215245,1038182
2023-04-25 01:07,1038182,325479,497456,215247,1038182
2023-04-25 01:08,1038182,325470,497461,215251,1038182
2023-04-25 01:09,1038182,325468,497461,215253,1038182
2023-04-25 01:10,1038182,325465,497463,215254,1038182
2023-04-25 01:11,1038182,325465,497463,215254,1038182
2023-04-25 01:12,1038182,325462,497464,215256,1038182
2023-04-25 01:13,1038183,325460,497464,215259,1038183
2023-04-25 01:14,1038183,325457,497465,215261,1038183
2023-04-25 01:15,1038183,325456,497465,215262,1038183
2023-04-25 01:16,1038183,325453,497467,215263,1038183
2023-04-25 01:17,1038183,325450,497467,215266,1038183
2023-04-25 01:18,1038183,325448,497468,215267,1038183
2023-04-25 01:19,1038183,325446,497468,215269,1038183
2023-04-25 01:20,1038184,325446,497469,215269,1038184
2023-04-25 01:21,1038184,325443,497469,215272,1038184
2023-04-25 01:22,1038184,325442,497470,215272,1038184
2023-04-25 01:23,1038184,325440,497470,215274,1038184
2023-04-25 01:24,1038184,325436,497472,215276,1038184
2023-04-25 01:25,1038184,325435,497472,215277,1038184
2023-04-25 01:26,1038184,325432,497472,215280,1038184
2023-04-25 01:27,1038184,325431,497472,215281,1038184
2023-04-25 01:28,1038184,325427,497475,215282,1038184
2023-04-25 01:29,1038184,325425,497475,215284,1038184
2023-04-25 01:30,1038184,325425,497475,215284,1038184
2023-04-25 01:31,1038185,325424,497475,215286,1038185
2023-04-25 01:32,1038186,325420,497477,215289,1038186
2023-04-25 01:33,1038186,325419,497477,215290,1038186
2023-04-25 01:34,1038187,325416,497479,215292,1038187
2023-04-25 01:35,1038188,325415,497479,215294,1038188
2023-04-25 01:36,1038188,325412,497481,215295,1038188
2023-04-25 01:37,1038188,325410,497481,215297,1038188
2023-04-25 01:38,1038188,325405,497485,215298,1038188
2023-04-25 01:39,1038188,325400,497488,215300,1038188
2023-04-25 01:40,1038188,325399,497488,215301,1038188
2023-04-25 01:41,1038188,325397,497489,215302,1038188
2023-04-25 01:42,1038188,325397,497489,215302,1038188
2023-04-25 01:43,1038190,325397,497489,215304,1038190
2023-04-25 01:44,1038190,325395,497489,215306,1038190
2023-04-25 01:45,1038190,325391,497491,215308,1038190
2023-04-25 01:46,1038190,325391,497491,215308,1038190
2023-04-25 01:47,1038191,325390,497493,215308,1038191
2023-04-25 01:49,1038191,325389,497493,215309,1038191
2023-04-25 01:50,1038192,325388,497494,215310,1038192
2023-04-25 01:51,1038192,325387,497494,215311,1038192
2023-04-25 01:52,1038192,325386,497495,215311,1038192
2023-04-25 01:53,1038192,325386,497495,215311,1038192
2023-04-25 01:54,1038193,325383,497498,215312,1038193
2023-04-25 01:55,1038193,325382,497498,215313,1038193
2023-04-25 01:56,1038193,325380,497500,215313,1038193
2023-04-25 01:57,1038193,325378,497502,215313,1038193
2023-04-25 01:58,1038193,325378,497502,215313,1038193
2023-04-25 01:59,1038194,325376,497504,215314,1038194
2023-04-25 02:00,1038198,325380,497504,215314,1038198
2023-04-25 02:01,1038211,325392,497505,215314,1038211
2023-04-25 02:02,1038225,325406,497505,215314,1038225
2023-04-25 02:03,1038237,325417,497506,215314,1038237
2023-04-25 02:04,1038251,325430,497506,215315,1038251
2023-04-25 02:05,1038264,325437,497510,215317,1038264
2023-04-25 02:06,1038278,325451,497510,215317,1038278
2023-04-25 02:07,1038291,325461,497511,215319,1038291
2023-04-25 02:08,1038304,325473,497511,215320,1038304
2023-04-25 02:09,1038317,325482,497514,215321,1038317
2023-04-25 02:10,1038332,325497,497514,215321,1038332
2023-04-25 02:11,1038345,325509,497515,215321,1038345
2023-04-25 02:12,1038359,325523,497515,215321,1038359
2023-04-25 02:13,1038373,325536,497516,215321,1038373
2023-04-25 02:14,1038386,325548,497516,215322,1038386
2023-04-25 02:15,1038399,325561,497516,215322,1038399
2023-04-25 02:16,1038412,325574,497516,215322,1038412
2023-04-25 02:17,1038425,325585,497516,215324,1038425
2023-04-25 02:18,1038438,325597,497516,215325,1038438
2023-04-25 02:19,1038453,325609,497518,215326,1038453
2023-04-25 02:20,1038466,325622,497518,215326,1038466
2023-04-25 02:21,1038479,325634,497518,215327,1038479
2023-04-25 02:22,1038492,325647,497518,215327,1038492
2023-04-25 02:23,1038505,325655,497521,215329,1038505
2023-04-25 02:24,1038518,325667,497521,215330,1038518
2023-04-25 02:25,1038531,325675,497524,215332,1038531
2023-04-25 02:26,1038544,325687,497524,215333,1038544
2023-04-25 02:27,1038558,325699,497525,215334,1038558
2023-04-25 02:28,1038571,325710,497525,215336,1038571
2023-04-25 02:29,1038584,325720,497527,215337,1038584
2023-04-25 02:30,1038598,325733,497527,215338,1038598
2023-04-25 02:31,1038611,325745,497527,215339,1038611
2023-04-25 02:32,1038624,325757,497527,215340,1038624
2023-04-25 02:33,1038638,325770,497528,215340,1038638
2023-04-25 02:34,1038651,325783,497528,215340,1038651
2023-04-25 02:36,1038664,325791,497530,215343,1038664
2023-04-25 02:37,1038677,325803,497530,215344,1038677
2023-04-25 02:38,1038691,325816,497530,215345,1038691
2023-04-25 02:39,1038703,325828,497530,215345,1038703
2023-04-25 02:40,1038717,325842,497530,215345,1038717
2023-04-25 02:41,1038731,325856,497530,215345,1038731
2023-04-25 02:42,1038743,325867,497531,215345,1038743
2023-04-25 02:43,1038757,325881,497531,215345,1038757
2023-04-25 02:44,1038771,325895,497531,215345,1038771
2023-04-25 02:45,1038783,325907,497531,215345,1038783
2023-04-25 02:46,1038796,325919,497531,215346,1038796
2023-04-25 02:47,1038810,325933,497531,215346,1038810
2023-04-25 02:48,1038823,325946,497531,215346,1038823
2023-04-25 02:49,1038836,325959,497531,215346,1038836
2023-04-25 02:50,1038850,325974,497530,215346,1038850
2023-04-25 02:51,1038862,325986,497530,215346,1038862
2023-04-25 02:52,1038875,325998,497530,215347,1038875
2023-04-25 02:53,1038889,326012,497530,215347,1038889
2023-04-25 02:54,1038903,326025,497531,215347,1038903
2023-04-25 02:55,1038916,326038,497531,215347,1038916
2023-04-25 02:56,1038929,326051,497531,215347,1038929
2023-04-25 02:57,1038942,326064,497531,215347,1038942
2023-04-25 02:58,1038955,326077,497531,215347,1038955
2023-04-25 02:59,1038969,326090,497531,215348,1038969
2023-04-25 03:00,1038978,326097,497532,215349,1038978
2023-04-25 03:01,1038985,326103,497532,215350,1038985
2023-04-25 03:02,1038992,326110,497532,215350,1038992
2023-04-25 03:03,1038998,326116,497532,215350,1038998
2023-04-25 03:04,1039004,326122,497532,215350,1039004
2023-04-25 03:05,1039011,326129,497532,215350,1039011
2023-04-25 03:06,1039017,326133,497533,215351,1039017
2023-04-25 03:07,1039024,326140,497533,215351,1039024
2023-04-25 03:08,1039030,326145,497533,215352,1039030
2023-04-25 03:09,1039037,326152,497533,215352,1039037
2023-04-25 03:10,1039043,326155,497536,215352,1039043
2023-04-25 03:11,1039050,326162,497536,215352,1039050
2023-04-25 03:12,1039057,326167,497537,215353,1039057
2023-04-25 03:13,1039064,326174,497537,215353,1039064
2023-04-25 03:14,1039070,326179,497538,215353,1039070
2023-04-25 03:15,1039076,326185,497538,215353,1039076
2023-04-25 03:16,1039083,326192,497538,215353,1039083
2023-04-25 03:17,1039089,326198,497538,215353,1039089
2023-04-25 03:18,1039096,326205,497538,215353,1039096
2023-04-25 03:19,1039102,326211,497538,215353,1039102
2023-04-25 03:20,1039109,326216,497539,215354,1039109
2023-04-25 03:22,1039115,326222,497539,215354,1039115
2023-04-25 03:23,1039122,326228,497540,215354,1039122
2023-04-25 03:24,1039128,326234,497540,215354,1039128
2023-04-25 03:25,1039135,326241,497540,215354,1039135
2023-04-25 03:26,1039142,326247,497540,215355,1039142
2023-04-25 03:27,1039148,326252,497541,215355,1039148
2023-04-25 03:28,1039155,326259,497541,215355,1039155
2023-04-25 03:29,1039161,326264,497541,215356,1039161
2023-04-25 03:30,1039168,326270,497541,215357,1039168
2023-04-25 03:31,1039174,326274,497543,215357,1039174
2023-04-25 03:32,1039181,326281,497543,215357,1039181
2023-04-25 03:33,1039187,326285,497544,215358,1039187
2023-04-25 03:34,1039194,326291,497544,215359,1039194
2023-04-25 03:35,1039200,326296,497545,215359,1039200
2023-04-25 03:36,1039206,326302,497545,215359,1039206
2023-04-25 03:37,1039213,326309,497545,215359,1039213
2023-04-25 03:38,1039220,326316,497545,215359,1039220
2023-04-25 03:39,1039226,326321,497546,215359,1039226
2023-04-25 03:40,1039233,326328,497546,215359,1039233
2023-04-25 03:41,1039239,326330,497549,215360,1039239
2023-04-25 03:42,1039245,326336,497549,215360,1039245
2023-04-25 03:43,1039252,326343,497549,215360,1039252
2023-04-25 03:44,1039258,326349,497549,215360,1039258
2023-04-25 03:45,1039265,326354,497551,215360,1039265
2023-04-25 03:46,1039271,326358,497551,215362,1039271
2023-04-25 03:47,1039277,326363,497552,215362,1039277
2023-04-25 03:48,1039284,326369,497552,215363,1039284
2023-04-25 03:49,1039290,326375,497552,215363,1039290
2023-04-25 03:50,1039297,326382,497552,215363,1039297
2023-04-25 03:51,1039303,326387,497553,215363,1039303
2023-04-25 03:52,1039310,326394,497553,215363,1039310
2023-04-25 03:53,1039317,326400,497553,215364,1039317
2023-04-25 03:54,1039324,326407,497553,215364,1039324
2023-04-25 03:55,1039330,326411,497554,215365,1039330
2023-04-25 03:56,1039336,326417,497554,215365,1039336
2023-04-25 03:57,1039343,326422,497556,215365,1039343
2023-04-25 03:58,1039350,326429,497556,215365,1039350
2023-04-25 03:59,1039356,326435,497556,215365,1039356
2023-04-25 04:00,1039372,326451,497556,215365,1039372
2023-04-25 04:01,1039391,326469,497557,215365,1039391
2023-04-25 04:02,1039410,326488,497557,215365,1039410
2023-04-25 04:03,1039430,326508,497557,215365,1039430
2023-04-25 04:04,1039450,326528,497557,215365,1039450
2023-04-25 04:05,1039469,326546,497558,215365,1039469
2023-04-25 04:06,1039490,326565,497558,215367,1039490
2023-04-25 04:07,1039508,326583,497558,215367,1039508
2023-04-25 04:09,1039529,326603,497558,215368,1039529
2023-04-25 04:10,1039547,326621,497558,215368,1039547
2023-04-25 04:11,1039566,326641,497558,215367,1039566
2023-04-25 04:12,1039586,326660,497559,215367,1039586
2023-04-25 04:13,1039605,326679,497559,215367,1039605
2023-04-25 04:14,1039624,326697,497560,215367,1039624
2023-04-25 04:15,1039644,326717,497560,215367,1039644
2023-04-25 04:16,1039664,326737,497560,215367,1039664
2023-04-25 04:17,1039683,326754,497560,215369,1039683
2023-04-25 04:18,1039702,326772,497561,215369,1039702
2023-04-25 04:19,1039721,326791,497561,215369,1039721
2023-04-25 04:20,1039741,326809,497561,215371,1039741
2023-04-25 04:21,1039761,326829,497561,215371,1039761
2023-04-25 04:22,1039780,326847,497562,215371,1039780
2023-04-25 04:23,1039799,326866,497562,215371,1039799
2023-04-25 04:24,1039819,326886,497562,215371,1039819
2023-04-25 04:25,1039837,326904,497562,215371,1039837
2023-04-25 04:26,1039858,326925,497562,215371,1039858
2023-04-25 04:27,1039877,326944,497562,215371,1039877
2023-04-25 04:28,1039896,326960,497565,215371,1039896
2023-04-25 04:29,1039916,326980,497565,215371,1039916
2023-04-25 04:30,1039934,326997,497566,215371,1039934
2023-04-25 04:31,1039954,327017,497566,215371,1039954
2023-04-25 04:32,1039973,327034,497567,215372,1039973
2023-04-25 04:33,1039992,327053,497567,215372,1039992
2023-04-25 04:34,1040012,327073,497567,215372,1040012
2023-04-25 04:35,1040032,327093,497567,215372,1040032
2023-04-25 04:36,1040050,327110,497568,215372,1040050
2023-04-25 04:37,1040070,327130,497568,215372,1040070
2023-04-25 04:38,1040090,327149,497569,215372,1040090
2023-04-25 04:39,1040109,327168,497569,215372,1040109
2023-04-25 04:40,1040129,327187,497570,215372,1040129
2023-04-25 04:41,1040149,327207,497570,215372,1040149
2023-04-25 04:42,1040168,327226,497570,215372,1040168
2023-04-25 04:43,1040187,327245,497570,215372,1040187
2023-04-25 04:44,1040207,327264,497570,215373,1040207
2023-04-25 04:45,1040226,327283,497570,215373,1040226
2023-04-25 04:46,1040245,327301,497571,215373,1040245
2023-04-25 04:47,1040265,327321,497571,215373,1040265
2023-04-25 04:48,1040285,327342,497570,215373,1040285
2023-04-25 04:49,1040304,327361,497570,215373,1040304
2023-04-25 04:50,1040323,327379,497571,215373,1040323
2023-04-25 04:51,1040343,327399,497571,215373,1040343
2023-04-25 04:52,1040362,327416,497572,215374,1040362
2023-04-25 04:53,1040381,327435,497572,215374,1040381
2023-04-25 04:54,1040400,327454,497572,215374,1040400
2023-04-25 04:56,1040420,327474,497572,215374,1040420
2023-04-25 04:57,1040439,327493,497572,215374,1040439
2023-04-25 04:58,1040459,327512,497572,215375,1040459
2023-04-25 04:59,1040478,327530,497572,215376,1040478
2023-04-25 05:00,1040498,327550,497572,215376,1040498
2023-04-25 05:01,1040514,327564,497574,215376,1040514
2023-04-25 05:02,1040532,327582,497574,215376,1040532
2023-04-25 05:03,1040550,327600,497574,215376,1040550
2023-04-25 05:04,1040567,327617,497574,215376,1040567
2023-04-25 05:05,1040584,327633,497575,215376,1040584
2023-04-25 05:06,1040603,327652,497575,215376,1040603
2023-04-25 05:07,1040619,327668,497575,215376,1040619
2023-04-25 05:08,1040636,327684,497575,215377,1040636
2023-04-25 05:09,1040654,327702,497575,215377,1040654
2023-04-25 05:10,1040672,327720,497575,215377,1040672
2023-04-25 05:11,1040689,327737,497575,215377,1040689
2023-04-25 05:12,1040708,327756,497575,215377,1040708
2023-04-25 05:13,1040726,327774,497575,215377,1040726
2023-04-25 05:14,1040743,327791,497575,215377,1040743
2023-04-25 05:15,1040760,327808,497575,215377,1040760
2023-04-25 05:16,1040777,327825,497575,215377,1040777
2023-04-25 05:17,1040794,327842,497575,215377,1040794
2023-04-25 05:18,1040812,327860,497575,215377,1040812
2023-04-25 05:19,1040830,327877,497576,215377,1040830
2023-04-25 05:20,1040847,327894,497576,215377,1040847
2023-04-25 05:21,1040864,327911,497576,215377,1040864
2023-04-25 05:22,1040883,327930,497576,215377,1040883
2023-04-25 05:23,1040900,327947,497576,215377,1040900
2023-04-25 05:24,1040917,327962,497577,215378,1040917
2023-04-25 05:25,1040934,327979,497577,215378,1040934
2023-04-25 05:26,1040952,327995,497579,215378,1040952
2023-04-25 05:27,1040969,328012,497579,215378,1040969
2023-04-25 05:28,1040987,328029,497579,215379,1040987
2023-04-25 05:29,1041004,328046,497579,215379,1041004
2023-04-25 05:30,1041021,328063,497579,215379,1041021
2023-04-25 05:31,1041039,328080,497579,215380,1041039
2023-04-25 05:32,1041057,328097,497579,215381,1041057
2023-04-25 05:33,1041074,328113,497579,215382,1041074
2023-04-25 05:34,1041091,328129,497579,215383,1041091
2023-04-25 05:35,1041109,328146,497579,215384,1041109
2023-04-25 05:36,1041127,328164,497579,215384,1041127
2023-04-25 05:37,1041145,328182,497579,215384,1041145
2023-04-25 05:38,1041162,328198,497579,215385,1041162
2023-04-25 05:39,1041179,328213,497579,215387,1041179
2023-04-25 05:40,1041198,328230,497581,215387,1041198
2023-04-25 05:42,1041215,328247,497581,215387,1041215
2023-04-25 05:43,1041231,328260,497582,215389,1041231
2023-04-25 05:44,1041249,328278,497582,215389,1041249
2023-04-25 05:45,1041267,328295,497582,215390,1041267
2023-04-25 05:46,1041285,328313,497582,215390,1041285
2023-04-25 05:47,1041302,328330,497582,215390,1041302
2023-04-25 05:48,1041320,328348,497582,215390,1041320
2023-04-25 05:49,1041338,328365,497583,215390,1041338
2023-04-25 05:50,1041356,328381,497583,215392,1041356
2023-04-25 05:51,1041374,328399,497583,215392,1041374
2023-04-25 05:52,1041392,328417,497583,215392,1041392
2023-04-25 05:53,1041409,328433,497584,215392,1041409
2023-04-25 05:54,1041427,328451,497584,215392,1041427
2023-04-25 05:55,1041444,328468,497584,215392,1041444
2023-04-25 05:56,1041461,328485,497584,215392,1041461
2023-04-25 05:57,1041479,328501,497585,215393,1041479
2023-04-25 05:58,1041497,328519,497585,215393,1041497
2023-04-25 05:59,1041514,328536,497585,215393,1041514
2023-04-25 06:00,1041531,328553,497585,215393,1041531
2023-04-25 06:01,1041551,328571,497586,215394,1041551
2023-04-25 06:02,1041570,328590,497586,215394,1041570
2023-04-25 06:03,1041590,328610,497586,215394,1041590
2023-04-25 06:04,1041608,328628,497586,215394,1041608
2023-04-25 06:05,1041627,328646,497587,215394,1041627
2023-04-25 06:06,1041645,328663,497587,215395,1041645
2023-04-25 06:07,1041665,328682,497587,215396,1041665
2023-04-25 06:08,1041683,328700,497587,215396,1041683
2023-04-25 06:09,1041701,328718,497587,215396,1041701
2023-04-25 06:10,1041720,328735,497587,215398,1041720
2023-04-25 06:11,1041738,328751,497589,215398,1041738
2023-04-25 06:12,1041757,328770,497589,215398,1041757
2023-04-25 06:13,1041776,328787,497591,215398,1041776
2023-04-25 06:14,1041794,328804,497591,215399,1041794
2023-04-25 06:15,1041814,328823,497591,215400,1041814
2023-04-25 06:16,1041832,328841,497591,215400,1041832
2023-04-25 06:17,1041851,328858,497591,215402,1041851
2023-04-25 06:18,1041869,328876,497591,215402,1041869
2023-04-25 06:19,1041888,328894,497592,215402,1041888
2023-04-25 06:20,1041907,328913,497592,215402,1041907
2023-04-25 06:21,1041927,328933,497592,215402,1041927
2023-04-25 06:22,1041946,328951,497592,215403,1041946
2023-04-25 06:23,1041964,328967,497593,215404,1041964
2023-04-25 06:24,1041982,328985,497593,215404,1041982
2023-04-25 06:25,1042002,329004,497593,215405,1042002
2023-04-25 06:26,1042019,329021,497593,215405,1042019
2023-04-25 06:27,1042039,329040,497594,215405,1042039
2023-04-25 06:29,1042057,329058,497594,215405,1042057
2023-04-25 06:30,1042078,329079,497594,215405,1042078
2023-04-25 06:31,1042097,329098,497594,215405,1042097
2023-04-25 06:32,1042116,329116,497595,215405,1042116
2023-04-25 06:33,1042136,329136,497595,215405,1042136
2023-04-25 06:34,1042155,329154,497596,215405,1042155
2023-04-25 06:35,1042173,329172,497596,215405,1042173
2023-04-25 06:36,1042193,329191,497596,215406,1042193
2023-04-25 06:37,1042211,329209,497596,215406,1042211
2023-04-25 06:38,1042230,329226,497598,215406,1042230
2023-04-25 06:39,1042250,329246,497598,215406,1042250
2023-04-25 06:40,1042268,329262,497600,215406,1042268
2023-04-25 06:41,1042289,329283,497600,215406,1042289
2023-04-25 06:42,1042308,329301,497600,215407,1042308
2023-04-25 06:43,1042327,329318,497600,215409,1042327
2023-04-25 06:44,1042346,329335,497602,215409,1042346
2023-04-25 06:45,1042365,329353,497602,215410,1042365
2023-04-25 06:46,1042384,329371,497603,215410,1042384
2023-04-25 06:47,1042403,329390,497603,215410,1042403
2023-04-25 06:48,1042422,329409,497603,215410,1042422
2023-04-25 06:49,1042441,329427,497603,215411,1042441
2023-04-25 06:50,1042459,329445,497602,215412,1042459
2023-04-25 06:51,1042478,329464,497602,215412,1042478
2023-04-25 06:52,1042497,329483,497602,215412,1042497
2023-04-25 06:53,1042515,329501,497602,215412,1042515
2023-04-25 06:54,1042533,329519,497602,215412,1042533
2023-04-25 06:55,1042553,329539,497602,215412,1042553
2023-04-25 06:56,1042571,329557,497602,215412,1042571
2023-04-25 06:57,1042590,329575,497602,215413,1042590
2023-04-25 06:58,1042608,329592,497602,215414,1042608
2023-04-25 06:59,1042628,329612,497602,215414,1042628
2023-04-25 07:00,1042649,329630,497604,215415,1042649
2023-04-25 07:01,1042673,329655,497604,215414,1042673
2023-04-25 07:02,1042698,329679,497604,215415,1042698
2023-04-25 07:03,1042722,329703,497604,215415,1042722
2023-04-25 07:04,1042747,329727,497604,215416,1042747
2023-04-25 07:05,1042771,329750,497604,215417,1042771
2023-04-25 07:06,1042796,329775,497604,215417,1042796
2023-04-25 07:07,1042823,329801,497604,215418,1042823
2023-04-25 07:08,1042846,329824,497604,215418,1042846
2023-04-25 07:09,1042872,329850,497604,215418,1042872
2023-04-25 07:10,1042896,329864,497614,215418,1042896
2023-04-25 07:11,1042922,329889,497614,215419,1042922
2023-04-25 07:12,1042945,329912,497614,215419,1042945
2023-04-25 07:13,1042971,329939,497614,215418,1042971
2023-04-25 07:15,1042995,329963,497614,215418,1042995
2023-04-25 07:16,1043018,329985,497614,215419,1043018
2023-04-25 07:17,1043042,330008,497614,215420,1043042
2023-04-25 07:18,1043066,330031,497614,215421,1043066
2023-04-25 07:19,1043092,330056,497614,215422,1043092
2023-04-25 07:20,1043116,330078,497614,215424,1043116
2023-04-25 07:21,1043142,330102,497616,215424,1043142
2023-04-25 07:22,1043165,330124,497616,215425,1043165
2023-04-25 07:23,1043191,330149,497616,215426,1043191
2023-04-25 07:24,1043215,330171,497616,215428,1043215
2023-04-25 07:25,1043241,330196,497616,215429,1043241
2023-04-25 07:26,1043264,330219,497616,215429,1043264
2023-04-25 07:27,1043289,330242,497616,215431,1043289
2023-04-25 07:28,1043315,330268,497616,215431,1043315
2023-04-25 07:29,1043340,330293,497616,215431,1043340
2023-04-25 07:30,1043365,330316,497616,215433,1043365
2023-04-25 07:31,1043389,330332,497623,215434,1043389
2023-04-25 07:32,1043415,330355,497623,215437,1043415
2023-04-25 07:33,1043439,330379,497623,215437,1043439
2023-04-25 07:34,1043464,330404,497623,215437,1043464
2023-04-25 07:35,1043488,330427,497623,215438,1043488
2023-04-25 07:36,1043512,330451,497623,215438,1043512
2023-04-25 07:37,1043537,330476,497623,215438,1043537
2023-04-25 07:38,1043561,330498,497623,215440,1043561
2023-04-25 07:39,1043586,330523,497623,215440,1043586
2023-04-25 07:40,1043613,330549,497623,215441,1043613
2023-04-25 07:41,1043636,330564,497630,215442,1043636
2023-04-25 07:42,1043661,330589,497630,215442,1043661
2023-04-25 07:43,1043686,330614,497630,215442,1043686
2023-04-25 07:44,1043709,330637,497630,215442,1043709
2023-04-25 07:45,1043733,330661,497630,215442,1043733
2023-04-25 07:46,1043757,330683,497630,215444,1043757
2023-04-25 07:47,1043781,330704,497630,215447,1043781
2023-04-25 07:48,1043805,330727,497630,215448,1043805
2023-04-25 07:49,1043830,330752,497630,215448,1043830
2023-04-25 07:50,1043855,330775,497630,215450,1043855
2023-04-25 07:51,1043878,330792,497635,215451,1043878
2023-04-25 07:52,1043904,330818,497635,215451,1043904
2023-04-25 07:53,1043928,330842,497635,215451,1043928
2023-04-25 07:54,1043953,330863,497635,215455,1043953
2023-04-25 07:55,1043977,330887,497635,215455,1043977
2023-04-25 07:56,1044002,330911,497635,215456,1044002
2023-04-25 07:57,1044028,330935,497635,215458,1044028
2023-04-25 07:58,1044052,330958,497635,215459,1044052
2023-04-25 07:59,1044076,330981,497635,215460,1044076
2023-04-25 08:00,1044103,331005,497635,215463,1044103
2023-04-25 08:02,1044132,331030,497640,215462,1044132
2023-04-25 08:03,1044159,331056,497640,215463,1044159
2023-04-25 08:04,1044190,331085,497640,215465,1044190
2023-04-25 08:05,1044217,331111,497640,215466,1044217
2023-04-25 08:06,1044246,331138,497641,215467,1044246
2023-04-25 08:07,1044275,331167,497641,215467,1044275
2023-04-25 08:08,1044303,331188,497646,215469,1044303
2023-04-25 08:09,1044332,331216,497646,215470,1044332
2023-04-25 08:10,1044359,331242,497646,215471,1044359
2023-04-25 08:11,1044388,331270,497646,215472,1044388
2023-04-25 08:12,1044416,331295,497649,215472,1044416
2023-04-25 08:13,1044446,331325,497649,215472,1044446
2023-04-25 08:14,1044475,331349,497653,215473,1044475
2023-04-25 08:15,1044502,331375,497653,215474,1044502
2023-04-25 08:16,1044529,331402,497653,215474,1044529
2023-04-25 08:17,1044558,331429,497653,215476,1044558
2023-04-25 08:18,1044587,331456,497655,215476,1044587
2023-04-25 08:19,1044616,331485,497655,215476,1044616
2023-04-25 08:20,1044643,331511,497656,215476,1044643
2023-04-25 08:21,1044673,331540,497656,215477,1044673
2023-04-25 08:22,1044704,331569,497657,215478,1044704
2023-04-25 08:23,1044733,331596,497657,215480,1044733
2023-04-25 08:24,1044760,331623,497657,215480,1044760
2023-04-25 08:25,1044791,331653,497657,215481,1044791
2023-04-25 08:26,1044820,331679,497660,215481,1044820
2023-04-25 08:27,1044847,331706,497660,215481,1044847
2023-04-25 08:28,1044875,331733,497661,215481,1044875
2023-04-25 08:29,1044903,331761,497661,215481,1044903
2023-04-25 08:30,1044933,331790,497662,215481,1044933
2023-04-25 08:31,1044961,331818,497662,215481,1044961
2023-04-25 08:32,1044987,331839,497665,215483,1044987
2023-04-25 08:33,1045017,331867,497665,215485,1045017
2023-04-25 08:34,1045044,331889,497668,215487,1045044
2023-04-25 08:35,1045073,331916,497668,215489,1045073
2023-04-25 08:36,1045102,331944,497668,215490,1045102
2023-04-25 08:37,1045131,331972,497668,215491,1045131
2023-04-25 08:38,1045159,332000,497668,215491,1045159
2023-04-25 08:39,1045188,332027,497668,215493,1045188
2023-04-25 08:40,1045215,332053,497669,215493,1045215
2023-04-25 08:41,1045245,332080,497669,215496,1045245
2023-04-25 08:42,1045273,332105,497670,215498,1045273
2023-04-25 08:43,1045303,332134,497670,215499,1045303
2023-04-25 08:44,1045332,332162,497671,215499,1045332
2023-04-25 08:45,1045360,332190,497671,215499,1045360
2023-04-25 08:46,1045390,332217,497672,215501,1045390
2023-04-25 08:48,1045418,332243,497672,215503,1045418
2023-04-25 08:49,1045447,332271,497674,215502,1045447
2023-04-25 08:50,1045476,332301,497674,215501,1045476
2023-04-25 08:51,1045504,332325,497678,215501,1045504
2023-04-25 08:52,1045532,332353,497678,215501,1045532
2023-04-25 08:53,1045561,332380,497680,215501,1045561
2023-04-25 08:54,1045589,332407,497680,215502,1045589
2023-04-25 08:55,1045616,332431,497679,215506,1045616
2023-04-25 08:56,1045643,332458,497679,215506,1045643
2023-04-25 08:57,1045672,332483,497681,215508,1045672
2023-04-25 08:58,1045700,332511,497681,215508,1045700
2023-04-25 08:59,1045729,332539,497682,215508,1045729
2023-04-25 09:00,1045754,332561,497682,215511,1045754
2023-04-25 09:01,1045768,332575,497682,215511,1045768
2023-04-25 09:02,1045781,332588,497682,215511,1045781
2023-04-25 09:03,1045796,332597,497686,215513,1045796
2023-04-25 09:04,1045810,332611,497686,215513,1045810
2023-04-25 09:05,1045825,332621,497688,215516,1045825
2023-04-25 09:06,1045840,332636,497688,215516,1045840
2023-04-25 09:07,1045854,332645,497692,215517,1045854
2023-04-25 09:08,1045867,332658,497692,215517,1045867
2023-04-25 09:09,1045880,332668,497694,215518,1045880
2023-04-25 09:10,1045895,332680,497694,215521,1045895
2023-04-25 09:11,1045910,332693,497695,215522,1045910
2023-04-25 09:12,1045923,332706,497695,215522,1045923
2023-04-25 09:13,1045939,332720,497695,215524,1045939
2023-04-25 09:14,1045952,332727,497699,215526,1045952
2023-04-25 09:15,1045967,332742,497699,215526,1045967
2023-04-25 09:16,1045982,332756,497700,215526,1045982
2023-04-25 09:17,1045995,332768,497700,215527,1045995
2023-04-25 09:18,1046009,332778,497702,215529,1046009
2023-04-25 09:19,1046023,332791,497702,215530,1046023
2023-04-25 09:20,1046037,332804,497703,215530,1046037
2023-04-25 09:21,1046050,332817,497703,215530,1046050
2023-04-25 09:22,1046064,332826,497704,215534,1046064
2023-04-25 09:23,1046077,332838,497704,215535,1046077
2023-04-25 09:24,1046090,332842,497711,215537,1046090
2023-04-25 09:25,1046103,332854,497711,215538,1046103
2023-04-25 09:26,1046116,332867,497711,215538,1046116
2023-04-25 09:27,1046131,332881,497711,215539,1046131
2023-04-25 09:28,1046144,332891,497711,215542,1046144
2023-04-25 09:29,1046157,332903,497711,215543,1046157
2023-04-25 09:30,1046170,332913,497712,215545,1046170
2023-04-25 09:31,1046183,332924,497712,215547,1046183
2023-04-25 09:32,1046199,332938,497712,215549,1046199
2023-04-25 09:33,1046212,332950,497712,215550,1046212
2023-04-25 09:35,1046226,332960,497715,215551,1046226
2023-04-25 09:36,1046240,332971,497715,215554,1046240
2023-04-25 09:37,1046254,332981,497719,215554,1046254
2023-04-25 09:38,1046268,332993,497719,215556,1046268
2023-04-25 09:39,1046283,333002,497722,215559,1046283
2023-04-25 09:40,1046297,333015,497722,215560,1046297
2023-04-25 09:41,1046310,333027,497722,215561,1046310
2023-04-25 09:42,1046323,333040,497722,215561,1046323
2023-04-25 09:43,1046339,333054,497724,215561,1046339
2023-04-25 09:44,1046352,333067,497724,215561,1046352
2023-04-25 09:45,1046366,333078,497726,215562,1046366
2023-04-25 09:46,1046380,333090,497726,215564,1046380
2023-04-25 09:47,1046394,333102,497728,215564,1046394
2023-04-25 09:48,1046408,333115,497728,215565,1046408
2023-04-25 09:49,1046422,333125,497729,215568,1046422
2023-04-25 09:50,1046436,333138,497729,215569,1046436
2023-04-25 09:51,1046449,333148,497731,215570,1046449
2023-04-25 09:52,1046465,333163,497731,215571,1046465
2023-04-25 09:53,1046480,333177,497731,215572,1046480
2023-04-25 09:54,1046494,333190,497731,215573,1046494
2023-04-25 09:55,1046509,333199,497736,215574,1046509
2023-04-25 09:56,1046523,333211,497736,215576,1046523
2023-04-25 09:57,1046535,333218,497738,215579,1046535
2023-04-25 09:58,1046549,333227,497738,215584,1046549
2023-04-25 09:59,1046563,333239,497739,215585,1046563
2023-04-25 10:00,1046577,333252,497739,215586,1046577
2023-04-25 10:01,1046594,333267,497740,215587,1046594
2023-04-25 10:02,1046612,333285,497740,215587,1046612
2023-04-25 10:03,1046628,333298,497742,215588,1046628
2023-04-25 10:04,1046645,333313,497742,215590,1046645
2023-04-25 10:05,1046663,333329,497742,215592,1046663
2023-04-25 10:06,1046681,333346,497742,215593,1046681
2023-04-25 10:07,1046697,333361,497742,215594,1046697
2023-04-25 10:08,1046714,333373,497742,215599,1046714
2023-04-25 10:09,1046732,333388,497742,215602,1046732
2023-04-25 10:10,1046748,333401,497742,215605,1046748
2023-04-25 10:11,1046765,333417,497742,215606,1046765
2023-04-25 10:12,1046780,333423,497749,215608,1046780
2023-04-25 10:13,1046798,333442,497749,215607,1046798
2023-04-25 10:14,1046815,333457,497751,215607,1046815
2023-04-25 10:15,1046832,333474,497751,215607,1046832
2023-04-25 10:16,1046849,333486,497755,215608,1046849
2023-04-25 10:17,1046865,333501,497755,215609,1046865
2023-04-25 10:18,1046882,333515,497755,215612,1046882
2023-04-25 10:19,1046898,333528,497755,215615,1046898
2023-04-25 10:20,1046915,333544,497755,215616,1046915
2023-04-25 10:22,1046934,333563,497755,215616,1046934
2023-04-25 10:23,1046950,333576,497755,215619,1046950
2023-04-25 10:24,1046967,333590,497755,215622,1046967
2023-04-25 10:25,1046984,333602,497756,215626,1046984
2023-04-25 10:26,1047001,333618,497756,215627,1047001
2023-04-25 10:27,1047018,333629,497759,215630,1047018
2023-04-25 10:28,1047034,333643,497759,215632,1047034
2023-04-25 10:29,1047051,333655,497761,215635,1047051
2023-04-25 10:30,1047068,333670,497763,215635,1047068
2023-04-25 10:31,1047084,333683,497763,215638,1047084
2023-04-25 10:32,1047101,333697,497764,215640,1047101
2023-04-25 10:33,1047118,333714,497764,215640,1047118
2023-04-25 10:34,1047136,333731,497764,215641,1047136
2023-04-25 10:35,1047153,333743,497765,215645,1047153
2023-04-25 10:36,1047171,333760,497765,215646,1047171
2023-04-25 10:37,1047189,333773,497768,215648,1047189
2023-04-25 10:38,1047206,333789,497768,215649,1047206
2023-04-25 10:39,1047223,333801,497771,215651,1047223
2023-04-25 10:40,1047240,333815,497771,215654,1047240
2023-04-25 10:41,1047257,333829,497773,215655,1047257
2023-04-25 10:42,1047273,333843,497773,215657,1047273
2023-04-25 10:43,1047290,333858,497774,215658,1047290
2023-04-25 10:44,1047307,333875,497774,215658,1047307
2023-04-25 10:45,1047323,333889,497774,215660,1047323
2023-04-25 10:46,1047344,333909,497774,215661,1047344
2023-04-25 10:47,1047360,333922,497777,215661,1047360
2023-04-25 10:48,1047377,333936,497777,215664,1047377
2023-04-25 10:49,1047397,333954,497778,215665,1047397
2023-04-25 10:50,1047415,333970,497779,215666,1047415
2023-04-25 10:51,1047431,333986,497779,215666,1047431
2023-04-25 10:52,1047448,334002,497780,215666,1047448
2023-04-25 10:53,1047464,334017,497780,215667,1047464
2023-04-25 10:54,1047481,334031,497782,215668,1047481
2023-04-25 10:55,1047498,334045,497783,215670,1047498
2023-04-25 10:56,1047515,334057,497784,215674,1047515
2023-04-25 10:57,1047532,334074,497784,215674,1047532
2023-04-25 10:58,1050550,337090,497784,215676,1050550
2023-04-25 10:59,1050570,337108,497785,215677,1050570
2023-04-25 11:00,1050588,337126,497785,215677,1050588
2023-04-25 11:01,1050607,337143,497786,215678,1050607
2023-04-25 11:02,1050626,337161,497786,215679,1050626
2023-04-25 11:03,1050646,337176,497791,215679,1050646
2023-04-25 11:04,1050665,337194,497791,215680,1050665
2023-04-25 11:05,1050683,337204,497797,215682,1050683
2023-04-25 11:06,1050702,337221,497797,215684,1050702
2023-04-25 11:08,1050721,337235,497798,215688,1050721
2023-04-25 11:09,1050739,337252,497798,215689,1050739
2023-04-25 11:10,1050758,337270,497798,215690,1050758
2023-04-25 11:11,1050776,337287,497798,215691,1050776
2023-04-25 11:12,1050797,337306,497799,215692,1050797
2023-04-25 11:13,1050818,337324,497799,215695,1050818
2023-04-25 11:14,1050837,337337,497803,215697,1050837
2023-04-25 11:15,1050856,337356,497803,215697,1050856
2023-04-25 11:16,1050876,337372,497805,215699,1050876
2023-04-25 11:17,1050895,337390,497805,215700,1050895
2023-04-25 11:18,1050913,337399,497807,215707,1050913
2023-04-25 11:19,1050932,337414,497807,215711,1050932
2023-04-25 11:20,1050952,337428,497811,215713,1050952
2023-04-25 11:21,1050970,337443,497811,215716,1050970
2023-04-25 11:22,1050990,337461,497812,215717,1050990
2023-04-25 11:23,1051009,337477,497812,215720,1051009
2023-04-25 11:24,1051028,337493,497812,215723,1051028
2023-04-25 11:25,1051047,337511,497812,215724,1051047
2023-04-25 11:26,1051065,337522,497815,215728,1051065
2023-04-25 11:27,1051084,337538,497815,215731,1051084
2023-04-25 11:28,1051103,337553,497819,215731,1051103
2023-04-25 11:29,1051121,337570,497819,215732,1051121
2023-04-25 11:30,1051140,337587,497821,215732,1051140
2023-04-25 11:31,1051159,337604,497821,215734,1051159
2023-04-25 11:32,1051179,337621,497824,215734,1051179
2023-04-25 11:33,1051197,337636,497824,215737,1051197
2023-04-25 11:34,1051219,337653,497826,215740,1051219
2023-04-25 11:35,1051240,337674,497826,215740,1051240
2023-04-25 11:36,1051258,337688,497827,215743,1051258
2023-04-25 11:37,1051278,337707,497827,215744,1051278
2023-04-25 11:38,1051297,337724,497827,215746,1051297
2023-04-25 11:39,1051316,337740,497827,215749,1051316
2023-04-25 11:40,1051334,337752,497831,215751,1051334
2023-04-25 11:41,1051355,337770,497831,215754,1051355
2023-04-25 11:42,1051373,337779,497835,215759,1051373
2023-04-25 11:43,1051391,337797,497835,215759,1051391
2023-04-25 11:44,1051410,337815,497836,215759,1051410
2023-04-25 11:45,1051429,337834,497836,215759,1051429
2023-04-25 11:46,1051447,337847,497839,215761,1051447
2023-04-25 11:47,1051467,337867,497839,215761,1051467
2023-04-25 11:48,1051484,337883,497840,215761,1051484
2023-04-25 11:49,1051504,337901,497840,215763,1051504
2023-04-25 11:50,1051523,337915,497844,215764,1051523
2023-04-25 11:51,1051542,337933,497844,215765,1051542
2023-04-25 11:52,1051560,337947,497846,215767,1051560
2023-04-25 11:53,1051579,337964,497846,215769,1051579
2023-04-25 11:55,1051598,337977,497848,215773,1051598
2023-04-25 11:56,1051618,337994,497851,215773,1051618
2023-04-25 11:57,1051636,338011,497851,215774,1051636
2023-04-25 11:58,1051655,338025,497852,215778,1051655
2023-04-25 11:59,1051675,338045,497852,215778,1051675
2023-04-25 12:00,1051693,338058,497855,215780,1051693
2023-04-25 12:01,1051711,338071,497858,215782,1051711
2023-04-25 12:02,1051729,338088,497858,215783,1051729
2023-04-25 12:03,1051748,338102,497862,215784,1051748
2023-04-25 12:04,1051766,338120,497862,215784,1051766
2023-04-25 12:05,1051785,338135,497864,215786,1051785
2023-04-25 12:06,1051802,338152,497864,215786,1051802
2023-04-25 12:07,1051820,338163,497871,215786,1051820
2023-04-25 12:08,1051839,338179,497871,215789,1051839
2023-04-25 12:09,1051857,338195,497873,215789,1051857
2023-04-25 12:10,1051874,338208,497876,215790,1051874
2023-04-25 12:11,1051894,338224,497876,215794,1051894
2023-04-25 12:12,1051911,338238,497878,215795,1051911
2023-04-25 12:13,1051931,338259,497878,215794,1051931
2023-04-25 12:14,1051950,338277,497878,215795,1051950
2023-04-25 12:15,1051967,338288,497878,215801,1051967
2023-04-25 12:16,1051986,338305,497878,215803,1051986
2023-04-25 12:17,1052003,338322,497878,215803,1052003
2023-04-25 12:18,1052023,338341,497878,215804,1052023
2023-04-25 12:19,1052042,338360,497878,215804,1052042
2023-04-25 12:20,1052059,338375,497878,215806,1052059
2023-04-25 12:21,1052078,338394,497878,215806,1052078
2023-04-25 12:22,1052096,338393,497892,215811,1052096
2023-04-25 12:23,1052115,338410,497892,215813,1052115
2023-04-25 12:24,1052133,338419,497899,215815,1052133
2023-04-25 12:25,1052153,338439,497899,215815,1052153
2023-04-25 12:26,1052170,338452,497901,215817,1052170
2023-04-25 12:27,1052188,338468,497901,215819,1052188
2023-04-25 12:28,1052207,338487,497901,215819,1052207
2023-04-25 12:29,1052225,338502,497901,215822,1052225
2023-04-25 12:30,1052243,338519,497901,215823,1052243
2023-04-25 12:31,1052261,338537,497901,215823,1052261
2023-04-25 12:32,1052279,338554,497901,215824,1052279
2023-04-25 12:33,1052299,338574,497901,215824,1052299
2023-04-25 12:34,1052318,338590,497901,215827,1052318
2023-04-25 12:35,1052335,338605,497901,215829,1052335
2023-04-25 12:36,1052353,338601,497919,215833,1052353
2023-04-25 12:37,1052371,338617,497919,215835,1052371
2023-04-25 12:38,1052389,338628,497924,215837,1052389
2023-04-25 12:39,1052407,338645,497924,215838,1052407
2023-04-25 12:40,1052426,338658,497928,215840,1052426
2023-04-25 12:42,1052445,338674,497929,215842,1052445
2023-04-25 12:43,1052462,338691,497929,215842,1052462
2023-04-25 12:44,1052481,338706,497933,215842,1052481
2023-04-25 12:45,1052499,338722,497933,215844,1052499
2023-04-25 12:46,1052517,338733,497937,215847,1052517
2023-04-25 12:47,1052536,338747,497940,215849,1052536
2023-04-25 12:48,1052555,338765,497940,215850,1052555
2023-04-25 12:49,1052573,338776,497942,215855,1052573
2023-04-25 12:50,1052592,338792,497942,215858,1052592
2023-04-25 12:51,1052610,338807,497945,215858,1052610
2023-04-25 12:52,1052629,338824,497945,215860,1052629
2023-04-25 12:53,1052647,338834,497949,215864,1052647
2023-04-25 12:54,1052665,338848,497949,215868,1052665
2023-04-25 12:55,1052683,338859,497955,215869,1052683
2023-04-25 12:56,1052701,338872,497955,215874,1052701
2023-04-25 12:57,1052718,338884,497959,215875,1052718
2023-04-25 12:58,1052738,338904,497959,215875,1052738
2023-04-25 12:59,1052755,338918,497959,215878,1052755
2023-04-25 13:00,1052773,338936,497959,215878,1052773
2023-04-25 13:01,1052790,338948,497963,215879,1052790
2023-04-25 13:02,1052807,338964,497963,215880,1052807
2023-04-25 13:03,1052823,338977,497966,215880,1052823
2023-04-25 13:04,1052841,338994,497966,215881,1052841
2023-04-25 13:05,1052858,339005,497971,215882,1052858
2023-04-25 13:06,1052874,339014,497974,215886,1052874
2023-04-25 13:07,1052891,339030,497974,215887,1052891
2023-04-25 13:08,1052908,339040,497979,215889,1052908
2023-04-25 13:09,1052926,339056,497980,215890,1052926
2023-04-25 13:10,1052942,339069,497980,215893,1052942
2023-04-25 13:11,1052960,339080,497984,215896,1052960
2023-04-25 13:12,1052977,339097,497984,215896,1052977
2023-04-25 13:13,1052993,339109,497987,215897,1052993
2023-04-25 13:14,1053011,339125,497988,215898,1053011
2023-04-25 13:15,1053028,339142,497988,215898,1053028
2023-04-25 13:16,1053047,339158,497990,215899,1053047
2023-04-25 13:17,1053063,339174,497990,215899,1053063
2023-04-25 13:18,1053081,339189,497990,215902,1053081
2023-04-25 13:19,1053098,339204,497990,215904,1053098
2023-04-25 13:20,1053115,339217,497993,215905,1053115
2023-04-25 13:21,1053132,339233,497993,215906,1053132
2023-04-25 13:22,1053150,339248,497995,215907,1053150
2023-04-25 13:23,1053168,339265,497996,215907,1053168
2023-04-25 13:24,1053186,339279,497996,215911,1053186
2023-04-25 13:25,1053202,339295,497995,215912,1053202
2023-04-25 13:27,1053219,339311,497995,215913,1053219
2023-04-25 13:28,1053236,339326,497996,215914,1053236
2023-04-25 13:29,1053254,339344,497996,215914,1053254
2023-04-25 13:30,1053271,339356,498000,215915,1053271
2023-04-25 13:31,1053287,339370,498000,215917,1053287
2023-04-25 13:32,1053305,339382,498004,215919,1053305
2023-04-25 13:33,1053322,339398,498004,215920,1053322
2023-04-25 13:34,1053339,339412,498007,215920,1053339
2023-04-25 13:35,1053355,339425,498007,215923,1053355
2023-04-25 13:36,1053372,339442,498007,215923,1053372
2023-04-25 13:37,1053389,339460,498007,215922,1053389
2023-04-25 13:38,1053406,339475,498008,215923,1053406
2023-04-25 13:39,1053423,339491,498008,215924,1053423
2023-04-25 13:40,1053439,339503,498010,215926,1053439
2023-04-25 13:41,1053457,339520,498010,215927,1053457
2023-04-25 13:42,1053474,339533,498012,215929,1053474
2023-04-25 13:43,1053492,339551,498012,215929,1053492
2023-04-25 13:44,1053508,339566,498011,215931,1053508
2023-04-25 13:45,1053526,339581,498011,215934,1053526
2023-04-25 13:46,1053543,339592,498015,215936,1053543
2023-04-25 13:47,1053559,339607,498015,215937,1053559
2023-04-25 13:48,1053577,339622,498017,215938,1053577
2023-04-25 13:49,1053595,339638,498017,215940,1053595
2023-04-25 13:50,1053611,339651,498020,215940,1053611
2023-04-25 13:51,1053628,339666,498020,215942,1053628
2023-04-25 13:52,1053645,339680,498021,215944,1053645
2023-04-25 13:53,1053661,339695,498021,215945,1053661
2023-04-25 13:54,1053678,339709,498022,215947,1053678
2023-04-25 13:55,1053696,339726,498022,215948,1053696
2023-04-25 13:56,1053713,339741,498024,215948,1053713
2023-04-25 13:57,1053729,339755,498024,215950,1053729
2023-04-25 13:58,1053747,339771,498026,215950,1053747
2023-04-25 13:59,1053764,339785,498028,215951,1053764
2023-04-25 14:00,1053774,339792,498028,215954,1053774
2023-04-25 14:01,1053780,339796,498030,215954,1053780
2023-04-25 14:02,1053788,339802,498030,215956,1053788
2023-04-25 14:03,1053794,339806,498031,215957,1053794
2023-04-25 14:04,1053801,339813,498031,215957,1053801
2023-04-25 14:05,1053807,339818,498032,215957,1053807
2023-04-25 14:06,1053815,339823,498032,215960,1053815
2023-04-25 14:07,1053821,339827,498032,215962,1053821
2023-04-25 14:08,1053828,339832,498032,215964,1053828
2023-04-25 14:09,1053836,339838,498033,215965,1053836
2023-04-25 14:10,1053843,339845,498033,215965,1053843
2023-04-25 14:11,1053850,339848,498036,215966,1053850
2023-04-25 14:12,1053857,339854,498036,215967,1053857
2023-04-25 14:13,1053863,339850,498042,215971,1053863
2023-04-25 14:15,1053870,339855,498042,215973,1053870
2023-04-25 14:16,1053877,339859,498044,215974,1053877
2023-04-25 14:17,1053885,339866,498044,215975,1053885
2023-04-25 14:18,1053892,339872,498045,215975,1053892
2023-04-25 14:19,1053899,339879,498045,215975,1053899
2023-04-25 14:20,1053905,339885,498046,215974,1053905
2023-04-25 14:21,1053912,339892,498046,215974,1053912
2023-04-25 14:22,1053918,339895,498047,215976,1053918
2023-04-25 14:23,1053925,339901,498047,215977,1053925
2023-04-25 14:24,1053931,339904,498048,215979,1053931
2023-04-25 14:25,1053938,339911,498048,215979,1053938
2023-04-25 14:26,1053944,339912,498052,215980,1053944
2023-04-25 14:27,1053951,339915,498053,215983,1053951
2023-04-25 14:28,1053958,339919,498053,215986,1053958
2023-04-25 14:29,1053965,339923,498056,215986,1053965
2023-04-25 14:30,1053972,339928,498056,215988,1053972
2023-04-25 14:31,1053980,339931,498059,215990,1053980
2023-04-25 14:32,1053987,339937,498059,215991,1053987
2023-04-25 14:33,1053995,339945,498059,215991,1053995
2023-04-25 14:34,1054003,339953,498059,215991,1054003
2023-04-25 14:35,1054009,339959,498060,215990,1054009
2023-04-25 14:36,1054016,339966,498060,215990,1054016
2023-04-25 14:37,1054023,339970,498060,215993,1054023
2023-04-25 14:38,1054029,339975,498060,215994,1054029
2023-04-25 14:39,1054036,339979,498062,215995,1054036
2023-04-25 14:40,1054042,339981,498062,215999,1054042
2023-04-25 14:41,1054049,339986,498064,215999,1054049
2023-04-25 14:42,1054058,339994,498064,216000,1054058
2023-04-25 14:43,1054064,339995,498067,216002,1054064
2023-04-25 14:44,1054070,340001,498067,216002,1054070
2023-04-25 14:45,1054079,340005,498072,216002,1054079
2023-04-25 14:46,1054085,340007,498074,216004,1054085
2023-04-25 14:47,1054092,340012,498074,216006,1054092
2023-04-25 14:48,1054100,340015,498078,216007,1054100
2023-04-25 14:49,1054107,340021,498078,216008,1054107
2023-04-25 14:50,1054114,340023,498082,216009,1054114
2023-04-25 14:51,1054120,340028,498082,216010,1054120
2023-04-25 14:52,1054126,340031,498083,216012,1054126
2023-04-25 14:53,1054133,340037,498083,216013,1054133
2023-04-25 14:54,1054141,340043,498085,216013,1054141
2023-04-25 14:55,1054147,340048,498085,216014,1054147
2023-04-25 14:56,1054153,340053,498085,216015,1054153
2023-04-25 14:57,1054161,340058,498085,216018,1054161
2023-04-25 14:58,1054168,340064,498085,216019,1054168
2023-04-25 15:00,1054174,340067,498085,216022,1054174
2023-04-25 15:01,1054200,340088,498089,216023,1054200
2023-04-25 15:02,1054226,340114,498089,216023,1054226
2023-04-25 15:03,1054253,340134,498090,216029,1054253
2023-04-25 15:04,1054279,340159,498090,216030,1054279
2023-04-25 15:05,1054305,340185,498090,216030,1054305
2023-04-25 15:06,1054334,340213,498090,216031,1054334
2023-04-25 15:07,1054358,340230,498094,216034,1054358
2023-04-25 15:08,1054384,340252,498097,216035,1054384
2023-04-25 15:09,1054412,340280,498097,216035,1054412
2023-04-25 15:10,1054440,340304,498099,216037,1054440
2023-04-25 15:11,1054466,340327,498099,216040,1054466
2023-04-25 15:12,1054493,340354,498099,216040,1054493
2023-04-25 15:13,1054519,340379,498099,216041,1054519
2023-04-25 15:14,1054545,340403,498100,216042,1054545
2023-04-25 15:15,1054570,340426,498100,216044,1054570
2023-04-25 15:16,1054597,340453,498099,216045,1054597
2023-04-25 15:17,1054624,340479,498099,216046,1054624
2023-04-25 15:18,1054650,340499,498100,216051,1054650
2023-04-25 15:19,1054676,340522,498100,216054,1054676
2023-04-25 15:20,1054702,340544,498102,216056,1054702
2023-04-25 15:21,1054729,340569,498102,216058,1054729
2023-04-25 15:22,1054758,340592,498105,216061,1054758
2023-04-25 15:23,1054783,340615,498105,216063,1054783
2023-04-25 15:24,1054809,340637,498106,216066,1054809
2023-04-25 15:25,1054837,340664,498106,216067,1054837
2023-04-25 15:26,1054863,340685,498110,216068,1054863
2023-04-25 15:27,1054889,340707,498111,216071,1054889
2023-04-25 15:28,1054917,340733,498111,216073,1054917
2023-04-25 15:29,1054942,340755,498115,216072,1054942
2023-04-25 15:30,1054969,340781,498115,216073,1054969
2023-04-25 15:31,1054995,340805,498115,216075,1054995
2023-04-25 15:32,1055022,340831,498115,216076,1055022
2023-04-25 15:33,1055049,340855,498118,216076,1055049
2023-04-25 15:34,1055075,340880,498118,216077,1055075
2023-04-25 15:37,1055103,340904,498119,216080,1055103
2023-04-25 15:38,1055164,340962,498122,216080,1055164
2023-04-25 15:39,1055190,340986,498122,216082,1055190
2023-04-25 15:41,1055217,341003,498130,216084,1055217
2023-04-25 15:42,1055282,341065,498130,216087,1055282
2023-04-25 15:43,1055308,341087,498133,216088,1055308
2023-04-25 15:46,1055333,341106,498134,216093,1055333
2023-04-25 15:47,1055404,341176,498134,216094,1055404
2023-04-25 15:48,1055432,341201,498136,216095,1055432
2023-04-25 15:50,1055458,341222,498136,216100,1055458
2023-04-25 15:51,1055503,341263,498138,216102,1055503
2023-04-25 15:52,1055529,341289,498138,216102,1055529
2023-04-25 15:53,1055559,341318,498138,216103,1055559
2023-04-25 15:54,1055584,341342,498139,216103,1055584
2023-04-25 15:55,1055611,341369,498139,216103,1055611
2023-04-25 15:56,1055636,341389,498141,216106,1055636
2023-04-25 15:57,1055664,341415,498141,216108,1055664
2023-04-25 15:58,1055690,341440,498141,216109,1055690
2023-04-25 15:59,1055716,341465,498141,216110,1055716
2023-04-25 16:00,1055736,341481,498144,216111,1055736
2023-04-25 16:01,1055744,341487,498144,216113,1055744
2023-04-25 16:02,1055754,341493,498145,216116,1055754
2023-04-25 16:03,1055763,341500,498145,216118,1055763
2023-04-25 16:04,1055774,341509,498147,216118,1055774
2023-04-25 16:05,1055784,341518,498147,216119,1055784
2023-04-25 16:06,1055793,341522,498149,216122,1055793
2023-04-25 16:07,1055803,341531,498149,216123,1055803
2023-04-25 16:08,1055812,341536,498151,216125,1055812
2023-04-25 16:09,1055820,341543,498151,216126,1055820
2023-04-25 16:10,1055829,341541,498158,216130,1055829
2023-04-25 16:11,1055837,341548,498158,216131,1055837
2023-04-25 16:12,1055847,341557,498159,216131,1055847
2023-04-25 16:13,1055856,341566,498159,216131,1055856
2023-04-25 16:14,1055865,341571,498161,216133,1055865
2023-04-25 16:15,1055873,341579,498161,216133,1055873
2023-04-25 16:16,1055881,341584,498164,216133,1055881
2023-04-25 16:17,1055891,341592,498164,216135,1055891
2023-04-25 16:18,1055901,341598,498168,216135,1055901
2023-04-25 16:19,1055910,341606,498168,216136,1055910
2023-04-25 16:20,1055919,341614,498169,216136,1055919
2023-04-25 16:21,1055927,341620,498169,216138,1055927
2023-04-25 16:22,1055936,341628,498171,216137,1055936
2023-04-25 16:23,1055945,341634,498171,216140,1055945
2023-04-25 16:24,1055953,341641,498171,216141,1055953
2023-04-25 16:25,1055962,341649,498171,216142,1055962
2023-04-25 16:27,1055970,341657,498171,216142,1055970
2023-04-25 16:28,1055979,341665,498171,216143,1055979
2023-04-25 16:29,1055988,341672,498171,216145,1055988
2023-04-25 16:30,1055997,341680,498171,216146,1055997
2023-04-25 16:31,1056005,341684,498171,216150,1056005
2023-04-25 16:32,1056015,341693,498171,216151,1056015
2023-04-25 16:33,1056024,341684,498186,216154,1056024
2023-04-25 16:34,1056032,341691,498186,216155,1056032
2023-04-25 16:35,1056041,341696,498186,216159,1056041
2023-04-25 16:36,1056050,341705,498186,216159,1056050
2023-04-25 16:37,1056060,341713,498186,216161,1056060
2023-04-25 16:38,1056068,341719,498186,216163,1056068
2023-04-25 16:39,1056077,341727,498186,216164,1056077
2023-04-25 16:40,1056086,341735,498186,216165,1056086
2023-04-25 16:41,1056095,341743,498186,216166,1056095
2023-04-25 16:42,1056104,341751,498186,216167,1056104
2023-04-25 16:43,1056112,341746,498199,216167,1056112
2023-04-25 16:44,1056121,341754,498199,216168,1056121
2023-04-25 16:45,1056130,341761,498199,216170,1056130
2023-04-25 16:46,1056139,341768,498199,216172,1056139
2023-04-25 16:47,1056147,341775,498199,216173,1056147
2023-04-25 16:48,1056156,341780,498199,216177,1056156
2023-04-25 16:49,1056166,341790,498199,216177,1056166
2023-04-25 16:50,1056174,341797,498199,216178,1056174
2023-04-25 16:51,1056183,341806,498199,216178,1056183
2023-04-25 16:52,1056191,341813,498199,216179,1056191
2023-04-25 16:53,1056201,341812,498206,216183,1056201
2023-04-25 16:54,1056210,341821,498206,216183,1056210
2023-04-25 16:55,1056219,341830,498206,216183,1056219
2023-04-25 16:56,1056227,341836,498206,216185,1056227
2023-04-25 16:57,1056237,341844,498206,216187,1056237
2023-04-25 16:58,1056246,341852,498206,216188,1056246
2023-04-25 16:59,1056256,341860,498206,216190,1056256
2023-04-25 17:00,1056267,341869,498206,216192,1056267
2023-04-25 17:01,1056280,341879,498206,216195,1056280
2023-04-25 17:02,1056294,341893,498206,216195,1056294
2023-04-25 17:03,1056307,341893,498219,216195,1056307
2023-04-25 17:04,1056319,341903,498219,216197,1056319
2023-04-25 17:05,1056332,341915,498219,216198,1056332
2023-04-25 17:06,1056345,341928,498219,216198,1056345
2023-04-25 17:07,1056359,341941,498219,216199,1056359
2023-04-25 17:08,1056372,341954,498219,216199,1056372
2023-04-25 17:09,1056384,341964,498219,216201,1056384
2023-04-25 17:10,1056397,341976,498219,216202,1056397
2023-04-25 17:11,1056410,341989,498219,216202,1056410
2023-04-25 17:12,1056424,342001,498219,216204,1056424
2023-04-25 17:14,1056438,341998,498233,216207,1056438
2023-04-25 17:15,1056451,342009,498233,216209,1056451
2023-04-25 17:16,1056464,342021,498233,216210,1056464
2023-04-25 17:17,1056478,342035,498233,216210,1056478
2023-04-25 17:18,1056490,342046,498233,216211,1056490
2023-04-25 17:19,1056503,342058,498233,216212,1056503
2023-04-25 17:20,1056516,342069,498233,216214,1056516
2023-04-25 17:21,1056530,342082,498233,216215,1056530
2023-04-25 17:22,1056542,342094,498233,216215,1056542
2023-04-25 17:23,1056555,342092,498246,216217,1056555
2023-04-25 17:24,1056569,342106,498246,216217,1056569
2023-04-25 17:25,1056582,342119,498246,216217,1056582
2023-04-25 17:26,1056593,342130,498246,216217,1056593
2023-04-25 17:27,1056606,342142,498246,216218,1056606
2023-04-25 17:28,1056619,342155,498246,216218,1056619
2023-04-25 17:29,1056633,342167,498246,216220,1056633
2023-04-25 17:30,1056645,342165,498259,216221,1056645
2023-04-25 17:31,1056658,342178,498259,216221,1056658
2023-04-25 17:32,1056671,342188,498262,216221,1056671
2023-04-25 17:33,1056683,342197,498262,216224,1056683
2023-04-25 17:34,1056696,342208,498264,216224,1056696
2023-04-25 17:35,1056710,342220,498264,216226,1056710
2023-04-25 17:36,1056722,342229,498266,216227,1056722
2023-04-25 17:37,1056736,342242,498266,216228,1056736
2023-04-25 17:38,1056750,342250,498271,216229,1056750
2023-04-25 17:39,1056763,342260,498271,216232,1056763
2023-04-25 17:40,1056776,342269,498272,216235,1056776
2023-04-25 17:41,1056789,342282,498272,216235,1056789
2023-04-25 17:42,1056802,342291,498275,216236,1056802
2023-04-25 17:43,1056815,342303,498275,216237,1056815
2023-04-25 17:44,1056829,342313,498279,216237,1056829
2023-04-25 17:45,1056842,342324,498280,216238,1056842
2023-04-25 17:46,1056856,342337,498280,216239,1056856
2023-04-25 17:47,1056869,342349,498281,216239,1056869
2023-04-25 17:48,1056883,342363,498281,216239,1056883
2023-04-25 17:49,1056895,342372,498284,216239,1056895
2023-04-25 17:50,1056908,342383,498286,216239,1056908
2023-04-25 17:51,1056922,342397,498286,216239,1056922
2023-04-25 17:52,1056936,342406,498290,216240,1056936
2023-04-25 17:53,1056950,342416,498290,216244,1056950
2023-04-25 17:54,1056964,342425,498294,216245,1056964
2023-04-25 17:55,1056977,342437,498294,216246,1056977
2023-04-25 17:56,1056991,342451,498294,216246,1056991
2023-04-25 17:57,1057004,342463,498294,216247,1057004
2023-04-25 17:58,1057017,342474,498295,216248,1057017
2023-04-25 18:00,1057030,342484,498295,216251,1057030
2023-04-25 18:01,1057049,342498,498299,216252,1057049
2023-04-25 18:02,1057069,342516,498299,216254,1057069
2023-04-25 18:03,1057088,342527,498306,216255,1057088
2023-04-25 18:04,1057108,342546,498306,216256,1057108
2023-04-25 18:05,1057129,342560,498310,216259,1057129
2023-04-25 18:06,1057150,342579,498311,216260,1057150
2023-04-25 18:07,1057169,342598,498311,216260,1057169
2023-04-25 18:08,1057188,342611,498314,216263,1057188
2023-04-25 18:09,1057209,342631,498314,216264,1057209
2023-04-25 18:10,1057227,342646,498317,216264,1057227
2023-04-25 18:11,1057246,342665,498317,216264,1057246
2023-04-25 18:12,1057266,342679,498320,216267,1057266
2023-04-25 18:13,1057286,342694,498322,216270,1057286
2023-04-25 18:14,1057305,342713,498322,216270,1057305
2023-04-25 18:15,1057324,342727,498324,216273,1057324
2023-04-25 18:16,1057344,342744,498324,216276,1057344
2023-04-25 18:17,1057370,342763,498330,216277,1057370
2023-04-25 18:18,1057392,342785,498330,216277,1057392
2023-04-25 18:19,1057410,342800,498332,216278,1057410
2023-04-25 18:20,1057429,342818,498332,216279,1057429
2023-04-25 18:21,1057449,342834,498334,216281,1057449
2023-04-25 18:22,1057469,342852,498334,216283,1057469
2023-04-25 18:23,1057488,342870,498335,216283,1057488
2023-04-25 18:24,1057507,342889,498335,216283,1057507
2023-04-25 18:25,1057528,342905,498339,216284,1057528
2023-04-25 18:26,1057546,342923,498339,216284,1057546
2023-04-25 18:27,1057566,342941,498339,216286,1057566
2023-04-25 18:28,1057585,342955,498344,216286,1057585
2023-04-25 18:29,1057605,342972,498347,216286,1057605
2023-04-25 18:31,1057625,342991,498347,216287,1057625
2023-04-25 18:32,1057644,343004,498352,216288,1057644
2023-04-25 18:33,1057663,343022,498352,216289,1057663
2023-04-25 18:34,1057682,343034,498354,216294,1057682
2023-04-25 18:35,1057702,343053,498354,216295,1057702
2023-04-25 18:36,1057721,343070,498356,216295,1057721
2023-04-25 18:37,1057742,343089,498356,216297,1057742
2023-04-25 18:38,1057762,343104,498359,216299,1057762
2023-04-25 18:39,1057782,343124,498359,216299,1057782
2023-04-25 18:40,1057801,343137,498364,216300,1057801
2023-04-25 18:41,1057821,343156,498364,216301,1057821
2023-04-25 18:42,1057839,343171,498367,216301,1057839
2023-04-25 18:43,1057860,343188,498367,216305,1057860
2023-04-25 18:44,1057878,343203,498370,216305,1057878
2023-04-25 18:45,1057899,343223,498370,216306,1057899
2023-04-25 18:46,1057917,343239,498371,216307,1057917
2023-04-25 18:47,1057937,343259,498371,216307,1057937
2023-04-25 18:48,1057956,343273,498374,216309,1057956
2023-04-25 18:49,1057975,343291,498374,216310,1057975
2023-04-25 18:50,1057994,343304,498378,216312,1057994
2023-04-25 18:51,1058013,343322,498378,216313,1058013
2023-04-25 18:52,1058033,343335,498383,216315,1058033
2023-04-25 18:53,1058051,343348,498383,216320,1058051
2023-04-25 18:54,1058071,343363,498384,216324,1058071
2023-04-25 18:55,1058092,343383,498384,216325,1058092
2023-04-25 18:56,1058112,343401,498385,216326,1058112
2023-04-25 18:57,1058131,343420,498385,216326,1058131
2023-04-25 18:58,1058151,343436,498388,216327,1058151
2023-04-25 18:59,1058171,343454,498388,216329,1058171
2023-04-25 19:00,1058184,343460,498393,216331,1058184
2023-04-25 19:01,1058192,343466,498393,216333,1058192
2023-04-25 19:02,1058201,343471,498396,216334,1058201
2023-04-25 19:03,1058208,343476,498396,216336,1058208
2023-04-25 19:04,1058216,343475,498398,216343,1058216
2023-04-25 19:05,1058223,343479,498398,216346,1058223
2023-04-25 19:06,1058233,343485,498401,216347,1058233
2023-04-25 19:07,1058242,343492,498401,216349,1058242
2023-04-25 19:08,1058249,343497,498403,216349,1058249
2023-04-25 19:09,1058258,343504,498404,216350,1058258
2023-04-25 19:10,1058267,343510,498404,216353,1058267
2023-04-25 19:11,1058277,343517,498407,216353,1058277
2023-04-25 19:12,1058284,343523,498407,216354,1058284
2023-04-25 19:13,1058291,343525,498409,216357,1058291
2023-04-25 19:14,1058301,343534,498409,216358,1058301
2023-04-25 19:15,1058310,343539,498411,216360,1058310
2023-04-25 19:17,1058317,343544,498411,216362,1058317
2023-04-25 19:18,1058326,343547,498417,216362,1058326
2023-04-25 19:19,1058334,343553,498417,216364,1058334
2023-04-25 19:20,1058341,343553,498423,216365,1058341
2023-04-25 19:21,1058350,343559,498424,216367,1058350
2023-04-25 19:22,1058357,343561,498426,216370,1058357
2023-04-25 19:23,1058365,343567,498428,216370,1058365
2023-04-25 19:24,1058373,343574,498428,216371,1058373
2023-04-25 19:25,1058381,343580,498430,216371,1058381
2023-04-25 19:26,1058388,343586,498430,216372,1058388
2023-04-25 19:27,1058396,343593,498431,216372,1058396
2023-04-25 19:28,1058403,343599,498431,216373,1058403
2023-04-25 19:29,1058410,343599,498434,216377,1058410
2023-04-25 19:30,1058418,343607,498434,216377,1058418
2023-04-25 19:31,1058425,343613,498435,216377,1058425
2023-04-25 19:32,1058433,343617,498435,216381,1058433
2023-04-25 19:33,1058440,343618,498439,216383,1058440
2023-04-25 19:34,1058448,343626,498439,216383,1058448
2023-04-25 19:35,1058455,343632,498439,216384,1058455
2023-04-25 19:36,1058463,343639,498439,216385,1058463
2023-04-25 19:37,1058472,343638,498445,216389,1058472
2023-04-25 19:38,1058481,343645,498445,216391,1058481
2023-04-25 19:39,1058488,343651,498446,216391,1058488
2023-04-25 19:40,1058496,343659,498446,216391,1058496
2023-04-25 19:41,1058503,343663,498449,216391,1058503
2023-04-25 19:42,1058510,343668,498451,216391,1058510
2023-04-25 19:43,1058518,343672,498454,216392,1058518
2023-04-25 19:44,1058526,343680,498454,216392,1058526
2023-04-25 19:45,1058537,343689,498454,216394,1058537
2023-04-25 19:46,1058547,343697,498454,216396,1058547
2023-04-25 19:47,1058554,343701,498454,216399,1058554
2023-04-25 19:48,1058562,343696,498466,216400,1058562
2023-04-25 19:49,1058570,343701,498466,216403,1058570
2023-04-25 19:50,1058577,343704,498468,216405,1058577
2023-04-25 19:51,1058585,343711,498468,216406,1058585
2023-04-25 19:52,1058593,343719,498468,216406,1058593
2023-04-25 19:53,1058600,343722,498469,216409,1058600
2023-04-25 19:54,1058608,343730,498469,216409,1058608
2023-04-25 19:55,1058617,343737,498469,216411,1058617
2023-04-25 19:56,1058624,343742,498469,216413,1058624
2023-04-25 19:57,1058632,343750,498469,216413,1058632
2023-04-25 19:58,1058639,343755,498469,216415,1058639
2023-04-25 19:59,1058646,343758,498469,216419,1058646
2023-04-25 20:00,1058658,343769,498469,216420,1058658
2023-04-25 20:01,1058670,343781,498469,216420,1058670
2023-04-25 20:03,1058682,343792,498469,216421,1058682
2023-04-25 20:04,1058694,343790,498481,216423,1058694
2023-04-25 20:05,1058704,343798,498481,216425,1058704
2023-04-25 20:06,1058715,343804,498484,216427,1058715
2023-04-25 20:07,1058728,343817,498484,216427,1058728
2023-04-25 20:08,1058738,343824,498486,216428,1058738
2023-04-25 20:09,1058749,343834,498486,216429,1058749
2023-04-25 20:10,1058760,343843,498487,216430,1058760
2023-04-25 20:11,1058771,343851,498487,216433,1058771
2023-04-25 20:12,1058783,343857,498490,216436,1058783
2023-04-25 20:13,1058794,343867,498490,216437,1058794
2023-04-25 20:14,1058805,343875,498492,216438,1058805
2023-04-25 20:15,1058816,343886,498492,216438,1058816
2023-04-25 20:16,1058829,343896,498494,216439,1058829
2023-04-25 20:17,1058840,343907,498494,216439,1058840
2023-04-25 20:18,1058851,343915,498497,216439,1058851
2023-04-25 20:19,1058862,343925,498498,216439,1058862
2023-04-25 20:20,1058874,343936,498498,216440,1058874
2023-04-25 20:21,1058885,343943,498501,216441,1058885
2023-04-25 20:22,1058896,343949,498503,216444,1058896
2023-04-25 20:23,1058909,343960,498503,216446,1058909
2023-04-25 20:24,1058920,343963,498509,216448,1058920
2023-04-25 20:25,1058931,343972,498509,216450,1058931
2023-04-25 20:26,1058942,343973,498516,216453,1058942
2023-04-25 20:27,1058952,343982,498516,216454,1058952
2023-04-25 20:28,1058964,343989,498519,216456,1058964
2023-04-25 20:29,1058975,343997,498519,216459,1058975
2023-04-25 20:30,1058987,344006,498521,216460,1058987
2023-04-25 20:31,1058997,344012,498521,216464,1058997
2023-04-25 20:32,1059008,344018,498523,216467,1059008
2023-04-25 20:33,1059020,344029,498523,216468,1059020
2023-04-25 20:34,1059031,344038,498524,216469,1059031
2023-04-25 20:35,1059043,344047,498524,216472,1059043
2023-04-25 20:36,1059054,344054,498527,216473,1059054
2023-04-25 20:37,1059065,344064,498528,216473,1059065
2023-04-25 20:38,1059076,344073,498528,216475,1059076
2023-04-25 20:39,1059088,344084,498528,216476,1059088
2023-04-25 20:40,1059099,344085,498533,216481,1059099
2023-04-25 20:41,1059110,344096,498533,216481,1059110
2023-04-25 20:42,1059122,344102,498537,216483,1059122
2023-04-25 20:43,1059134,344112,498537,216485,1059134
2023-04-25 20:44,1059145,344117,498543,216485,1059145
2023-04-25 20:45,1059157,344126,498543,216488,1059157
2023-04-25 20:46,1059169,344132,498549,216488,1059169
2023-04-25 20:47,1059183,344145,498549,216489,1059183
2023-04-25 20:48,1059195,344143,498558,216494,1059195
2023-04-25 20:50,1059207,344151,498559,216497,1059207
2023-04-25 20:51,1059220,344162,498559,216499,1059220
2023-04-25 20:52,1059231,344171,498561,216499,1059231
2023-04-25 20:53,1059241,344180,498561,216500,1059241
2023-04-25 20:54,1059253,344192,498563,216498,1059253
2023-04-25 20:55,1059264,344202,498563,216499,1059264
2023-04-25 20:56,1059274,344207,498566,216501,1059274
2023-04-25 20:57,1059285,344215,498567,216503,1059285
2023-04-25 20:58,1059296,344226,498567,216503,1059296
2023-04-25 20:59,1059309,344236,498567,216506,1059309
2023-04-25 21:00,1059324,344245,498569,216510,1059324
2023-04-25 21:01,1059352,344272,498569,216511,1059352
2023-04-25 21:02,1059380,344295,498572,216513,1059380
2023-04-25 21:03,1059408,344321,498572,216515,1059408
2023-04-25 21:04,1059437,344349,498573,216515,1059437
2023-04-25 21:05,1059467,344378,498573,216516,1059467
2023-04-25 21:06,1059494,344400,498575,216519,1059494
2023-04-25 21:07,1059522,344428,498575,216519,1059522
2023-04-25 21:08,1059551,344456,498576,216519,1059551
2023-04-25 21:09,1059578,344481,498576,216521,1059578
2023-04-25 21:10,1059608,344506,498579,216523,1059608
2023-04-25 21:11,1059635,344531,498579,216525,1059635
2023-04-25 21:12,1059664,344557,498580,216527,1059664
2023-04-25 21:13,1059691,344583,498580,216528,1059691
2023-04-25 21:14,1059719,344603,498585,216531,1059719
2023-04-25 21:15,1059748,344630,498585,216533,1059748
2023-04-25 21:16,1059777,344655,498587,216535,1059777
2023-04-25 21:17,1059804,344680,498587,216537,1059804
2023-04-25 21:18,1059832,344698,498593,216541,1059832
2023-04-25 21:19,1059861,344724,498593,216544,1059861
2023-04-25 21:20,1059888,344747,498594,216547,1059888
2023-04-25 21:21,1059917,344777,498594,216546,1059917
2023-04-25 21:22,1059945,344803,498595,216547,1059945
2023-04-25 21:23,1059974,344831,498595,216548,1059974
2023-04-25 21:24,1060002,344850,498601,216551,1060002
2023-04-25 21:25,1060030,344876,498601,216553,1060030
2023-04-25 21:26,1060057,344902,498602,216553,1060057
2023-04-25 21:27,1060086,344923,498605,216558,1060086
2023-04-25 21:28,1060114,344946,498605,216563,1060114
2023-04-25 21:29,1060143,344970,498607,216566,1060143
2023-04-25 21:30,1060169,344993,498607,216569,1060169
2023-04-25 21:31,1060198,345017,498609,216572,1060198
2023-04-25 21:32,1060229,345046,498609,216574,1060229
2023-04-25 21:33,1060257,345067,498613,216577,1060257
2023-04-25 21:34,1060285,345090,498613,216582,1060285
2023-04-25 21:36,1060314,345116,498616,216582,1060314
2023-04-25 21:37,1060341,345143,498616,216582,1060341
2023-04-25 21:38,1060370,345163,498623,216584,1060370
2023-04-25 21:39,1060399,345189,498625,216585,1060399
2023-04-25 21:40,1060428,345218,498625,216585,1060428
2023-04-25 21:41,1060456,345240,498627,216589,1060456
2023-04-25 21:42,1060485,345267,498627,216591,1060485
2023-04-25 21:43,1060514,345289,498633,216592,1060514
2023-04-25 21:44,1060541,345313,498633,216595,1060541
2023-04-25 21:45,1060569,345336,498636,216597,1060569
2023-04-25 21:46,1060597,345362,498637,216598,1060597
2023-04-25 21:47,1060625,345389,498637,216599,1060625
2023-04-25 21:48,1060653,345415,498637,216601,1060653
2023-04-25 21:49,1060682,345440,498637,216605,1060682
2023-04-25 21:50,1060710,345461,498641,216608,1060710
2023-04-25 21:51,1060738,345486,498644,216608,1060738
2023-04-25 21:52,1060765,345513,498644,216608,1060765
2023-04-25 21:53,1060796,345537,498648,216611,1060796
2023-04-25 21:54,1060824,345563,498648,216613,1060824
2023-04-25 21:55,1060851,345583,498652,216616,1060851
2023-04-25 21:56,1060880,345612,498652,216616,1060880
2023-04-25 21:57,1060908,345640,498651,216617,1060908
2023-04-25 21:58,1060937,345669,498651,216617,1060937
2023-04-25 21:59,1060964,345690,498655,216619,1060964
2023-04-25 22:00,1060991,345715,498655,216621,1060991
2023-04-25 22:01,1061015,345731,498657,216627,1061015
2023-04-25 22:02,1061039,345754,498657,216628,1061039
2023-04-25 22:03,1061063,345774,498659,216630,1061063
2023-04-25 22:04,1061086,345793,498659,216634,1061086
2023-04-25 22:05,1061111,345813,498662,216636,1061111
2023-04-25 22:06,1061135,345835,498663,216637,1061135
2023-04-25 22:07,1061158,345853,498663,216642,1061158
2023-04-25 22:08,1061184,345870,498669,216645,1061184
2023-04-25 22:09,1061207,345891,498669,216647,1061207
2023-04-25 22:10,1061231,345913,498671,216647,1061231
2023-04-25 22:11,1061256,345936,498671,216649,1061256
2023-04-25 22:12,1061280,345952,498674,216654,1061280
2023-04-25 22:13,1061302,345972,498674,216656,1061302
2023-04-25 22:14,1061326,345990,498678,216658,1061326
2023-04-25 22:15,1061351,346014,498678,216659,1061351
2023-04-25 22:16,1061376,346030,498684,216662,1061376
2023-04-25 22:17,1061399,346051,498684,216664,1061399
2023-04-25 22:18,1061423,346068,498689,216666,1061423
2023-04-25 22:19,1061446,346086,498689,216671,1061446
2023-04-25 22:20,1061471,346106,498694,216671,1061471
2023-04-25 22:21,1061495,346128,498694,216673,1061495
2023-04-25 22:23,1061518,346147,498698,216673,1061518
2023-04-25 22:24,1061542,346167,498700,216675,1061542
2023-04-25 22:25,1061566,346189,498700,216677,1061566
2023-04-25 22:26,1061591,346212,498700,216679,1061591
2023-04-25 22:27,1061614,346233,498700,216681,1061614
2023-04-25 22:28,1061639,346250,498700,216689,1061639
2023-04-25 22:29,1061662,346271,498700,216691,1061662
2023-04-25 22:30,1061686,346279,498713,216694,1061686
2023-04-25 22:31,1061709,346298,498713,216698,1061709
2023-04-25 22:32,1061733,346316,498717,216700,1061733
2023-04-25 22:33,1061757,346336,498717,216704,1061757
2023-04-25 22:34,1061783,346354,498720,216709,1061783
2023-04-25 22:35,1061805,346374,498720,216711,1061805
2023-04-25 22:36,1061829,346392,498724,216713,1061829
2023-04-25 22:37,1061853,346414,498724,216715,1061853
2023-04-25 22:38,1061877,346433,498728,216716,1061877
2023-04-25 22:39,1061901,346455,498730,216716,1061901
2023-04-25 22:40,1061924,346470,498732,216722,1061924
2023-04-25 22:41,1061948,346489,498735,216724,1061948
2023-04-25 22:42,1061970,346506,498738,216726,1061970
2023-04-25 22:43,1061995,346529,498738,216728,1061995
2023-04-25 22:44,1062018,346547,498743,216728,1062018
2023-04-25 22:45,1062042,346564,498743,216735,1062042
2023-04-25 22:46,1062066,346576,498749,216741,1062066
2023-04-25 22:47,1062090,346597,498752,216741,1062090
2023-04-25 22:48,1062114,346615,498752,216747,1062114
2023-04-25 22:49,1062138,346630,498759,216749,1062138
2023-04-25 22:50,1062161,346650,498759,216752,1062161
2023-04-25 22:51,1062186,346667,498766,216753,1062186
2023-04-25 22:52,1062209,346685,498766,216758,1062209
2023-04-25 22:53,1062234,346707,498767,216760,1062234
2023-04-25 22:54,1062258,346731,498767,216760,1062258
2023-04-25 22:55,1062281,346748,498771,216762,1062281
2023-04-25 22:56,1062304,346767,498771,216766,1062304
2023-04-25 22:57,1062329,346789,498772,216768,1062329
2023-04-25 22:58,1062352,346812,498772,216768,1062352
2023-04-25 22:59,1062377,346834,498773,216770,1062377
2023-04-25 23:00,1062394,346850,498773,216771,1062394
2023-04-25 23:01,1062410,346865,498773,216772,1062410
2023-04-25 23:02,1062426,346881,498773,216772,1062426
2023-04-25 23:03,1062443,346895,498775,216773,1062443
2023-04-25 23:04,1062458,346907,498775,216776,1062458
2023-04-25 23:05,1062474,346916,498778,216780,1062474
2023-04-25 23:06,1062490,346930,498778,216782,1062490
2023-04-25 23:07,1062505,346944,498779,216782,1062505
2023-04-25 23:08,1062522,346959,498780,216783,1062522
2023-04-25 23:10,1062538,346973,498780,216785,1062538
2023-04-25 23:11,1062554,346984,498784,216786,1062554
2023-04-25 23:12,1062570,346997,498784,216789,1062570
2023-04-25 23:13,1062587,347011,498786,216790,1062587
2023-04-25 23:14,1062603,347022,498786,216795,1062603
2023-04-25 23:15,1062618,347034,498789,216795,1062618
2023-04-25 23:16,1062635,347048,498791,216796,1062635
2023-04-25 23:17,1062650,347060,498791,216799,1062650
2023-04-25 23:18,1062666,347069,498796,216801,1062666
2023-04-25 23:19,1062682,347083,498796,216803,1062682
2023-04-25 23:20,1062697,347088,498799,216810,1062697
2023-04-25 23:21,1062712,347103,498799,216810,1062712
2023-04-25 23:22,1062728,347111,498804,216813,1062728
2023-04-25 23:23,1062744,347124,498804,216816,1062744
2023-04-25 23:24,1062760,347134,498809,216817,1062760
2023-04-25 23:25,1062776,347145,498809,216822,1062776
2023-04-25 23:26,1062791,347158,498811,216822,1062791
2023-04-25 23:27,1062806,347172,498811,216823,1062806
2023-04-25 23:28,1062823,347187,498812,216824,1062823
2023-04-25 23:29,1062839,347200,498814,216825,1062839
2023-04-25 23:30,1062855,347216,498814,216825,1062855
2023-04-25 23:31,1062872,347228,498819,216825,1062872
2023-04-25 23:32,1062889,347244,498819,216826,1062889
2023-04-25 23:33,1062905,347254,498822,216829,1062905
2023-04-25 23:34,1062920,347268,498822,216830,1062920
2023-04-25 23:35,1062935,347280,498824,216831,1062935
2023-04-25 23:36,1062952,347289,498828,216835,1062952
2023-04-25 23:37,1062968,347303,498828,216837,1062968
2023-04-25 23:38,1062982,347313,498831,216838,1062982
2023-04-25 23:39,1063000,347327,498831,216842,1063000
2023-04-25 23:40,1063015,347339,498833,216843,1063015
2023-04-25 23:41,1063031,347354,498833,216844,1063031
2023-04-25 23:42,1063046,347365,498835,216846,1063046
2023-04-25 23:43,1063062,347376,498835,216851,1063062
2023-04-25 23:44,1063078,347386,498837,216855,1063078
2023-04-25 23:45,1063094,347399,498837,216858,1063094
2023-04-25 23:46,1063112,347410,498839,216863,1063112
2023-04-25 23:47,1063127,347424,498839,216864,1063127
2023-04-25 23:48,1063142,347429,498845,216868,1063142
2023-04-25 23:49,1063159,347444,498845,216870,1063159
2023-04-25 23:50,1063174,347454,498847,216873,1063174
2023-04-25 23:51,1063190,347470,498847,216873,1063190
2023-04-25 23:52,1063206,347483,498850,216873,1063206
2023-04-25 23:53,1063222,347499,498850,216873,1063222
2023-04-25 23:54,1063239,347513,498853,216873,1063239
2023-04-25 23:56,1063254,347527,498853,216874,1063254
2023-04-25 23:57,1063270,347538,498858,216874,1063270
2023-04-25 23:58,1063287,347554,498858,216875,1063287
2023-04-25 23:59,1063302,347564,498860,216878,1063302
2023-04-26 00:00,1063318,347580,498860,216878,1063318
2023-04-26 00:01,1063347,347603,498863,216881,1063347
2023-04-26 00:02,1063377,347627,498866,216884,1063377
2023-04-26 00:03,1063406,347653,498866,216887,1063406
2023-04-26 00:04,1063436,347679,498869,216888,1063436
2023-04-26 00:05,1063467,347710,498869,216888,1063467
2023-04-26 00:06,1063498,347737,498869,216892,1063498
2023-04-26 00:07,1063528,347763,498869,216896,1063528
2023-04-26 00:08,1063558,347791,498870,216897,1063558
2023-04-26 00:09,1063586,347819,498870,216897,1063586
2023-04-26 00:10,1063617,347843,498876,216898,1063617
2023-04-26 00:11,1063645,347872,498876,216897,1063645
2023-04-26 00:12,1063674,347896,498878,216900,1063674
2023-04-26 00:13,1063704,347926,498878,216900,1063704
2023-04-26 00:14,1063733,347947,498882,216904,1063733
2023-04-26 00:15,1063764,347977,498882,216905,1063764
2023-04-26 00:16,1063794,348004,498885,216905,1063794
2023-04-26 00:17,1063823,348029,498885,216909,1063823
2023-04-26 00:18,1063853,348055,498887,216911,1063853
2023-04-26 00:19,1063883,348082,498887,216914,1063883
2023-04-26 00:20,1063914,348110,498889,216915,1063914
2023-04-26 00:21,1063941,348137,498889,216915,1063941
2023-04-26 00:22,1063973,348165,498891,216917,1063973
2023-04-26 00:23,1064003,348194,498891,216918,1064003
2023-04-26 00:24,1064034,348221,498893,216920,1064034
2023-04-26 00:25,1064064,348249,498893,216922,1064064
2023-04-26 00:26,1064091,348274,498894,216923,1064091
2023-04-26 00:27,1064122,348304,498894,216924,1064122
2023-04-26 00:28,1064150,348328,498896,216926,1064150
2023-04-26 00:29,1064180,348358,498896,216926,1064180
2023-04-26 00:30,1064209,348382,498900,216927,1064209
2023-04-26 00:31,1064239,348410,498900,216929,1064239
2023-04-26 00:32,1064269,348439,498901,216929,1064269
2023-04-26 00:33,1064298,348465,498902,216931,1064298
2023-04-26 00:34,1064328,348492,498902,216934,1064328
2023-04-26 00:35,1064357,348521,498902,216934,1064357
2023-04-26 00:36,1064387,348546,498904,216937,1064387
2023-04-26 00:37,1064416,348575,498904,216937,1064416
2023-04-26 00:38,1064447,348605,498904,216938,1064447
2023-04-26 00:39,1064476,348634,498904,216938,1064476
2023-04-26 00:40,1064505,348663,498904,216938,1064505
2023-04-26 00:41,1064534,348692,498904,216938,1064534
2023-04-26 00:43,1064564,348719,498904,216941,1064564
2023-04-26 00:44,1064593,348746,498904,216943,1064593
2023-04-26 00:45,1064623,348761,498916,216946,1064623
2023-04-26 00:46,1064654,348791,498916,216947,1064654
2023-04-26 00:47,1064682,348813,498920,216949,1064682
2023-04-26 00:48,1064711,348838,498920,216953,1064711
2023-04-26 00:49,1064741,348866,498922,216953,1064741
2023-04-26 00:50,1064771,348895,498922,216954,1064771
2023-04-26 00:51,1064801,348916,498928,216957,1064801
2023-04-26 00:52,1064831,348944,498928,216959,1064831
2023-04-26 00:53,1064861,348972,498928,216961,1064861
2023-04-26 00:54,1064889,348998,498928,216963,1064889
2023-04-26 00:55,1064919,349023,498932,216964,1064919
2023-04-26 00:56,1064950,349053,498932,216965,1064950
2023-04-26 00:57,1064978,349079,498934,216965,1064978
2023-04-26 00:58,1065006,349106,498934,216966,1065006
2023-04-26 00:59,1065038,349137,498934,216967,1065038
2023-04-26 01:00,1065069,349162,498934,216973,1065069
2023-04-26 01:01,1065117,349205,498937,216975,1065117
2023-04-26 01:02,1065162,349249,498937,216976,1065162
2023-04-26 01:03,1065205,349291,498937,216977,1065205
2023-04-26 01:04,1065252,349338,498937,216977,1065252
2023-04-26 01:05,1065296,349373,498941,216982,1065296
2023-04-26 01:06,1065341,349418,498941,216982,1065341
2023-04-26 01:07,1065387,349460,498942,216985,1065387
2023-04-26 01:08,1065434,349506,498942,216986,1065434
2023-04-26 01:09,1065478,349549,498942,216987,1065478
2023-04-26 01:10,1065524,349594,498942,216988,1065524
2023-04-26 01:11,1065571,349638,498944,216989,1065571
2023-04-26 01:12,1065615,349681,498944,216990,1065615
2023-04-26 01:13,1065662,349725,498945,216992,1065662
2023-04-26 01:14,1065707,349768,498945,216994,1065707
2023-04-26 01:15,1065750,349806,498948,216996,1065750
2023-04-26 01:16,1065799,349854,498948,216997,1065799
2023-04-26 01:17,1065841,349893,498950,216998,1065841
2023-04-26 01:18,1065889,349940,498950,216999,1065889
2023-04-26 01:19,1065934,349982,498952,217000,1065934
2023-04-26 01:20,1065981,350027,498952,217002,1065981
2023-04-26 01:21,1066025,350068,498955,217002,1066025
2023-04-26 01:22,1066072,350115,498955,217002,1066072
2023-04-26 01:23,1066118,350157,498958,217003,1066118
2023-04-26 01:24,1066162,350199,498958,217005,1066162
2023-04-26 01:25,1066209,350244,498959,217006,1066209
2023-04-26 01:26,1066253,350288,498959,217006,1066253
2023-04-26 01:27,1066299,350332,498960,217007,1066299
2023-04-26 01:28,1066345,350378,498960,217007,1066345
2023-04-26 01:30,1066391,350422,498962,217007,1066391
2023-04-26 01:31,1066435,350465,498962,217008,1066435
2023-04-26 01:32,1066483,350512,498963,217008,1066483
2023-04-26 01:33,1066526,350555,498963,217008,1066526
2023-04-26 01:34,1066571,350600,498963,217008,1066571
2023-04-26 01:35,1066616,350645,498963,217008,1066616
2023-04-26 01:36,1066665,350693,498963,217009,1066665
2023-04-26 01:37,1066707,350735,498963,217009,1066707
2023-04-26 01:38,1066753,350778,498963,217012,1066753
2023-04-26 01:39,1066799,350821,498965,217013,1066799
2023-04-26 01:40,1066844,350865,498965,217014,1066844
2023-04-26 01:41,1066891,350908,498967,217016,1066891
2023-04-26 01:42,1066937,350954,498967,217016,1066937
2023-04-26 01:43,1066981,350997,498968,217016,1066981
2023-04-26 01:44,1067025,351041,498968,217016,1067025
2023-04-26 01:45,1067071,351085,498969,217017,1067071
2023-04-26 01:46,1067119,351133,498969,217017,1067119
2023-04-26 01:47,1067165,351177,498970,217018,1067165
2023-04-26 01:48,1067208,351220,498970,217018,1067208
2023-04-26 01:49,1067255,351268,498969,217018,1067255
2023-04-26 01:50,1067301,351314,498969,217018,1067301
2023-04-26 01:51,1067347,351356,498972,217019,1067347
2023-04-26 01:52,1067393,351402,498972,217019,1067393
2023-04-26 01:53,1067438,351446,498973,217019,1067438
2023-04-26 01:54,1067482,351490,498973,217019,1067482
2023-04-26 01:55,1067526,351531,498975,217020,1067526
2023-04-26 01:56,1067576,351580,498975,217021,1067576
2023-04-26 01:57,1067620,351620,498979,217021,1067620
2023-04-26 01:58,1067664,351663,498979,217022,1067664
2023-04-26 01:59,1067713,351710,498978,217025,1067713
2023-04-26 02:00,1067736,351733,498978,217025,1067736
2023-04-26 02:01,1067746,351743,498978,217025,1067746
2023-04-26 02:02,1067756,351752,498978,217026,1067756
2023-04-26 02:03,1067766,351759,498980,217027,1067766
2023-04-26 02:04,1067776,351768,498980,217028,1067776
2023-04-26 02:05,1067786,351774,498981,217031,1067786
2023-04-26 02:06,1067796,351784,498981,217031,1067796
2023-04-26 02:07,1067806,351792,498982,217032,1067806
2023-04-26 02:08,1067815,351800,498982,217033,1067815
2023-04-26 02:09,1067825,351807,498984,217034,1067825
2023-04-26 02:10,1067835,351817,498984,217034,1067835
2023-04-26 02:11,1067846,351826,498985,217035,1067846
2023-04-26 02:12,1067856,351834,498986,217036,1067856
2023-04-26 02:13,1067866,351844,498986,217036,1067866
2023-04-26 02:14,1067876,351851,498987,217038,1067876
2023-04-26 02:15,1067886,351861,498987,217038,1067886
2023-04-26 02:17,1067896,351869,498989,217038,1067896
2023-04-26 02:18,1067905,351878,498989,217038,1067905
2023-04-26 02:19,1067915,351886,498991,217038,1067915
2023-04-26 02:20,1067925,351895,498991,217039,1067925
2023-04-26 02:21,1067935,351902,498991,217042,1067935
2023-04-26 02:22,1067945,351910,498991,217044,1067945
2023-04-26 02:23,1067955,351918,498992,217045,1067955
2023-04-26 02:24,1067965,351926,498992,217047,1067965
2023-04-26 02:25,1067975,351933,498995,217047,1067975
2023-04-26 02:26,1067985,351941,498996,217048,1067985
2023-04-26 02:27,1067995,351951,498996,217048,1067995
2023-04-26 02:28,1068004,351957,498998,217049,1068004
2023-04-26 02:29,1068015,351968,498998,217049,1068015
2023-04-26 02:30,1068024,351977,498998,217049,1068024
2023-04-26 02:31,1068034,351987,498998,217049,1068034
2023-04-26 02:32,1068044,351997,498997,217050,1068044
2023-04-26 02:33,1068054,352007,498997,217050,1068054
2023-04-26 02:34,1068063,352016,498997,217050,1068063
2023-04-26 02:35,1068073,352025,498997,217051,1068073
2023-04-26 02:36,1068084,352034,498999,217051,1068084
2023-04-26 02:37,1068094,352044,498999,217051,1068094
2023-04-26 02:38,1068104,352054,498999,217051,1068104
2023-04-26 02:39,1068114,352063,498999,217052,1068114
2023-04-26 02:40,1068124,352072,499000,217052,1068124
2023-04-26 02:41,1068134,352082,499000,217052,1068134
2023-04-26 02:42,1068144,352092,499000,217052,1068144
2023-04-26 02:43,1068154,352101,499000,217053,1068154
2023-04-26 02:44,1068164,352110,499000,217054,1068164
2023-04-26 02:45,1068175,352121,499000,217054,1068175
2023-04-26 02:46,1068184,352130,499000,217054,1068184
2023-04-26 02:47,1068194,352139,499000,217055,1068194
2023-04-26 02:48,1068204,352147,499001,217056,1068204
2023-04-26 02:49,1068214,352156,499001,217057,1068214
2023-04-26 02:50,1068224,352166,499001,217057,1068224
2023-04-26 02:51,1068234,352175,499001,217058,1068234
2023-04-26 02:52,1068244,352183,499002,217059,1068244
2023-04-26 02:53,1068254,352191,499003,217060,1068254
2023-04-26 02:54,1068264,352201,499003,217060,1068264
2023-04-26 02:55,1068273,352210,499003,217060,1068273
2023-04-26 02:56,1068283,352219,499003,217061,1068283
2023-04-26 02:57,1068293,352229,499003,217061,1068293
2023-04-26 02:58,1068303,352239,499003,217061,1068303
2023-04-26 02:59,1068313,352249,499003,217061,1068313
2023-04-26 03:00,1068335,352271,499003,217061,1068335
2023-04-26 03:01,1068359,352292,499005,217062,1068359
2023-04-26 03:02,1068384,352317,499005,217062,1068384
2023-04-26 03:04,1068408,352342,499005,217061,1068408
2023-04-26 03:05,1068432,352364,499005,217063,1068432
2023-04-26 03:06,1068455,352386,499005,217064,1068455
2023-04-26 03:07,1068479,352409,499005,217065,1068479
2023-04-26 03:08,1068504,352433,499006,217065,1068504
2023-04-26 03:09,1068527,352455,499006,217066,1068527
2023-04-26 03:10,1068552,352478,499008,217066,1068552
2023-04-26 03:11,1068576,352502,499008,217066,1068576
2023-04-26 03:12,1068601,352525,499010,217066,1068601
2023-04-26 03:13,1068625,352548,499010,217067,1068625
2023-04-26 03:14,1068649,352573,499009,217067,1068649
2023-04-26 03:15,1068673,352597,499009,217067,1068673
2023-04-26 03:16,1068696,352620,499009,217067,1068696
2023-04-26 03:17,1068721,352644,499009,217068,1068721
2023-04-26 03:18,1068744,352666,499010,217068,1068744
2023-04-26 03:19,1068768,352690,499010,217068,1068768
2023-04-26 03:20,1068794,352717,499009,217068,1068794
2023-04-26 03:21,1068818,352741,499009,217068,1068818
2023-04-26 03:22,1068842,352764,499009,217069,1068842
2023-04-26 03:23,1068865,352787,499009,217069,1068865
2023-04-26 03:24,1068889,352811,499009,217069,1068889
2023-04-26 03:25,1068913,352835,499009,217069,1068913
2023-04-26 03:26,1068938,352859,499009,217070,1068938
2023-04-26 03:27,1068963,352883,499009,217071,1068963
2023-04-26 03:28,1068987,352907,499009,217071,1068987
2023-04-26 03:29,1069010,352930,499009,217071,1069010
2023-04-26 03:30,1069035,352955,499009,217071,1069035
2023-04-26 03:31,1069059,352979,499009,217071,1069059
2023-04-26 03:32,1069083,353003,499009,217071,1069083
2023-04-26 03:33,1069106,353025,499009,217072,1069106
2023-04-26 03:34,1069132,353050,499010,217072,1069132
2023-04-26 03:35,1069158,353076,499010,217072,1069158
2023-04-26 03:36,1069182,353099,499010,217073,1069182
2023-04-26 03:37,1069205,353122,499010,217073,1069205
2023-04-26 03:38,1069229,353145,499010,217074,1069229
2023-04-26 03:39,1069254,353170,499010,217074,1069254
2023-04-26 03:40,1069279,353195,499010,217074,1069279
2023-04-26 03:41,1069303,353219,499010,217074,1069303
2023-04-26 03:42,1069326,353241,499011,217074,1069326
2023-04-26 03:43,1069351,353266,499011,217074,1069351
2023-04-26 03:44,1069375,353289,499011,217075,1069375
2023-04-26 03:45,1069400,353314,499011,217075,1069400
2023-04-26 03:47,1069424,353338,499011,217075,1069424
2023-04-26 03:48,1069448,353362,499011,217075,1069448
2023-04-26 03:49,1069471,353385,499011,217075,1069471
2023-04-26 03:50,1069497,353411,499011,217075,1069497
2023-04-26 03:51,1069520,353434,499011,217075,1069520
2023-04-26 03:52,1069545,353458,499011,217076,1069545
2023-04-26 03:53,1069569,353482,499011,217076,1069569
2023-04-26 03:54,1069592,353505,499011,217076,1069592
2023-04-26 03:55,1069616,353528,499012,217076,1069616
2023-04-26 03:56,1069641,353553,499012,217076,1069641
2023-04-26 03:57,1069666,353578,499012,217076,1069666
2023-04-26 03:58,1069689,353601,499012,217076,1069689
2023-04-26 03:59,1069714,353624,499014,217076,1069714
2023-04-26 04:00,1069739,353648,499014,217077,1069739
2023-04-26 04:01,1069766,353675,499014,217077,1069766
2023-04-26 04:02,1069797,353706,499014,217077,1069797
2023-04-26 04:03,1069825,353734,499014,217077,1069825
2023-04-26 04:04,1069855,353764,499014,217077,1069855
2023-04-26 04:05,1069883,353791,499015,217077,1069883
2023-04-26 04:06,1069912,353820,499015,217077,1069912
2023-04-26 04:07,1069942,353850,499015,217077,1069942
2023-04-26 04:08,1069971,353878,499015,217078,1069971
2023-04-26 04:09,1070000,353906,499016,217078,1070000
2023-04-26 04:10,1070030,353936,499016,217078,1070030
2023-04-26 04:11,1070059,353965,499016,217078,1070059
2023-04-26 04:12,1070087,353992,499016,217079,1070087
2023-04-26 04:13,1070116,354021,499016,217079,1070116
2023-04-26 04:14,1070145,354050,499016,217079,1070145
2023-04-26 04:15,1070174,354078,499016,217080,1070174
2023-04-26 04:16,1070204,354108,499016,217080,1070204
2023-04-26 04:17,1070233,354137,499016,217080,1070233
2023-04-26 04:18,1070262,354166,499016,217080,1070262
2023-04-26 04:19,1070292,354196,499016,217080,1070292
2023-04-26 04:20,1070321,354225,499016,217080,1070321
2023-04-26 04:21,1070350,354254,499016,217080,1070350
2023-04-26 04:22,1070379,354283,499016,217080,1070379
2023-04-26 04:23,1070409,354312,499016,217081,1070409
2023-04-26 04:24,1070438,354341,499016,217081,1070438
2023-04-26 04:25,1070466,354368,499016,217082,1070466
2023-04-26 04:26,1070495,354397,499016,217082,1070495
2023-04-26 04:27,1070525,354427,499016,217082,1070525
2023-04-26 04:28,1070555,354457,499016,217082,1070555
2023-04-26 04:29,1070582,354484,499016,217082,1070582
2023-04-26 04:30,1070611,354513,499016,217082,1070611
2023-04-26 04:32,1070642,354544,499016,217082,1070642
2023-04-26 04:33,1070670,354572,499016,217082,1070670
2023-04-26 04:34,1070699,354601,499016,217082,1070699
2023-04-26 04:35,1070728,354630,499016,217082,1070728
2023-04-26 04:36,1070757,354659,499016,217082,1070757
2023-04-26 04:37,1070787,354689,499016,217082,1070787
2023-04-26 04:38,1070815,354717,499016,217082,1070815
2023-04-26 04:39,1070844,354746,499016,217082,1070844
2023-04-26 04:40,1070873,354774,499017,217082,1070873
2023-04-26 04:41,1070902,354803,499017,217082,1070902
2023-04-26 04:42,1070931,354831,499018,217082,1070931
2023-04-26 04:43,1070962,354862,499018,217082,1070962
2023-04-26 04:44,1070991,354891,499018,217082,1070991
2023-04-26 04:45,1071019,354919,499018,217082,1071019
2023-04-26 04:46,1071047,354947,499018,217082,1071047
2023-04-26 04:47,1071077,354977,499018,217082,1071077
2023-04-26 04:48,1071108,355008,499018,217082,1071108
2023-04-26 04:49,1071135,355035,499018,217082,1071135
2023-04-26 04:50,1071166,355066,499018,217082,1071166
2023-04-26 04:51,1071193,355093,499018,217082,1071193
2023-04-26 04:52,1071224,355123,499018,217083,1071224
2023-04-26 04:53,1071251,355150,499018,217083,1071251
2023-04-26 04:54,1071280,355179,499018,217083,1071280
2023-04-26 04:55,1071309,355208,499018,217083,1071309
2023-04-26 04:56,1071338,355237,499018,217083,1071338
2023-04-26 04:57,1071369,355267,499018,217084,1071369
2023-04-26 04:58,1071397,355294,499018,217085,1071397
2023-04-26 04:59,1071427,355324,499018,217085,1071427
2023-04-26 05:00,1071454,355351,499018,217085,1071454
2023-04-26 05:01,1071480,355376,499018,217086,1071480
2023-04-26 05:02,1071506,355402,499018,217086,1071506
2023-04-26 05:03,1071534,355430,499018,217086,1071534
2023-04-26 05:04,1071560,355456,499018,217086,1071560
2023-04-26 05:05,1071587,355483,499018,217086,1071587
2023-04-26 05:06,1071613,355509,499018,217086,1071613
2023-04-26 05:07,1071638,355534,499018,217086,1071638
2023-04-26 05:08,1071665,355559,499019,217087,1071665
2023-04-26 05:09,1071691,355585,499019,217087,1071691
2023-04-26 05:10,1071717,355610,499020,217087,1071717
2023-04-26 05:11,1071745,355638,499020,217087,1071745
2023-04-26 05:12,1071770,355663,499020,217087,1071770
2023-04-26 05:13,1071798,355690,499020,217088,1071798
2023-04-26 05:14,1071824,355716,499020,217088,1071824
2023-04-26 05:15,1071851,355743,499020,217088,1071851
2023-04-26 05:16,1071876,355768,499020,217088,1071876
2023-04-26 05:17,1071904,355796,499020,217088,1071904
2023-04-26 05:19,1071930,355819,499021,217090,1071930
2023-04-26 05:20,1071956,355845,499021,217090,1071956
2023-04-26 05:21,1071982,355870,499021,217091,1071982
2023-04-26 05:22,1072010,355897,499021,217092,1072010
2023-04-26 05:23,1072036,355923,499021,217092,1072036
2023-04-26 05:24,1072061,355948,499021,217092,1072061
2023-04-26 05:25,1072089,355976,499021,217092,1072089
2023-04-26 05:26,1072114,356001,499021,217092,1072114
2023-04-26 05:27,1072142,356029,499021,217092,1072142
2023-04-26 05:28,1072168,356055,499021,217092,1072168
2023-04-26 05:29,1072193,356080,499021,217092,1072193
2023-04-26 05:30,1072220,356107,499021,217092,1072220
2023-04-26 05:31,1072247,356134,499021,217092,1072247
2023-04-26 05:32,1072273,356159,499021,217093,1072273
2023-04-26 05:33,1072300,356186,499021,217093,1072300
2023-04-26 05:34,1072326,356212,499021,217093,1072326
2023-04-26 05:35,1072353,356239,499021,217093,1072353
2023-04-26 05:36,1072380,356266,499021,217093,1072380
2023-04-26 05:37,1072406,356292,499021,217093,1072406
2023-04-26 05:38,1072432,356318,499021,217093,1072432
2023-04-26 05:39,1072459,356343,499022,217094,1072459
2023-04-26 05:40,1072486,356370,499022,217094,1072486
2023-04-26 05:41,1072511,356395,499022,217094,1072511
2023-04-26 05:42,1072539,356423,499022,217094,1072539
2023-04-26 05:43,1072564,356447,499023,217094,1072564
2023-04-26 05:44,1072591,356474,499023,217094,1072591
2023-04-26 05:45,1072618,356501,499023,217094,1072618
2023-04-26 05:46,1072645,356528,499023,217094,1072645
2023-04-26 05:47,1072671,356554,499023,217094,1072671
2023-04-26 05:48,1072697,356580,499023,217094,1072697
2023-04-26 05:49,1072724,356606,499024,217094,1072724
2023-04-26 05:50,1072749,356631,499024,217094,1072749
2023-04-26 05:51,1072776,356657,499024,217095,1072776
2023-04-26 05:52,1072803,356684,499024,217095,1072803
2023-04-26 05:53,1072828,356709,499024,217095,1072828
2023-04-26 05:54,1072855,356736,499024,217095,1072855
2023-04-26 05:55,1072881,356758,499027,217096,1072881
2023-04-26 05:56,1072908,356782,499027,217099,1072908
2023-04-26 05:57,1072935,356809,499027,217099,1072935
2023-04-26 05:58,1072961,356833,499027,217101,1072961
2023-04-26 05:59,1072988,356859,499028,217101,1072988
2023-04-26 06:00,1073014,356884,499028,217102,1073014
2023-04-26 06:01,1073040,356910,499028,217102,1073040
2023-04-26 06:02,1073065,356935,499028,217102,1073065
2023-04-26 06:03,1073091,356960,499028,217103,1073091
2023-04-26 06:05,1073117,356986,499028,217103,1073117
2023-04-26 06:06,1073143,357011,499029,217103,1073143
2023-04-26 06:07,1073169,357037,499029,217103,1073169
2023-04-26 06:08,1073196,357063,499029,217104,1073196
2023-04-26 06:09,1073221,357088,499029,217104,1073221
2023-04-26 06:10,1073248,357115,499029,217104,1073248
2023-04-26 06:11,1073273,357139,499029,217105,1073273
2023-04-26 06:12,1073299,357163,499031,217105,1073299
2023-04-26 06:13,1073326,357190,499031,217105,1073326
2023-04-26 06:14,1073350,357213,499031,217106,1073350
2023-04-26 06:15,1073378,357241,499031,217106,1073378
2023-04-26 06:16,1073402,357265,499031,217106,1073402
2023-04-26 06:17,1073428,357290,499031,217107,1073428
2023-04-26 06:18,1073454,357314,499032,217108,1073454
2023-04-26 06:19,1073481,357341,499032,217108,1073481
2023-04-26 06:20,1073509,357367,499032,217110,1073509
2023-04-26 06:21,1073534,357391,499032,217111,1073534
2023-04-26 06:22,1073559,357416,499032,217111,1073559
2023-04-26 06:23,1073585,357442,499032,217111,1073585
2023-04-26 06:24,1073612,357467,499032,217113,1073612
2023-04-26 06:25,1073638,357492,499032,217114,1073638
2023-04-26 06:26,1073663,357517,499032,217114,1073663
2023-04-26 06:27,1073691,357545,499032,217114,1073691
2023-04-26 06:28,1073716,357568,499034,217114,1073716
2023-04-26 06:29,1073743,357595,499034,217114,1073743
2023-04-26 06:30,1073768,357619,499034,217115,1073768
2023-04-26 06:31,1073793,357644,499034,217115,1073793
2023-04-26 06:32,1073820,357671,499034,217115,1073820
2023-04-26 06:33,1073846,357695,499034,217117,1073846
2023-04-26 06:34,1073872,357720,499035,217117,1073872
2023-04-26 06:35,1073898,357745,499035,217118,1073898
2023-04-26 06:36,1073923,357769,499036,217118,1073923
2023-04-26 06:37,1073949,357795,499036,217118,1073949
2023-04-26 06:38,1073976,357822,499036,217118,1073976
2023-04-26 06:39,1074001,357847,499036,217118,1074001
2023-04-26 06:40,1074027,357871,499037,217119,1074027
2023-04-26 06:41,1074054,357897,499037,217120,1074054
2023-04-26 06:42,1074079,357919,499039,217121,1074079
2023-04-26 06:43,1074106,357946,499039,217121,1074106
2023-04-26 06:44,1074130,357966,499042,217122,1074130
2023-04-26 06:45,1074157,357993,499042,217122,1074157
2023-04-26 06:46,1074183,358016,499044,217123,1074183
2023-04-26 06:47,1074209,358039,499044,217126,1074209
2023-04-26 06:48,1074236,358065,499044,217127,1074236
2023-04-26 06:49,1074261,358087,499044,217130,1074261
2023-04-26 06:50,1074287,358110,499045,217132,1074287
2023-04-26 06:52,1074313,358135,499045,217133,1074313
2023-04-26 06:53,1074339,358157,499046,217136,1074339
2023-04-26 06:54,1074365,358183,499046,217136,1074365
2023-04-26 06:55,1074392,358209,499047,217136,1074392
2023-04-26 06:56,1074419,358236,499047,217136,1074419
2023-04-26 06:57,1074444,358260,499047,217137,1074444
2023-04-26 06:58,1074470,358285,499047,217138,1074470
2023-04-26 06:59,1074495,358308,499047,217140,1074495
2023-04-26 07:00,1074522,358335,499047,217140,1074522
2023-04-26 07:01,1074545,358357,499048,217140,1074545
2023-04-26 07:02,1074568,358380,499048,217140,1074568
2023-04-26 07:03,1074591,358401,499049,217141,1074591
2023-04-26 07:04,1074616,358425,499049,217142,1074616
2023-04-26 07:05,1074639,358448,499049,217142,1074639
2023-04-26 07:06,1074663,358470,499049,217144,1074663
2023-04-26 07:07,1074686,358492,499049,217145,1074686
2023-04-26 07:08,1074708,358513,499049,217146,1074708
2023-04-26 07:09,1074733,358537,499050,217146,1074733
2023-04-26 07:10,1074755,358559,499050,217146,1074755
2023-04-26 07:11,1074779,358583,499050,217146,1074779
2023-04-26 07:12,1074802,358606,499050,217146,1074802
2023-04-26 07:13,1074825,358626,499052,217147,1074825
2023-04-26 07:14,1074849,358650,499052,217147,1074849
2023-04-26 07:15,1074872,358669,499056,217147,1074872
2023-04-26 07:16,1074895,358690,499056,217149,1074895
2023-04-26 07:17,1074918,358710,499059,217149,1074918
2023-04-26 07:18,1074942,358734,499059,217149,1074942
2023-04-26 07:19,1074965,358753,499060,217152,1074965
2023-04-26 07:20,1074988,358774,499060,217154,1074988
2023-04-26 07:21,1075011,358796,499061,217154,1075011
2023-04-26 07:22,1075035,358820,499061,217154,1075035
2023-04-26 07:23,1075059,358843,499062,217154,1075059
2023-04-26 07:24,1075082,358866,499062,217154,1075082
2023-04-26 07:25,1075105,358888,499063,217154,1075105
2023-04-26 07:26,1075129,358912,499063,217154,1075129
2023-04-26 07:27,1075151,358932,499064,217155,1075151
2023-04-26 07:28,1075175,358954,499064,217157,1075175
2023-04-26 07:29,1075199,358976,499065,217158,1075199
2023-04-26 07:30,1075221,358998,499065,217158,1075221
2023-04-26 07:31,1075245,359021,499065,217159,1075245
2023-04-26 07:32,1075269,359045,499065,217159,1075269
2023-04-26 07:33,1075291,359064,499068,217159,1075291
2023-04-26 07:34,1075315,359088,499068,217159,1075315
2023-04-26 07:35,1075337,359109,499069,217159,1075337
2023-04-26 07:37,1075361,359133,499069,217159,1075361
2023-04-26 07:38,1075384,359155,499070,217159,1075384
2023-04-26 07:39,1075407,359175,499070,217162,1075407
2023-04-26 07:40,1075431,359199,499070,217162,1075431
2023-04-26 07:41,1075453,359221,499070,217162,1075453
2023-04-26 07:42,1075478,359245,499070,217163,1075478
2023-04-26 07:43,1075501,359268,499070,217163,1075501
2023-04-26 07:44,1075524,359289,499070,217165,1075524
2023-04-26 07:45,1075547,359312,499070,217165,1075547
2023-04-26 07:46,1075569,359334,499070,217165,1075569
2023-04-26 07:47,1075593,359358,499070,217165,1075593
2023-04-26 07:48,1075616,359379,499072,217165,1075616
2023-04-26 07:49,1075639,359401,499072,217166,1075639
2023-04-26 07:50,1075663,359424,499073,217166,1075663
2023-04-26 07:51,1075686,359445,499073,217168,1075686
2023-04-26 07:52,1075710,359467,499074,217169,1075710
2023-04-26 07:53,1075734,359489,499074,217171,1075734
2023-04-26 07:54,1075757,359511,499075,217171,1075757
2023-04-26 07:55,1075780,359533,499075,217172,1075780
2023-04-26 07:56,1075803,359555,499075,217173,1075803
2023-04-26 07:57,1075826,359576,499075,217175,1075826
2023-04-26 07:58,1075848,359597,499075,217176,1075848
2023-04-26 07:59,1075872,359618,499075,217179,1075872
2023-04-26 08:00,1075890,359631,499075,217184,1075890
2023-04-26 08:01,1075900,359640,499075,217185,1075900
2023-04-26 08:02,1075911,359649,499076,217186,1075911
2023-04-26 08:03,1075921,359659,499076,217186,1075921
2023-04-26 08:04,1075931,359667,499076,217188,1075931
2023-04-26 08:05,1075942,359677,499076,217189,1075942
2023-04-26 08:06,1075952,359685,499077,217190,1075952
2023-04-26 08:07,1075963,359695,499077,217191,1075963
2023-04-26 08:08,1075974,359701,499078,217195,1075974
2023-04-26 08:09,1075984,359711,499078,217195,1075984
2023-04-26 08:10,1075995,359716,499082,217197,1075995
2023-04-26 08:11,1076005,359725,499082,217198,1076005
2023-04-26 08:12,1076016,359732,499084,217200,1076016
2023-04-26 08:13,1076027,359742,499084,217201,1076027
2023-04-26 08:14,1076037,359749,499085,217203,1076037
2023-04-26 08:15,1076047,359758,499085,217204,1076047
2023-04-26 08:16,1076058,359767,499086,217205,1076058
2023-04-26 08:17,1076068,359776,499086,217206,1076068
2023-04-26 08:18,1076079,359786,499086,217207,1076079
2023-04-26 08:19,1076089,359796,499086,217207,1076089
2023-04-26 08:20,1076099,359802,499087,217210,1076099
2023-04-26 08:21,1076110,359811,499087,217212,1076110
2023-04-26 08:22,1076120,359818,499089,217213,1076120
2023-04-26 08:24,1076131,359827,499089,217215,1076131
2023-04-26 08:25,1076141,359836,499089,217216,1076141
2023-04-26 08:26,1076151,359842,499089,217220,1076151
2023-04-26 08:27,1076162,359851,499091,217220,1076162
2023-04-26 08:28,1076172,359860,499091,217221,1076172
2023-04-26 08:29,1076183,359867,499093,217223,1076183
2023-04-26 08:30,1076193,359877,499093,217223,1076193
2023-04-26 08:31,1076203,359886,499094,217223,1076203
2023-04-26 08:32,1076213,359894,499094,217225,1076213
2023-04-26 08:33,1076224,359901,499098,217225,1076224
2023-04-26 08:34,1076234,359909,499098,217227,1076234
2023-04-26 08:35,1076245,359919,499098,217228,1076245
2023-04-26 08:36,1076255,359928,499098,217229,1076255
2023-04-26 08:37,1076266,359938,499098,217230,1076266
2023-04-26 08:38,1076276,359947,499098,217231,1076276
2023-04-26 08:39,1076286,359956,499098,217232,1076286
2023-04-26 08:40,1076297,359966,499098,217233,1076297
2023-04-26 08:41,1076308,359976,499098,217234,1076308
2023-04-26 08:42,1076318,359985,499098,217235,1076318
2023-04-26 08:43,1076329,359989,499103,217237,1076329
2023-04-26 08:44,1076339,359998,499103,217238,1076339
2023-04-26 08:45,1076350,360009,499103,217238,1076350
2023-04-26 08:46,1076360,360018,499103,217239,1076360
2023-04-26 08:47,1076370,360027,499103,217240,1076370
2023-04-26 08:48,1076381,360037,499103,217241,1076381
2023-04-26 08:49,1076391,360046,499103,217242,1076391
2023-04-26 08:50,1076401,360055,499103,217243,1076401
2023-04-26 08:51,1076412,360066,499103,217243,1076412
2023-04-26 08:52,1076422,360074,499103,217245,1076422
2023-04-26 08:53,1076432,360082,499105,217245,1076432
2023-04-26 08:54,1076444,360091,499105,217248,1076444
2023-04-26 08:55,1076454,360097,499105,217252,1076454
2023-04-26 08:56,1076465,360107,499105,217253,1076465
2023-04-26 08:57,1076476,360116,499105,217255,1076476
2023-04-26 08:58,1076486,360126,499105,217255,1076486
2023-04-26 08:59,1076497,360136,499105,217256,1076497
2023-04-26 09:00,1076511,360150,499105,217256,1076511
2023-04-26 09:01,1076527,360165,499105,217257,1076527
2023-04-26 09:02,1076542,360176,499105,217261,1076542
2023-04-26 09:03,1076558,360183,499111,217264,1076558
2023-04-26 09:04,1076573,360197,499111,217265,1076573
2023-04-26 09:05,1076587,360209,499111,217267,1076587
2023-04-26 09:06,1076602,360224,499111,217267,1076602
2023-04-26 09:07,1076617,360236,499111,217270,1076617
2023-04-26 09:08,1076633,360250,499111,217272,1076633
2023-04-26 09:09,1076647,360264,499111,217272,1076647
2023-04-26 09:11,1076662,360277,499111,217274,1076662
2023-04-26 09:12,1076677,360292,499111,217274,1076677
2023-04-26 09:13,1076691,360299,499117,217275,1076691
2023-04-26 09:14,1076706,360313,499117,217276,1076706
2023-04-26 09:15,1076720,360324,499117,217279,1076720
2023-04-26 09:16,1076735,360338,499117,217280,1076735
2023-04-26 09:17,1076750,360352,499117,217281,1076750
2023-04-26 09:18,1076765,360365,499117,217283,1076765
2023-04-26 09:19,1076779,360378,499117,217284,1076779
2023-04-26 09:20,1076795,360393,499117,217285,1076795
2023-04-26 09:21,1076809,360405,499117,217287,1076809
2023-04-26 09:22,1076823,360418,499117,217288,1076823
2023-04-26 09:23,1076838,360422,499124,217292,1076838
2023-04-26 09:24,1076853,360437,499124,217292,1076853
2023-04-26 09:25,1076868,360452,499124,217292,1076868
2023-04-26 09:26,1076884,360466,499124,217294,1076884
2023-04-26 09:27,1076899,360480,499124,217295,1076899
2023-04-26 09:28,1076914,360494,499124,217296,1076914
2023-04-26 09:29,1076929,360506,499124,217299,1076929
2023-04-26 09:30,1076944,360512,499132,217300,1076944
2023-04-26 09:31,1076958,360524,499132,217302,1076958
2023-04-26 09:32,1076974,360538,499133,217303,1076974
2023-04-26 09:33,1076988,360549,499133,217306,1076988
2023-04-26 09:34,1077003,360561,499135,217307,1077003
2023-04-26 09:35,1077018,360574,499135,217309,1077018
2023-04-26 09:36,1077033,360588,499135,217310,1077033
2023-04-26 09:37,1077047,360600,499135,217312,1077047
2023-04-26 09:38,1077062,360615,499135,217312,1077062
2023-04-26 09:39,1077078,360631,499135,217312,1077078
2023-04-26 09:40,1077092,360643,499136,217313,1077092
2023-04-26 09:41,1077108,360657,499136,217315,1077108
2023-04-26 09:42,1077122,360669,499136,217317,1077122
2023-04-26 09:43,1077137,360682,499136,217319,1077137
2023-04-26 09:44,1077152,360695,499138,217319,1077152
2023-04-26 09:45,1077167,360709,499138,217320,1077167
2023-04-26 09:46,1077183,360723,499138,217322,1077183
2023-04-26 09:47,1077197,360736,499138,217323,1077197
2023-04-26 09:48,1077212,360748,499138,217326,1077212
2023-04-26 09:49,1077227,360761,499138,217328,1077227
2023-04-26 09:50,1077241,360769,499139,217333,1077241
2023-04-26 09:51,1077257,360785,499139,217333,1077257
2023-04-26 09:52,1077272,360795,499142,217335,1077272
2023-04-26 09:53,1077287,360809,499142,217336,1077287
2023-04-26 09:54,1077301,360820,499144,217337,1077301
2023-04-26 09:55,1077317,360835,499144,217338,1077317
2023-04-26 09:56,1077332,360849,499144,217339,1077332
2023-04-26 09:58,1077347,360863,499144,217340,1077347
2023-04-26 09:59,1077362,360872,499150,217340,1077362
2023-04-26 10:00,1077376,360885,499151,217340,1077376
2023-04-26 10:01,1077394,360901,499151,217342,1077394
2023-04-26 10:02,1077413,360917,499151,217345,1077413
2023-04-26 10:03,1077432,360936,499151,217345,1077432
2023-04-26 10:04,1077450,360949,499154,217347,1077450
2023-04-26 10:05,1077467,360964,499154,217349,1077467
2023-04-26 10:06,1077486,360977,499158,217351,1077486
2023-04-26 10:07,1077505,360995,499159,217351,1077505
2023-04-26 10:08,1077524,361013,499159,217352,1077524
2023-04-26 10:09,1077541,361027,499161,217353,1077541
2023-04-26 10:10,1077559,361044,499161,217354,1077559
2023-04-26 10:11,1077578,361060,499163,217355,1077578
2023-04-26 10:12,1077596,361076,499163,217357,1077596
2023-04-26 10:13,1077613,361089,499166,217358,1077613
2023-04-26 10:14,1077633,361108,499166,217359,1077633
2023-04-26 10:15,1077649,361125,499165,217359,1077649
2023-04-26 10:16,1077670,361142,499167,217361,1077670
2023-04-26 10:17,1077689,361160,499168,217361,1077689
2023-04-26 10:18,1077707,361175,499168,217364,1077707
2023-04-26 10:19,1077724,361187,499170,217367,1077724
2023-04-26 10:20,1077743,361203,499170,217370,1077743
2023-04-26 10:21,1077761,361219,499172,217370,1077761
2023-04-26 10:22,1077778,361236,499172,217370,1077778
2023-04-26 10:23,1077797,361249,499175,217373,1077797
2023-04-26 10:24,1077815,361264,499175,217376,1077815
2023-04-26 10:25,1077833,361278,499177,217378,1077833
2023-04-26 10:26,1077851,361292,499177,217382,1077851
2023-04-26 10:27,1077869,361308,499177,217384,1077869
2023-04-26 10:28,1077888,361327,499177,217384,1077888
2023-04-26 10:29,1077907,361341,499180,217386,1077907
2023-04-26 10:30,1077925,361357,499180,217388,1077925
2023-04-26 10:31,1077945,361375,499182,217388,1077945
2023-04-26 10:32,1077962,361391,499182,217389,1077962
2023-04-26 10:33,1077980,361406,499183,217391,1077980
2023-04-26 10:34,1077999,361425,499183,217391,1077999
2023-04-26 10:35,1078017,361438,499187,217392,1078017
2023-04-26 10:36,1078036,361456,499187,217393,1078036
2023-04-26 10:37,1078054,361473,499186,217395,1078054
2023-04-26 10:38,1078073,361490,499186,217397,1078073
2023-04-26 10:39,1078091,361505,499187,217399,1078091
2023-04-26 10:40,1078109,361522,499187,217400,1078109
2023-04-26 10:41,1078128,361538,499189,217401,1078128
2023-04-26 10:42,1078146,361555,499189,217402,1078146
2023-04-26 10:43,1078164,361568,499194,217402,1078164
2023-04-26 10:45,1078182,361585,499194,217403,1078182
2023-04-26 10:46,1078201,361602,499194,217405,1078201
2023-04-26 10:47,1078220,361619,499194,217407,1078220
2023-04-26 10:48,1078239,361636,499194,217409,1078239
2023-04-26 10:49,1078257,361652,499194,217411,1078257
2023-04-26 10:50,1078274,361666,499195,217413,1078274
2023-04-26 10:51,1078293,361685,499195,217413,1078293
2023-04-26 10:52,1078311,361699,499197,217415,1078311
2023-04-26 10:53,1078329,361716,499197,217416,1078329
2023-04-26 10:54,1078347,361732,499198,217417,1078347
2023-04-26 10:55,1078365,361747,499199,217419,1078365
2023-04-26 10:56,1078383,361762,499199,217422,1078383
2023-04-26 10:57,1078403,361778,499201,217424,1078403
2023-04-26 10:58,1078422,361797,499201,217424,1078422
2023-04-26 10:59,1078440,361810,499205,217425,1078440
2023-04-26 11:00,1078457,361824,499205,217428,1078457
2023-04-26 11:01,1078473,361837,499206,217430,1078473
2023-04-26 11:02,1078486,361845,499206,217435,1078486
2023-04-26 11:03,1078502,361856,499209,217437,1078502
2023-04-26 11:04,1078515,361868,499209,217438,1078515
2023-04-26 11:05,1078530,361881,499209,217440,1078530
2023-04-26 11:06,1078544,361894,499209,217441,1078544
2023-04-26 11:07,1078558,361902,499213,217443,1078558
2023-04-26 11:08,1078572,361910,499216,217446,1078572
2023-04-26 11:09,1078586,361921,499216,217449,1078586
2023-04-26 11:10,1078600,361934,499216,217450,1078600
2023-04-26 11:11,1078614,361947,499216,217451,1078614
2023-04-26 11:12,1078629,361962,499216,217451,1078629
2023-04-26 11:13,1078644,361972,499216,217456,1078644
2023-04-26 11:14,1078658,361985,499216,217457,1078658
2023-04-26 11:15,1078673,362000,499216,217457,1078673
2023-04-26 11:16,1078687,362013,499216,217458,1078687
2023-04-26 11:17,1078701,362025,499216,217460,1078701
2023-04-26 11:18,1078716,362037,499219,217460,1078716
2023-04-26 11:19,1078730,362049,499219,217462,1078730
2023-04-26 11:20,1078745,362062,499219,217464,1078745
2023-04-26 11:21,1078759,362075,499219,217465,1078759
2023-04-26 11:22,1078774,362086,499224,217464,1078774
2023-04-26 11:23,1078788,362098,499224,217466,1078788
2023-04-26 11:24,1078801,362108,499227,217466,1078801
2023-04-26 11:25,1078816,362122,499227,217467,1078816
2023-04-26 11:26,1078831,362132,499229,217470,1078831
2023-04-26 11:27,1078845,362146,499229,217470,1078845
2023-04-26 11:28,1078859,362158,499230,217471,1078859
2023-04-26 11:29,1078873,362170,499230,217473,1078873
2023-04-26 11:30,1078887,362178,499233,217476,1078887
2023-04-26 11:31,1078902,362192,499233,217477,1078902
2023-04-26 11:33,1078916,362198,499239,217479,1078916
2023-04-26 11:34,1078929,362209,499239,217481,1078929
2023-04-26 11:35,1078944,362221,499241,217482,1078944
2023-04-26 11:36,1078958,362232,499241,217485,1078958
2023-04-26 11:37,1078972,362242,499244,217486,1078972
2023-04-26 11:38,1078985,362253,499246,217486,1078985
2023-04-26 11:39,1078999,362266,499246,217487,1078999
2023-04-26 11:40,1079014,362275,499252,217487,1079014
2023-04-26 11:41,1079028,362285,499256,217487,1079028
2023-04-26 11:42,1079042,362298,499256,217488,1079042
2023-04-26 11:43,1079057,362309,499260,217488,1079057
2023-04-26 11:44,1079070,362321,499260,217489,1079070
2023-04-26 11:45,1079086,362330,499265,217491,1079086
2023-04-26 11:46,1079100,362343,499265,217492,1079100
2023-04-26 11:47,1079114,362352,499269,217493,1079114
2023-04-26 11:48,1079129,362366,499269,217494,1079129
2023-04-26 11:49,1079143,362371,499277,217495,1079143
2023-04-26 11:50,1079159,362386,499277,217496,1079159
2023-04-26 11:51,1079172,362393,499281,217498,1079172
2023-04-26 11:52,1079186,362404,499281,217501,1079186
2023-04-26 11:53,1079201,362413,499285,217503,1079201
2023-04-26 11:54,1079216,362427,499285,217504,1079216
2023-04-26 11:55,1079230,362438,499287,217505,1079230
2023-04-26 11:56,1079244,362451,499287,217506,1079244
2023-04-26 11:57,1079260,362466,499288,217506,1079260
2023-04-26 11:58,1079274,362480,499288,217506,1079274
2023-04-26 11:59,1079288,362489,499291,217508,1079288
2023-04-26 12:00,1079303,362499,499292,217512,1079303
2023-04-26 12:01,1079315,362509,499292,217514,1079315
2023-04-26 12:02,1079328,362518,499295,217515,1079328
2023-04-26 12:03,1079343,362532,499295,217516,1079343
2023-04-26 12:04,1079355,362536,499302,217517,1079355
2023-04-26 12:05,1079368,362547,499302,217519,1079368
2023-04-26 12:06,1079382,362555,499307,217520,1079382
2023-04-26 12:07,1079394,362564,499307,217523,1079394
2023-04-26 12:08,1079408,362575,499309,217524,1079408
2023-04-26 12:09,1079420,362583,499309,217528,1079420
2023-04-26 12:10,1079434,362591,499312,217531,1079434
2023-04-26 12:11,1079448,362602,499312,217534,1079448
2023-04-26 12:12,1079461,362613,499314,217534,1079461
2023-04-26 12:13,1079474,362625,499314,217535,1079474
2023-04-26 12:14,1079486,362635,499316,217535,1079486
2023-04-26 12:15,1079499,362648,499316,217535,1079499
2023-04-26 12:16,1079513,362656,499320,217537,1079513
2023-04-26 12:17,1079528,362665,499322,217541,1079528
2023-04-26 12:18,1079541,362674,499324,217543,1079541
2023-04-26 12:20,1079556,362687,499324,217545,1079556
2023-04-26 12:21,1079569,362696,499327,217546,1079569
2023-04-26 12:22,1079582,362708,499327,217547,1079582
2023-04-26 12:23,1079595,362712,499335,217548,1079595
2023-04-26 12:24,1079609,362724,499336,217549,1079609
2023-04-26 12:25,1079622,362736,499336,217550,1079622
2023-04-26 12:26,1079635,362748,499336,217551,1079635
2023-04-26 12:27,1079648,362759,499336,217553,1079648
2023-04-26 12:28,1079661,362764,499339,217558,1079661
2023-04-26 12:29,1079673,362775,499339,217559,1079673
2023-04-26 12:30,1079687,362785,499342,217560,1079687
2023-04-26 12:31,1079700,362798,499342,217560,1079700
2023-04-26 12:32,1079712,362809,499343,217560,1079712
2023-04-26 12:33,1079726,362821,499343,217562,1079726
2023-04-26 12:34,1079739,362830,499345,217564,1079739
2023-04-26 12:35,1079752,362842,499345,217565,1079752
2023-04-26 12:36,1079766,362852,499348,217566,1079766
2023-04-26 12:37,1079778,362864,499348,217566,1079778
2023-04-26 12:38,1079792,362875,499350,217567,1079792
2023-04-26 12:39,1079805,362887,499350,217568,1079805
2023-04-26 12:40,1079818,362897,499352,217569,1079818
2023-04-26 12:41,1079831,362908,499352,217571,1079831
2023-04-26 12:42,1079844,362912,499357,217575,1079844
2023-04-26 12:43,1079856,362922,499358,217576,1079856
2023-04-26 12:44,1079869,362931,499358,217580,1079869
2023-04-26 12:45,1079882,362941,499360,217581,1079882
2023-04-26 12:46,1079895,362947,499365,217583,1079895
2023-04-26 12:47,1079910,362961,499365,217584,1079910
2023-04-26 12:48,1079922,362971,499367,217584,1079922
2023-04-26 12:49,1079935,362980,499367,217588,1079935
2023-04-26 12:50,1079948,362988,499372,217588,1079948
2023-04-26 12:51,1079961,362999,499372,217590,1079961
2023-04-26 12:52,1079975,363013,499371,217591,1079975
2023-04-26 12:53,1079988,363026,499371,217591,1079988
2023-04-26 12:54,1080002,363038,499372,217592,1080002
2023-04-26 12:55,1080014,363048,499372,217594,1080014
2023-04-26 12:56,1080028,363059,499373,217596,1080028
2023-04-26 12:57,1080041,363070,499373,217598,1080041
2023-04-26 12:58,1080054,363078,499377,217599,1080054
2023-04-26 12:59,1080067,363090,499377,217600,1080067
2023-04-26 13:00,1080080,363103,499377,217600,1080080
2023-04-26 13:01,1080094,363114,499377,217603,1080094
2023-04-26 13:02,1080107,363126,499377,217604,1080107
2023-04-26 13:03,1080120,363139,499377,217604,1080120
2023-04-26 13:04,1080133,363145,499381,217607,1080133
2023-04-26 13:05,1080147,363157,499381,217609,1080147
2023-04-26 13:06,1080161,363167,499385,217609,1080161
2023-04-26 13:08,1080175,363179,499385,217611,1080175
2023-04-26 13:09,1080188,363189,499386,217613,1080188
2023-04-26 13:10,1080201,363202,499386,217613,1080201
2023-04-26 13:11,1080214,363214,499387,217613,1080214
2023-04-26 13:12,1080227,363226,499387,217614,1080227
2023-04-26 13:13,1080241,363237,499387,217617,1080241
2023-04-26 13:14,1080255,363251,499387,217617,1080255
2023-04-26 13:15,1080268,363258,499390,217620,1080268
2023-04-26 13:16,1080282,363269,499391,217622,1080282
2023-04-26 13:17,1080295,363279,499391,217625,1080295
2023-04-26 13:18,1080309,363289,499393,217627,1080309
2023-04-26 13:19,1080323,363303,499393,217627,1080323
2023-04-26 13:20,1080337,363313,499397,217627,1080337
2023-04-26 13:21,1080349,363324,499397,217628,1080349
2023-04-26 13:22,1080363,363336,499398,217629,1080363
2023-04-26 13:23,1080376,363347,499398,217631,1080376
2023-04-26 13:24,1080390,363355,499403,217632,1080390
2023-04-26 13:25,1080404,363366,499403,217635,1080404
2023-04-26 13:26,1080419,363374,499408,217637,1080419
2023-04-26 13:27,1080432,363387,499408,217637,1080432
2023-04-26 13:28,1080445,363389,499415,217641,1080445
2023-04-26 13:29,1080460,363403,499415,217642,1080460
2023-04-26 13:30,1080473,363415,499416,217642,1080473
2023-04-26 13:31,1080487,363426,499416,217645,1080487
2023-04-26 13:32,1080500,363437,499417,217646,1080500
2023-04-26 13:33,1080514,363448,499418,217648,1080514
2023-04-26 13:34,1080528,363459,499418,217651,1080528
2023-04-26 13:35,1080541,363468,499420,217653,1080541
2023-04-26 13:36,1080554,363480,499420,217654,1080554
2023-04-26 13:37,1080568,363489,499423,217656,1080568
2023-04-26 13:38,1080581,363501,499423,217657,1080581
2023-04-26 13:39,1080594,363514,499423,217657,1080594
2023-04-26 13:40,1080607,363525,499423,217659,1080607
2023-04-26 13:41,1080620,363536,499424,217660,1080620
2023-04-26 13:42,1080633,363547,499424,217662,1080633
2023-04-26 13:43,1080647,363559,499425,217663,1080647
2023-04-26 13:44,1080660,363570,499426,217664,1080660
2023-04-26 13:45,1080673,363583,499426,217664,1080673
2023-04-26 13:46,1080686,363591,499429,217666,1080686
2023-04-26 13:47,1080699,363604,499429,217666,1080699
2023-04-26 13:48,1080712,363612,499432,217668,1080712
2023-04-26 13:49,1080725,363623,499432,217670,1080725
2023-04-26 13:50,1080740,363636,499435,217669,1080740
2023-04-26 13:51,1080753,363648,499435,217670,1080753
2023-04-26 13:52,1080765,363658,499436,217671,1080765
2023-04-26 13:53,1080779,363670,499436,217673,1080779
2023-04-26 13:55,1080792,363680,499438,217674,1080792
2023-04-26 13:56,1080805,363692,499438,217675,1080805
2023-04-26 13:57,1080817,363703,499439,217675,1080817
2023-04-26 13:58,1080831,363715,499439,217677,1080831
2023-04-26 13:59,1080844,363726,499439,217679,1080844
2023-04-26 14:00,1080857,363737,499439,217681,1080857
2023-04-26 14:01,1080873,363752,499440,217681,1080873
2023-04-26 14:02,1080887,363766,499440,217681,1080887
2023-04-26 14:03,1080901,363777,499441,217683,1080901
2023-04-26 14:04,1080915,363790,499441,217684,1080915
2023-04-26 14:05,1080929,363803,499441,217685,1080929
2023-04-26 14:06,1080944,363817,499441,217686,1080944
2023-04-26 14:07,1080958,363830,499442,217686,1080958
2023-04-26 14:08,1080972,363844,499442,217686,1080972
2023-04-26 14:09,1080985,363856,499442,217687,1080985
2023-04-26 14:10,1081000,363869,499442,217689,1081000
2023-04-26 14:11,1081013,363879,499444,217690,1081013
2023-04-26 14:12,1081027,363893,499444,217690,1081027
2023-04-26 14:13,1081042,363901,499446,217695,1081042
2023-04-26 14:14,1081055,363913,499446,217696,1081055
2023-04-26 14:15,1081070,363925,499448,217697,1081070
2023-04-26 14:16,1081083,363937,499448,217698,1081083
2023-04-26 14:17,1081098,363950,499450,217698,1081098
2023-04-26 14:18,1081112,363961,499450,217701,1081112
2023-04-26 14:19,1081126,363971,499453,217702,1081126
2023-04-26 14:20,1081141,363985,499453,217703,1081141
2023-04-26 14:21,1081155,363997,499455,217703,1081155
2023-04-26 14:22,1081170,364012,499455,217703,1081170
2023-04-26 14:23,1081184,364023,499456,217705,1081184
2023-04-26 14:24,1081199,364037,499456,217706,1081199
2023-04-26 14:25,1081213,364049,499457,217707,1081213
2023-04-26 14:26,1081227,364061,499458,217708,1081227
2023-04-26 14:27,1081242,364076,499458,217708,1081242
2023-04-26 14:28,1081256,364085,499459,217712,1081256
2023-04-26 14:29,1081269,364097,499459,217713,1081269
2023-04-26 14:30,1081284,364109,499461,217714,1081284
2023-04-26 14:31,1081298,364120,499461,217717,1081298
2023-04-26 14:32,1081314,364133,499464,217717,1081314
2023-04-26 14:33,1081329,364144,499464,217721,1081329
2023-04-26 14:34,1081343,364156,499465,217722,1081343
2023-04-26 14:35,1081357,364169,499466,217722,1081357
2023-04-26 14:36,1081372,364183,499466,217723,1081372
2023-04-26 14:37,1081386,364193,499468,217725,1081386
2023-04-26 14:38,1081401,364207,499468,217726,1081401
2023-04-26 14:39,1081415,364215,499471,217729,1081415
2023-04-26 14:40,1081429,364228,499471,217730,1081429
2023-04-26 14:42,1081443,364239,499471,217733,1081443
2023-04-26 14:43,1081457,364253,499471,217733,1081457
2023-04-26 14:44,1081471,364261,499473,217737,1081471
2023-04-26 14:45,1081485,364272,499476,217737,1081485
2023-04-26 14:46,1081499,364285,499476,217738,1081499
2023-04-26 14:47,1081513,364295,499477,217741,1081513
2023-04-26 14:48,1081527,364307,499477,217743,1081527
2023-04-26 14:49,1081541,364320,499478,217743,1081541
2023-04-26 14:50,1081556,364335,499478,217743,1081556
2023-04-26 14:51,1081570,364346,499479,217745,1081570
2023-04-26 14:52,1081585,364361,499479,217745,1081585
2023-04-26 14:53,1081598,364372,499479,217747,1081598
2023-04-26 14:54,1081613,364387,499479,217747,1081613
2023-04-26 14:55,1081628,364398,499480,217750,1081628
2023-04-26 14:56,1081644,364413,499480,217751,1081644
2023-04-26 14:57,1081658,364426,499480,217752,1081658
2023-04-26 14:58,1081671,364439,499480,217752,1081671
2023-04-26 14:59,1081685,364453,499480,217752,1081685
2023-04-26 15:00,1081700,364465,499480,217755,1081700
2023-04-26 15:01,1081718,364480,499483,217755,1081718
2023-04-26 15:02,1081734,364496,499483,217755,1081734
2023-04-26 15:03,1081752,364512,499485,217755,1081752
2023-04-26 15:04,1081769,364528,499485,217756,1081769
2023-04-26 15:05,1081785,364541,499487,217757,1081785
2023-04-26 15:06,1081803,364559,499487,217757,1081803
2023-04-26 15:07,1081821,364576,499488,217757,1081821
2023-04-26 15:08,1081840,364595,499488,217757,1081840
2023-04-26 15:09,1081858,364610,499489,217759,1081858
2023-04-26 15:10,1081875,364627,499489,217759,1081875
2023-04-26 15:11,1081892,364642,499491,217759,1081892
2023-04-26 15:12,1081910,364658,499491,217761,1081910
2023-04-26 15:13,1081927,364674,499492,217761,1081927
2023-04-26 15:14,1081945,364692,499492,217761,1081945
2023-04-26 15:15,1081961,364706,499492,217763,1081961
2023-04-26 15:16,1081979,364723,499492,217764,1081979
2023-04-26 15:17,1081995,364739,499492,217764,1081995
2023-04-26 15:18,1082013,364753,499492,217768,1082013
2023-04-26 15:19,1082031,364766,499496,217769,1082031
2023-04-26 15:20,1082049,364783,499496,217770,1082049
2023-04-26 15:21,1082067,364798,499499,217770,1082067
2023-04-26 15:22,1082084,364815,499499,217770,1082084
2023-04-26 15:23,1082100,364826,499503,217771,1082100
2023-04-26 15:24,1082118,364840,499503,217775,1082118
2023-04-26 15:25,1082134,364855,499504,217775,1082134
2023-04-26 15:26,1082151,364872,499504,217775,1082151
2023-04-26 15:27,1082170,364888,499505,217777,1082170
2023-04-26 15:29,1082188,364906,499505,217777,1082188
2023-04-26 15:30,1082205,364918,499508,217779,1082205
2023-04-26 15:31,1082223,364935,499508,217780,1082223
2023-04-26 15:32,1082240,364952,499508,217780,1082240
2023-04-26 15:33,1082257,364966,499508,217783,1082257
2023-04-26 15:34,1082275,364981,499510,217784,1082275
2023-04-26 15:35,1082292,364998,499510,217784,1082292
2023-04-26 15:36,1082311,365015,499512,217784,1082311
2023-04-26 15:37,1082329,365028,499515,217786,1082329
2023-04-26 15:38,1082346,365043,499515,217788,1082346
2023-04-26 15:39,1082363,365056,499516,217791,1082363
2023-04-26 15:40,1082381,365073,499516,217792,1082381
2023-04-26 15:41,1082397,365089,499516,217792,1082397
2023-04-26 15:42,1082416,365106,499516,217794,1082416
2023-04-26 15:43,1082432,365121,499516,217795,1082432
2023-04-26 15:44,1082451,365139,499516,217796,1082451
2023-04-26 15:45,1082468,365154,499517,217797,1082468
2023-04-26 15:46,1082485,365170,499517,217798,1082485
2023-04-26 15:47,1082502,365186,499518,217798,1082502
2023-04-26 15:48,1082520,365204,499518,217798,1082520
2023-04-26 15:49,1082537,365220,499519,217798,1082537
2023-04-26 15:50,1082556,365237,499519,217800,1082556
2023-04-26 15:51,1082573,365252,499520,217801,1082573
2023-04-26 15:52,1082591,365269,499520,217802,1082591
2023-04-26 15:53,1082608,365283,499523,217802,1082608
2023-04-26 15:54,1082626,365298,499526,217802,1082626
2023-04-26 15:55,1082642,365313,499526,217803,1082642
2023-04-26 15:56,1082662,365331,499527,217804,1082662
2023-04-26 15:57,1082678,365347,499527,217804,1082678
2023-04-26 15:58,1082697,365362,499528,217807,1082697
2023-04-26 15:59,1082715,365379,499528,217808,1082715
2023-04-26 16:00,1082726,365386,499531,217809,1082726
2023-04-26 16:01,1082736,365394,499531,217811,1082736
2023-04-26 16:02,1082745,365402,499531,217812,1082745
2023-04-26 16:03,1082755,365411,499531,217813,1082755
2023-04-26 16:04,1082764,365417,499533,217814,1082764
2023-04-26 16:05,1082773,365423,499533,217817,1082773
2023-04-26 16:06,1082781,365429,499535,217817,1082781
2023-04-26 16:07,1082790,365437,499535,217818,1082790
2023-04-26 16:08,1082801,365443,499538,217820,1082801
2023-04-26 16:09,1082809,365451,499538,217820,1082809
2023-04-26 16:10,1082818,365456,499539,217823,1082818
2023-04-26 16:11,1082827,365465,499539,217823,1082827
2023-04-26 16:12,1082836,365470,499541,217825,1082836
2023-04-26 16:13,1082845,365479,499541,217825,1082845
2023-04-26 16:15,1082854,365485,499544,217825,1082854
2023-04-26 16:16,1082864,365495,499544,217825,1082864
2023-04-26 16:17,1082873,365504,499543,217826,1082873
2023-04-26 16:18,1082881,365512,499543,217826,1082881
2023-04-26 16:19,1082890,365519,499544,217827,1082890
2023-04-26 16:20,1082899,365529,499544,217826,1082899
2023-04-26 16:21,1082908,365535,499547,217826,1082908
2023-04-26 16:22,1082916,365541,499547,217828,1082916
2023-04-26 16:23,1082925,365548,499548,217829,1082925
2023-04-26 16:24,1082935,365557,499548,217830,1082935
2023-04-26 16:25,1082944,365563,499550,217831,1082944
2023-04-26 16:26,1082952,365569,499551,217832,1082952
2023-04-26 16:27,1082961,365574,499551,217836,1082961
2023-04-26 16:28,1082970,365581,499552,217837,1082970
2023-04-26 16:29,1082979,365588,499552,217839,1082979
2023-04-26 16:30,1082989,365597,499553,217839,1082989
2023-04-26 16:31,1082997,365604,499553,217840,1082997
2023-04-26 16:32,1083006,365611,499554,217841,1083006
2023-04-26 16:33,1083014,365619,499554,217841,1083014
2023-04-26 16:34,1083023,365625,499556,217842,1083023
2023-04-26 16:35,1083032,365633,499556,217843,1083032
2023-04-26 16:36,1083041,365640,499558,217843,1083041
2023-04-26 16:37,1083050,365648,499558,217844,1083050
2023-04-26 16:38,1083058,365653,499560,217845,1083058
2023-04-26 16:39,1083067,365662,499560,217845,1083067
2023-04-26 16:40,1083076,365666,499564,217846,1083076
2023-04-26 16:41,1083085,365675,499564,217846,1083085
2023-04-26 16:42,1083094,365677,499569,217848,1083094
2023-04-26 16:43,1083103,365684,499569,217850,1083103
2023-04-26 16:44,1083112,365692,499570,217850,1083112
2023-04-26 16:45,1083121,365699,499570,217852,1083121
2023-04-26 16:46,1083130,365707,499570,217853,1083130
2023-04-26 16:47,1083138,365715,499570,217853,1083138
2023-04-26 16:48,1083148,365724,499571,217853,1083148
2023-04-26 16:49,1083156,365731,499571,217854,1083156
2023-04-26 16:50,1083165,365735,499575,217855,1083165
2023-04-26 16:51,1083174,365742,499575,217857,1083174
2023-04-26 16:52,1083183,365748,499577,217858,1083183
2023-04-26 16:53,1083192,365757,499577,217858,1083192
2023-04-26 16:54,1083201,365764,499579,217858,1083201
2023-04-26 16:55,1083210,365771,499579,217860,1083210
2023-04-26 16:56,1083218,365777,499581,217860,1083218
2023-04-26 16:57,1083227,365786,499581,217860,1083227
2023-04-26 16:58,1083236,365790,499584,217862,1083236
2023-04-26 16:59,1083244,365798,499584,217862,1083244
2023-04-26 17:00,1083265,365818,499585,217862,1083265
2023-04-26 17:02,1083287,365839,499585,217863,1083287
2023-04-26 17:03,1083309,365861,499585,217863,1083309
2023-04-26 17:04,1083330,365881,499585,217864,1083330
2023-04-26 17:05,1083352,365901,499586,217865,1083352
2023-04-26 17:06,1083374,365922,499586,217866,1083374
2023-04-26 17:07,1083396,365943,499587,217866,1083396
2023-04-26 17:08,1083417,365963,499587,217867,1083417
2023-04-26 17:09,1083439,365984,499587,217868,1083439
2023-04-26 17:10,1083461,366007,499587,217867,1083461
2023-04-26 17:11,1083482,366024,499591,217867,1083482
2023-04-26 17:12,1083503,366044,499591,217868,1083503
2023-04-26 17:13,1083525,366066,499591,217868,1083525
2023-04-26 17:14,1083547,366086,499591,217870,1083547
2023-04-26 17:15,1083569,366106,499593,217870,1083569
2023-04-26 17:16,1083591,366126,499593,217872,1083591
2023-04-26 17:17,1083613,366145,499595,217873,1083613
2023-04-26 17:18,1083635,366168,499595,217872,1083635
2023-04-26 17:19,1083658,366185,499599,217874,1083658
2023-04-26 17:20,1083680,366206,499599,217875,1083680
2023-04-26 17:21,1083702,366225,499601,217876,1083702
2023-04-26 17:22,1083724,366246,499601,217877,1083724
2023-04-26 17:23,1083746,366267,499601,217878,1083746
2023-04-26 17:24,1083769,366290,499601,217878,1083769
2023-04-26 17:25,1083790,366307,499603,217880,1083790
2023-04-26 17:26,1083811,366326,499603,217882,1083811
2023-04-26 17:27,1083833,366344,499605,217884,1083833
2023-04-26 17:28,1083854,366364,499605,217885,1083854
2023-04-26 17:29,1083877,366384,499608,217885,1083877
2023-04-26 17:30,1083899,366405,499608,217886,1083899
2023-04-26 17:31,1083921,366424,499609,217888,1083921
2023-04-26 17:32,1083942,366444,499609,217889,1083942
2023-04-26 17:33,1083964,366461,499612,217891,1083964
2023-04-26 17:34,1083987,366485,499612,217890,1083987
2023-04-26 17:35,1084007,366503,499612,217892,1084007
2023-04-26 17:36,1084030,366525,499612,217893,1084030
2023-04-26 17:37,1084052,366538,499619,217895,1084052
2023-04-26 17:38,1084074,366559,499619,217896,1084074
2023-04-26 17:39,1084096,366580,499619,217897,1084096
2023-04-26 17:40,1084118,366600,499619,217899,1084118
2023-04-26 17:41,1084139,366619,499620,217900,1084139
2023-04-26 17:42,1084163,366641,499621,217901,1084163
2023-04-26 17:43,1084184,366662,499621,217901,1084184
2023-04-26 17:44,1084207,366681,499624,217902,1084207
2023-04-26 17:45,1084229,366701,499624,217904,1084229
2023-04-26 17:46,1084250,366723,499624,217903,1084250
2023-04-26 17:47,1084273,366746,499624,217903,1084273
2023-04-26 17:49,1084294,366765,499624,217905,1084294
2023-04-26 17:50,1084316,366786,499624,217906,1084316
2023-04-26 17:51,1084338,366807,499624,217907,1084338
2023-04-26 17:52,1084360,366826,499624,217910,1084360
2023-04-26 17:53,1084381,366846,499624,217911,1084381
2023-04-26 17:54,1084404,366858,499635,217911,1084404
2023-04-26 17:55,1084425,366874,499635,217916,1084425
2023-04-26 17:56,1084446,366889,499638,217919,1084446
2023-04-26 17:57,1084468,366909,499638,217921,1084468
2023-04-26 17:58,1084489,366928,499640,217921,1084489
2023-04-26 17:59,1084512,366948,499640,217924,1084512
2023-04-26 18:00,1084537,366968,499642,217927,1084537
2023-04-26 18:01,1084567,366998,499642,217927,1084567
2023-04-26 18:02,1084602,367029,499645,217928,1084602
2023-04-26 18:03,1084633,367056,499645,217932,1084633
2023-04-26 18:04,1084665,367085,499646,217934,1084665
2023-04-26 18:05,1084697,367116,499647,217934,1084697
2023-04-26 18:06,1084727,367144,499648,217935,1084727
2023-04-26 18:07,1084760,367173,499648,217939,1084760
2023-04-26 18:08,1084790,367203,499648,217939,1084790
2023-04-26 18:09,1084822,367232,499648,217942,1084822
2023-04-26 18:10,1084853,367261,499648,217944,1084853
2023-04-26 18:11,1084886,367292,499648,217946,1084886
2023-04-26 18:12,1084918,367323,499648,217947,1084918
2023-04-26 18:13,1084949,367354,499648,217947,1084949
2023-04-26 18:14,1084981,367385,499648,217948,1084981
2023-04-26 18:15,1085012,367415,499648,217949,1085012
2023-04-26 18:16,1085042,367430,499663,217949,1085042
2023-04-26 18:17,1085074,367461,499663,217950,1085074
2023-04-26 18:18,1085108,367492,499663,217953,1085108
2023-04-26 18:19,1085139,367523,499663,217953,1085139
2023-04-26 18:20,1085171,367551,499664,217956,1085171
2023-04-26 18:21,1085203,367583,499664,217956,1085203
2023-04-26 18:22,1085235,367611,499665,217959,1085235
2023-04-26 18:23,1085268,367640,499665,217963,1085268
2023-04-26 18:24,1085298,367666,499667,217965,1085298
2023-04-26 18:25,1085331,367696,499669,217966,1085331
2023-04-26 18:26,1085364,367728,499669,217967,1085364
2023-04-26 18:27,1085396,367754,499672,217970,1085396
2023-04-26 18:28,1085427,367782,499672,217973,1085427
2023-04-26 18:29,1085459,367811,499673,217975,1085459
2023-04-26 18:30,1085490,367839,499673,217978,1085490
2023-04-26 18:31,1085522,367866,499677,217979,1085522
2023-04-26 18:32,1085553,367896,499677,217980,1085553
2023-04-26 18:33,1085585,367927,499678,217980,1085585
2023-04-26 18:34,1085616,367957,499678,217981,1085616
2023-04-26 18:36,1085647,367984,499680,217983,1085647
2023-04-26 18:37,1085681,368016,499680,217985,1085681
2023-04-26 18:38,1085712,368045,499682,217985,1085712
2023-04-26 18:39,1085743,368074,499682,217987,1085743
2023-04-26 18:40,1085774,368102,499684,217988,1085774
2023-04-26 18:41,1085807,368133,499684,217990,1085807
2023-04-26 18:42,1085839,368162,499686,217991,1085839
2023-04-26 18:43,1085872,368193,499687,217992,1085872
2023-04-26 18:44,1085905,368224,499687,217994,1085905
2023-04-26 18:45,1085938,368254,499690,217994,1085938
2023-04-26 18:46,1085968,368282,499690,217996,1085968
2023-04-26 18:47,1086000,368311,499690,217999,1086000
2023-04-26 18:48,1086032,368335,499697,218000,1086032
2023-04-26 18:49,1086065,368367,499697,218001,1086065
2023-04-26 18:50,1086096,368388,499706,218002,1086096
2023-04-26 18:51,1086128,368419,499706,218003,1086128
2023-04-26 18:52,1086159,368443,499713,218003,1086159
2023-04-26 18:53,1086191,368474,499713,218004,1086191
2023-04-26 18:54,1086221,368494,499720,218007,1086221
2023-04-26 18:55,1086253,368524,499720,218009,1086253
2023-04-26 18:56,1086285,368545,499730,218010,1086285
2023-04-26 18:57,1086316,368576,499730,218010,1086316
2023-04-26 18:58,1086349,368598,499740,218011,1086349
2023-04-26 18:59,1086382,368628,499740,218014,1086382
2023-04-26 19:00,1086404,368644,499745,218015,1086404
2023-04-26 19:01,1086416,368654,499745,218017,1086416
2023-04-26 19:02,1086429,368656,499756,218017,1086429
2023-04-26 19:03,1086442,368669,499756,218017,1086442
2023-04-26 19:04,1086454,368678,499757,218019,1086454
2023-04-26 19:05,1086468,368686,499761,218021,1086468
2023-04-26 19:06,1086480,368697,499761,218022,1086480
2023-04-26 19:07,1086493,368704,499766,218023,1086493
2023-04-26 19:08,1086505,368716,499766,218023,1086505
2023-04-26 19:09,1086518,368723,499771,218024,1086518
2023-04-26 19:10,1086531,368735,499771,218025,1086531
2023-04-26 19:11,1086544,368741,499776,218027,1086544
2023-04-26 19:12,1086556,368750,499778,218028,1086556
2023-04-26 19:13,1086569,368763,499778,218028,1086569
2023-04-26 19:14,1086582,368766,499786,218030,1086582
2023-04-26 19:15,1086594,368775,499786,218033,1086594
2023-04-26 19:16,1086607,368786,499788,218033,1086607
2023-04-26 19:17,1086620,368798,499789,218033,1086620
2023-04-26 19:18,1086632,368810,499789,218033,1086632
2023-04-26 19:19,1086646,368819,499793,218034,1086646
2023-04-26 19:20,1086659,368832,499793,218034,1086659
2023-04-26 19:22,1086672,368842,499795,218035,1086672
2023-04-26 19:23,1086686,368856,499795,218035,1086686
2023-04-26 19:24,1086698,368860,499802,218036,1086698
2023-04-26 19:25,1086712,368872,499802,218038,1086712
2023-04-26 19:26,1086724,368881,499805,218038,1086724
2023-04-26 19:27,1086736,368891,499805,218040,1086736
2023-04-26 19:28,1086750,368904,499806,218040,1086750
2023-04-26 19:29,1086763,368915,499807,218041,1086763
2023-04-26 19:30,1086776,368922,499812,218042,1086776
2023-04-26 19:31,1086790,368936,499812,218042,1086790
2023-04-26 19:32,1086803,368942,499817,218044,1086803
2023-04-26 19:33,1086816,368955,499817,218044,1086816
2023-04-26 19:34,1086829,368964,499819,218046,1086829
2023-04-26 19:35,1086841,368976,499819,218046,1086841
2023-04-26 19:36,1086855,368986,499822,218047,1086855
2023-04-26 19:37,1086867,368995,499822,218050,1086867
2023-04-26 19:38,1086880,369003,499825,218052,1086880
2023-04-26 19:39,1086893,369015,499825,218053,1086893
2023-04-26 19:40,1086906,369024,499828,218054,1086906
2023-04-26 19:41,1086920,369036,499828,218056,1086920
2023-04-26 19:42,1086933,369044,499833,218056,1086933
2023-04-26 19:43,1086946,369057,499833,218056,1086946
2023-04-26 19:44,1086959,369070,499833,218056,1086959
2023-04-26 19:45,1086974,369081,499835,218058,1086974
2023-04-26 19:46,1086986,369093,499835,218058,1086986
2023-04-26 19:47,1086998,369099,499841,218058,1086998
2023-04-26 19:48,1087012,369112,499841,218059,1087012
2023-04-26 19:49,1087027,369121,499844,218062,1087027
2023-04-26 19:50,1087040,369133,499844,218063,1087040
2023-04-26 19:51,1087052,369142,499847,218063,1087052
2023-04-26 19:52,1087065,369155,499847,218063,1087065
2023-04-26 19:53,1087079,369166,499850,218063,1087079
2023-04-26 19:54,1087092,369179,499850,218063,1087092
2023-04-26 19:55,1087104,369188,499851,218065,1087104
2023-04-26 19:56,1087117,369201,499851,218065,1087117
2023-04-26 19:57,1087131,369210,499856,218065,1087131
2023-04-26 19:58,1087144,369222,499856,218066,1087144
2023-04-26 19:59,1087158,369231,499859,218068,1087158
2023-04-26 20:00,1087170,369243,499859,218068,1087170
2023-04-26 20:01,1087182,369251,499861,218070,1087182
2023-04-26 20:02,1087195,369261,499861,218073,1087195
2023-04-26 20:03,1087207,369269,499863,218075,1087207
2023-04-26 20:04,1087220,369282,499863,218075,1087220
2023-04-26 20:05,1087232,369289,499866,218077,1087232
2023-04-26 20:06,1087244,369301,499866,218077,1087244
2023-04-26 20:07,1087256,369307,499869,218080,1087256
2023-04-26 20:09,1087270,369318,499869,218083,1087270
2023-04-26 20:10,1087283,369328,499870,218085,1087283
2023-04-26 20:11,1087295,369339,499870,218086,1087295
2023-04-26 20:12,1087307,369347,499873,218087,1087307
2023-04-26 20:13,1087320,369359,499873,218088,1087320
2023-04-26 20:14,1087332,369371,499873,218088,1087332
2023-04-26 20:15,1087345,369384,499873,218088,1087345
2023-04-26 20:16,1087359,369394,499873,218092,1087359
2023-04-26 20:17,1087372,369408,499873,218091,1087372
2023-04-26 20:18,1087383,369417,499873,218093,1087383
2023-04-26 20:19,1087396,369419,499882,218095,1087396
2023-04-26 20:20,1087409,369430,499884,218095,1087409
2023-04-26 20:21,1087421,369441,499884,218096,1087421
2023-04-26 20:22,1087434,369449,499887,218098,1087434
2023-04-26 20:23,1087446,369459,499887,218100,1087446
2023-04-26 20:24,1087458,369469,499888,218101,1087458
2023-04-26 20:25,1087472,369479,499888,218105,1087472
2023-04-26 20:26,1087485,369490,499888,218107,1087485
2023-04-26 20:27,1087497,369499,499888,218110,1087497
2023-04-26 20:28,1087509,369509,499890,218110,1087509
2023-04-26 20:29,1087522,369521,499890,218111,1087522
2023-04-26 20:30,1087534,369528,499894,218112,1087534
2023-04-26 20:31,1087546,369540,499894,218112,1087546
2023-04-26 20:32,1087558,369550,499895,218113,1087558
2023-04-26 20:33,1087572,369559,499897,218116,1087572
2023-04-26 20:34,1087584,369561,499902,218121,1087584
2023-04-26 20:35,1087597,369574,499902,218121,1087597
2023-04-26 20:36,1087609,369581,499906,218122,1087609
2023-04-26 20:37,1087621,369591,499907,218123,1087621
2023-04-26 20:38,1087634,369602,499907,218125,1087634
2023-04-26 20:39,1087648,369614,499907,218127,1087648
2023-04-26 20:40,1087660,369624,499907,218129,1087660
2023-04-26 20:41,1087673,369632,499911,218130,1087673
2023-04-26 20:42,1087685,369643,499911,218131,1087685
2023-04-26 20:43,1087698,369655,499911,218132,1087698
2023-04-26 20:44,1087712,369669,499911,218132,1087712
2023-04-26 20:45,1087726,369680,499913,218133,1087726
2023-04-26 20:46,1087739,369692,499913,218134,1087739
2023-04-26 20:47,1087751,369699,499915,218137,1087751
2023-04-26 20:48,1087763,369710,499915,218138,1087763
2023-04-26 20:49,1087776,369718,499916,218142,1087776
2023-04-26 20:50,1087787,369730,499916,218141,1087787
2023-04-26 20:51,1087801,369736,499921,218144,1087801
2023-04-26 20:52,1087813,369747,499921,218145,1087813
2023-04-26 20:53,1087828,369759,499923,218146,1087828
2023-04-26 20:54,1087840,369770,499923,218147,1087840
2023-04-26 20:56,1087853,369782,499923,218148,1087853
2023-04-26 20:57,1087865,369793,499923,218149,1087865
2023-04-26 20:58,1087878,369803,499923,218152,1087878
2023-04-26 20:59,1087890,369815,499923,218152,1087890
2023-04-26 21:00,1087903,369818,499932,218153,1087903
2023-04-26 21:01,1087920,369833,499932,218155,1087920
2023-04-26 21:02,1087936,369845,499936,218155,1087936
2023-04-26 21:03,1087953,369859,499937,218157,1087953
2023-04-26 21:04,1087970,369873,499937,218160,1087970
2023-04-26 21:05,1087985,369878,499945,218162,1087985
2023-04-26 21:06,1088003,369896,499945,218162,1088003
2023-04-26 21:07,1088019,369908,499947,218164,1088019
2023-04-26 21:08,1088035,369922,499947,218166,1088035
2023-04-26 21:09,1088053,369934,499951,218168,1088053
2023-04-26 21:10,1088070,369948,499952,218170,1088070
2023-04-26 21:11,1088086,369962,499952,218172,1088086
2023-04-26 21:12,1088103,369974,499956,218173,1088103
2023-04-26 21:13,1088118,369989,499956,218173,1088118
2023-04-26 21:14,1088135,370000,499960,218175,1088135
2023-04-26 21:15,1088153,370017,499960,218176,1088153
2023-04-26 21:16,1088170,370033,499961,218176,1088170
2023-04-26 21:17,1088186,370044,499964,218178,1088186
2023-04-26 21:18,1088203,370060,499964,218179,1088203
2023-04-26 21:19,1088219,370072,499967,218180,1088219
2023-04-26 21:20,1088235,370089,499967,218179,1088235
2023-04-26 21:21,1088251,370099,499971,218181,1088251
2023-04-26 21:22,1088269,370116,499971,218182,1088269
2023-04-26 21:23,1088285,370124,499977,218184,1088285
2023-04-26 21:24,1088302,370140,499977,218185,1088302
2023-04-26 21:25,1088319,370154,499979,218186,1088319
2023-04-26 21:26,1088335,370167,499980,218188,1088335
2023-04-26 21:27,1088351,370182,499980,218189,1088351
2023-04-26 21:28,1088368,370193,499983,218192,1088368
2023-04-26 21:29,1088384,370209,499983,218192,1088384
2023-04-26 21:30,1088403,370221,499987,218195,1088403
2023-04-26 21:31,1088419,370235,499987,218197,1088419
2023-04-26 21:32,1088435,370249,499988,218198,1088435
2023-04-26 21:33,1088453,370265,499989,218199,1088453
2023-04-26 21:34,1088469,370281,499989,218199,1088469
2023-04-26 21:35,1088487,370295,499990,218202,1088487
2023-04-26 21:36,1088504,370310,499990,218204,1088504
2023-04-26 21:37,1088520,370318,499996,218206,1088520
2023-04-26 21:38,1088536,370334,499996,218206,1088536
2023-04-26 21:39,1088552,370346,499999,218207,1088552
2023-04-26 21:40,1088571,370363,499999,218209,1088571
2023-04-26 21:41,1088587,370374,500003,218210,1088587
2023-04-26 21:43,1088603,370384,500007,218212,1088603
2023-04-26 21:44,1088620,370400,500007,218213,1088620
2023-04-26 21:45,1088636,370414,500008,218214,1088636
2023-04-26 21:46,1088654,370432,500008,218214,1088654
2023-04-26 21:47,1088670,370442,500013,218215,1088670
2023-04-26 21:48,1088687,370457,500013,218217,1088687
2023-04-26 21:49,1088702,370469,500015,218218,1088702
2023-04-26 21:50,1088719,370486,500015,218218,1088719
2023-04-26 21:51,1088736,370494,500023,218219,1088736
2023-04-26 21:52,1088751,370506,500023,218222,1088751
2023-04-26 21:53,1088769,370522,500023,218224,1088769
2023-04-26 21:54,1088784,370532,500027,218225,1088784
2023-04-26 21:55,1088801,370543,500030,218228,1088801
2023-04-26 21:56,1088817,370556,500031,218230,1088817
2023-04-26 21:57,1088834,370571,500031,218232,1088834
2023-04-26 21:58,1088851,370585,500033,218233,1088851
2023-04-26 21:59,1088868,370601,500033,218234,1088868
2023-04-26 22:00,1088889,370615,500038,218236,1088889
2023-04-26 22:01,1088920,370645,500038,218237,1088920
2023-04-26 22:02,1088952,370671,500040,218241,1088952
2023-04-26 22:03,1088984,370703,500040,218241,1088984
2023-04-26 22:04,1089017,370734,500042,218241,1089017
2023-04-26 22:05,1089047,370763,500042,218242,1089047
2023-04-26 22:06,1089080,370789,500045,218246,1089080
2023-04-26 22:07,1089112,370820,500045,218247,1089112
2023-04-26 22:08,1089143,370850,500046,218247,1089143
2023-04-26 22:09,1089176,370873,500050,218253,1089176
2023-04-26 22:10,1089207,370900,500050,218257,1089207
2023-04-26 22:11,1089237,370925,500054,218258,1089237
2023-04-26 22:12,1089271,370960,500054,218257,1089271
2023-04-26 22:13,1089301,370985,500058,218258,1089301
2023-04-26 22:14,1089334,371017,500058,218259,1089334
2023-04-26 22:15,1089365,371044,500062,218259,1089365
2023-04-26 22:16,1089397,371075,500062,218260,1089397
2023-04-26 22:17,1089427,371099,500066,218262,1089427
2023-04-26 22:18,1089460,371131,500066,218263,1089460
2023-04-26 22:19,1089490,371159,500066,218265,1089490
2023-04-26 22:20,1089523,371189,500066,218268,1089523
2023-04-26 22:21,1089553,371218,500066,218269,1089553
2023-04-26 22:22,1089584,371248,500066,218270,1089584
2023-04-26 22:23,1089617,371281,500066,218270,1089617
2023-04-26 22:24,1089647,371308,500066,218273,1089647
2023-04-26 22:25,1089680,371338,500066,218276,1089680
2023-04-26 22:26,1089713,371368,500066,218279,1089713
2023-04-26 22:27,1089743,371381,500080,218282,1089743
2023-04-26 22:28,1089776,371408,500080,218288,1089776
2023-04-26 22:30,1089809,371434,500085,218290,1089809
2023-04-26 22:31,1089839,371462,500085,218292,1089839
2023-04-26 22:32,1089870,371489,500086,218295,1089870
2023-04-26 22:33,1089902,371521,500086,218295,1089902
2023-04-26 22:34,1089933,371543,500094,218296,1089933
2023-04-26 22:35,1089965,371571,500094,218300,1089965
2023-04-26 22:36,1089997,371599,500095,218303,1089997
2023-04-26 22:37,1090029,371630,500095,218304,1090029
2023-04-26 22:38,1090060,371660,500096,218304,1090060
2023-04-26 22:39,1090091,371690,500096,218305,1090091
2023-04-26 22:40,1090122,371718,500096,218308,1090122
2023-04-26 22:41,1090154,371749,500096,218309,1090154
2023-04-26 22:42,1090188,371776,500099,218313,1090188
2023-04-26 22:43,1090221,371809,500099,218313,1090221
2023-04-26 22:44,1090252,371835,500103,218314,1090252
2023-04-26 22:45,1090283,371865,500103,218315,1090283
2023-04-26 22:46,1090315,371889,500106,218320,1090315
2023-04-26 22:47,1090348,371921,500106,218321,1090348
2023-04-26 22:48,1090381,371952,500108,218321,1090381
2023-04-26 22:49,1090411,371981,500108,218322,1090411
2023-04-26 22:50,1090444,372010,500111,218323,1090444
2023-04-26 22:51,1090477,372044,500111,218322,1090477
2023-04-26 22:52,1090509,372072,500115,218322,1090509
2023-04-26 22:53,1090540,372102,500115,218323,1090540
2023-04-26 22:54,1090572,372130,500118,218324,1090572
2023-04-26 22:55,1090604,372159,500118,218327,1090604
2023-04-26 22:56,1090635,372187,500120,218328,1090635
2023-04-26 22:57,1090667,372218,500120,218329,1090667
2023-04-26 22:58,1090700,372247,500122,218331,1090700
2023-04-26 22:59,1090729,372274,500122,218333,1090729
2023-04-26 23:00,1090754,372295,500123,218336,1090754
2023-04-26 23:01,1090774,372312,500123,218339,1090774
2023-04-26 23:02,1090793,372327,500125,218341,1090793
2023-04-26 23:03,1090813,372346,500125,218342,1090813
2023-04-26 23:04,1090832,372362,500127,218343,1090832
2023-04-26 23:05,1090851,372378,500127,218346,1090851
2023-04-26 23:06,1090871,372393,500129,218349,1090871
2023-04-26 23:07,1090890,372410,500129,218351,1090890
2023-04-26 23:08,1090910,372424,500133,218353,1090910
2023-04-26 23:09,1090928,372442,500133,218353,1090928
2023-04-26 23:10,1090948,372458,500135,218355,1090948
2023-04-26 23:11,1090968,372477,500135,218356,1090968
2023-04-26 23:12,1090987,372491,500138,218358,1090987
2023-04-26 23:13,1091005,372509,500138,218358,1091005
2023-04-26 23:14,1091025,372523,500142,218360,1091025
2023-04-26 23:16,1091044,372537,500142,218365,1091044
2023-04-26 23:17,1091062,372551,500144,218367,1091062
2023-04-26 23:18,1091081,372567,500144,218370,1091081
2023-04-26 23:19,1091101,372579,500150,218372,1091101
2023-04-26 23:20,1091120,372597,500150,218373,1091120
2023-04-26 23:21,1091140,372613,500152,218375,1091140
2023-04-26 23:22,1091158,372630,500152,218376,1091158
2023-04-26 23:23,1091177,372645,500155,218377,1091177
2023-04-26 23:24,1091198,372665,500155,218378,1091198
2023-04-26 23:25,1091217,372679,500157,218381,1091217
2023-04-26 23:26,1091236,372694,500161,218381,1091236
2023-04-26 23:27,1091256,372712,500161,218383,1091256
2023-04-26 23:28,1091275,372726,500164,218385,1091275
2023-04-26 23:29,1091295,372746,500164,218385,1091295
2023-04-26 23:30,1091313,372761,500165,218387,1091313
2023-04-26 23:31,1091334,372772,500169,218393,1091334
2023-04-26 23:32,1091353,372789,500169,218395,1091353
2023-04-26 23:33,1091371,372804,500169,218398,1091371
2023-04-26 23:34,1091390,372823,500169,218398,1091390
2023-04-26 23:35,1091410,372838,500173,218399,1091410
2023-04-26 23:36,1091430,372856,500173,218401,1091430
2023-04-26 23:37,1091451,372876,500172,218403,1091451
2023-04-26 23:38,1091470,372895,500172,218403,1091470
2023-04-26 23:39,1091489,372911,500172,218406,1091489
2023-04-26 23:40,1091507,372927,500171,218409,1091507
2023-04-26 23:41,1091526,372945,500171,218410,1091526
2023-04-26 23:42,1091546,372958,500174,218414,1091546
2023-04-26 23:43,1091565,372975,500174,218416,1091565
2023-04-26 23:44,1091585,372989,500177,218419,1091585
2023-04-26 23:45,1091604,373005,500179,218420,1091604
2023-04-26 23:46,1091626,373024,500179,218423,1091626
2023-04-26 23:47,1091646,373043,500179,218424,1091646
2023-04-26 23:48,1091665,373061,500179,218425,1091665
2023-04-26 23:49,1091686,373080,500181,218425,1091686
2023-04-26 23:50,1091705,373099,500181,218425,1091705
2023-04-26 23:51,1091724,373114,500184,218426,1091724
2023-04-26 23:52,1091743,373132,500184,218427,1091743
2023-04-26 23:53,1091762,373149,500186,218427,1091762
2023-04-26 23:54,1091781,373166,500186,218429,1091781
2023-04-26 23:55,1091801,373180,500189,218432,1091801
2023-04-26 23:56,1091821,373200,500189,218432,1091821
2023-04-26 23:57,1091839,373214,500191,218434,1091839
2023-04-26 23:58,1091859,373230,500192,218437,1091859
2023-04-26 23:59,1091878,373247,500192,218439,1091878
2023-04-27 00:00,1091901,373266,500196,218439,1091901
2023-04-27 00:01,1091924,373285,500196,218443,1091924
2023-04-27 00:03,1091947,373301,500200,218446,1091947
2023-04-27 00:04,1091970,373324,500200,218446,1091970
2023-04-27 00:05,1091993,373344,500202,218447,1091993
2023-04-27 00:06,1092016,373366,500202,218448,1092016
2023-04-27 00:07,1092039,373387,500202,218450,1092039
2023-04-27 00:08,1092062,373408,500202,218452,1092062
2023-04-27 00:09,1092085,373429,500202,218454,1092085
2023-04-27 00:10,1092109,373453,500202,218454,1092109
2023-04-27 00:11,1092131,373473,500202,218456,1092131
2023-04-27 00:12,1092154,373495,500202,218457,1092154
2023-04-27 00:13,1092176,373517,500202,218457,1092176
2023-04-27 00:14,1092200,373537,500202,218461,1092200
2023-04-27 00:15,1092223,373540,500220,218463,1092223
2023-04-27 00:16,1092247,373561,500220,218466,1092247
2023-04-27 00:17,1092270,373581,500222,218467,1092270
2023-04-27 00:18,1092293,373604,500222,218467,1092293
2023-04-27 00:19,1092318,373626,500224,218468,1092318
2023-04-27 00:20,1092341,373647,500225,218469,1092341
2023-04-27 00:21,1092365,373667,500225,218473,1092365
2023-04-27 00:22,1092387,373681,500232,218474,1092387
2023-04-27 00:23,1092410,373704,500232,218474,1092410
2023-04-27 00:24,1092434,373724,500235,218475,1092434
2023-04-27 00:25,1092456,373745,500235,218476,1092456
2023-04-27 00:26,1092480,373766,500236,218478,1092480
2023-04-27 00:27,1092504,373789,500236,218479,1092504
2023-04-27 00:28,1092525,373807,500238,218480,1092525
2023-04-27 00:29,1092550,373830,500238,218482,1092550
2023-04-27 00:30,1092572,373850,500240,218482,1092572
2023-04-27 00:31,1092595,373870,500240,218485,1092595
2023-04-27 00:32,1092618,373891,500242,218485,1092618
2023-04-27 00:33,1092642,373913,500242,218487,1092642
2023-04-27 00:34,1092663,373933,500243,218487,1092663
2023-04-27 00:35,1092686,373956,500243,218487,1092686
2023-04-27 00:36,1092710,373975,500246,218489,1092710
2023-04-27 00:37,1092732,373995,500246,218491,1092732
2023-04-27 00:38,1092755,374017,500247,218491,1092755
2023-04-27 00:39,1092777,374037,500247,218493,1092777
2023-04-27 00:40,1092800,374053,500251,218496,1092800
2023-04-27 00:41,1092823,374074,500251,218498,1092823
2023-04-27 00:42,1092846,374094,500254,218498,1092846
2023-04-27 00:43,1092868,374117,500254,218497,1092868
2023-04-27 00:44,1092892,374139,500255,218498,1092892
2023-04-27 00:45,1092914,374159,500255,218500,1092914
2023-04-27 00:46,1092938,374182,500256,218500,1092938
2023-04-27 00:47,1092961,374203,500256,218502,1092961
2023-04-27 00:49,1092984,374222,500258,218504,1092984
2023-04-27 00:50,1093009,374245,500258,218506,1093009
2023-04-27 00:51,1093032,374267,500258,218507,1093032
2023-04-27 00:52,1093054,374289,500258,218507,1093054
2023-04-27 00:53,1093078,374305,500260,218513,1093078
2023-04-27 00:54,1093101,374327,500260,218514,1093101
2023-04-27 00:55,1093124,374346,500262,218516,1093124
2023-04-27 00:56,1093146,374368,500262,218516,1093146
2023-04-27 00:57,1093170,374388,500264,218518,1093170
2023-04-27 00:58,1093192,374409,500264,218519,1093192
2023-04-27 00:59,1093215,374426,500269,218520,1093215
2023-04-27 01:00,1093236,374444,500269,218523,1093236
2023-04-27 01:01,1093247,374452,500270,218525,1093247
2023-04-27 01:02,1093259,374463,500270,218526,1093259
2023-04-27 01:03,1093271,374472,500271,218528,1093271
2023-04-27 01:04,1093282,374480,500271,218531,1093282
2023-04-27 01:05,1093293,374488,500272,218533,1093293
2023-04-27 01:06,1093304,374498,500272,218534,1093304
2023-04-27 01:07,1093315,374506,500275,218534,1093315
2023-04-27 01:08,1093328,374517,500277,218534,1093328
2023-04-27 01:09,1093340,374528,500277,218535,1093340
2023-04-27 01:10,1093351,374535,500280,218536,1093351
2023-04-27 01:11,1093362,374546,500280,218536,1093362
2023-04-27 01:12,1093375,374557,500281,218537,1093375
2023-04-27 01:13,1093386,374567,500281,218538,1093386
2023-04-27 01:14,1093397,374576,500282,218539,1093397
2023-04-27 01:15,1093409,374587,500282,218540,1093409
2023-04-27 01:16,1093420,374594,500284,218542,1093420
2023-04-27 01:17,1093432,374606,500284,218542,1093432
2023-04-27 01:18,1093444,374614,500287,218543,1093444
2023-04-27 01:19,1093456,374624,500287,218545,1093456
2023-04-27 01:20,1093468,374634,500288,218546,1093468
2023-04-27 01:21,1093479,374645,500288,218546,1093479
2023-04-27 01:22,1093490,374655,500289,218546,1093490
2023-04-27 01:23,1093502,374667,500289,218546,1093502
2023-04-27 01:24,1093513,374676,500291,218546,1093513
2023-04-27 01:25,1093524,374687,500291,218546,1093524
2023-04-27 01:26,1093536,374698,500292,218546,1093536
2023-04-27 01:27,1093548,374710,500292,218546,1093548
2023-04-27 01:28,1093558,374718,500292,218548,1093558
2023-04-27 01:29,1093570,374729,500292,218549,1093570
2023-04-27 01:30,1093581,374739,500292,218550,1093581
2023-04-27 01:31,1093593,374750,500292,218551,1093593
2023-04-27 01:32,1093605,374759,500295,218551,1093605
2023-04-27 01:33,1093616,374769,500295,218552,1093616
2023-04-27 01:34,1093628,374781,500295,218552,1093628
2023-04-27 01:35,1093640,374793,500295,218552,1093640
2023-04-27 01:37,1093651,374805,500294,218552,1093651
2023-04-27 01:38,1093662,374816,500294,218552,1093662
2023-04-27 01:39,1093674,374826,500296,218552,1093674
2023-04-27 01:40,1093685,374836,500296,218553,1093685
2023-04-27 01:41,1093696,374846,500296,218554,1093696
2023-04-27 01:42,1093707,374857,500296,218554,1093707
2023-04-27 01:43,1093719,374868,500296,218555,1093719
2023-04-27 01:44,1093730,374877,500296,218557,1093730
2023-04-27 01:45,1093742,374887,500298,218557,1093742
2023-04-27 01:46,1093754,374899,500298,218557,1093754
2023-04-27 01:47,1093765,374908,500300,218557,1093765
2023-04-27 01:48,1093777,374918,500300,218559,1093777
2023-04-27 01:49,1093788,374926,500302,218560,1093788
2023-04-27 01:50,1093800,374938,500302,218560,1093800
2023-04-27 01:51,1093811,374949,500302,218560,1093811
2023-04-27 01:52,1093822,374960,500302,218560,1093822
2023-04-27 01:53,1093834,374971,500302,218561,1093834
2023-04-27 01:54,1093845,374982,500302,218561,1093845
2023-04-27 01:55,1093857,374993,500303,218561,1093857
2023-04-27 01:56,1093868,375004,500303,218561,1093868
2023-04-27 01:57,1093879,375013,500303,218563,1093879
2023-04-27 01:58,1093890,375024,500303,218563,1093890
2023-04-27 01:59,1093902,375035,500304,218563,1093902
2023-04-27 02:00,1093920,375053,500304,218563,1093920
2023-04-27 02:01,1093947,375079,500304,218564,1093947
2023-04-27 02:02,1093975,375106,500304,218565,1093975
2023-04-27 02:03,1094004,375133,500306,218565,1094004
2023-04-27 02:04,1094031,375160,500306,218565,1094031
2023-04-27 02:05,1094059,375187,500307,218565,1094059
2023-04-27 02:06,1094087,375215,500307,218565,1094087
2023-04-27 02:07,1094114,375242,500307,218565,1094114
2023-04-27 02:08,1094142,375270,500307,218565,1094142
2023-04-27 02:09,1094171,375296,500308,218567,1094171
2023-04-27 02:10,1094199,375324,500308,218567,1094199
2023-04-27 02:11,1094226,375350,500309,218567,1094226
2023-04-27 02:12,1094252,375374,500309,218569,1094252
2023-04-27 02:13,1094282,375404,500309,218569,1094282
2023-04-27 02:14,1094309,375431,500309,218569,1094309
2023-04-27 02:15,1094337,375459,500309,218569,1094337
2023-04-27 02:16,1094365,375487,500309,218569,1094365
2023-04-27 02:17,1094392,375512,500309,218571,1094392
2023-04-27 02:18,1094419,375539,500309,218571,1094419
2023-04-27 02:19,1094448,375567,500310,218571,1094448
2023-04-27 02:20,1094474,375591,500310,218573,1094474
2023-04-27 02:21,1094503,375620,500310,218573,1094503
2023-04-27 02:22,1094531,375648,500310,218573,1094531
2023-04-27 02:23,1094558,375669,500314,218575,1094558
2023-04-27 02:25,1094584,375695,500314,218575,1094584
2023-04-27 02:26,1094612,375722,500315,218575,1094612
2023-04-27 02:27,1094641,375750,500315,218576,1094641
2023-04-27 02:28,1094667,375775,500315,218577,1094667
2023-04-27 02:29,1094695,375803,500315,218577,1094695
2023-04-27 02:30,1094724,375830,500317,218577,1094724
2023-04-27 02:31,1094752,375858,500317,218577,1094752
2023-04-27 02:32,1094780,375884,500319,218577,1094780
2023-04-27 02:33,1094807,375911,500319,218577,1094807
2023-04-27 02:34,1094834,375936,500321,218577,1094834
2023-04-27 02:35,1094861,375961,500321,218579,1094861
2023-04-27 02:36,1094889,375988,500321,218580,1094889
2023-04-27 02:37,1094917,376015,500321,218581,1094917
2023-04-27 02:38,1094945,376041,500323,218581,1094945
2023-04-27 02:39,1094972,376067,500323,218582,1094972
2023-04-27 02:40,1095000,376095,500323,218582,1095000
2023-04-27 02:41,1095028,376123,500323,218582,1095028
2023-04-27 02:42,1095055,376149,500322,218584,1095055
2023-04-27 02:43,1095082,376175,500322,218585,1095082
2023-04-27 02:44,1095110,376201,500323,218586,1095110
2023-04-27 02:45,1095138,376229,500323,218586,1095138
2023-04-27 02:46,1095166,376257,500323,218586,1095166
2023-04-27 02:47,1095194,376285,500323,218586,1095194
2023-04-27 02:48,1095220,376309,500324,218587,1095220
2023-04-27 02:49,1095248,376336,500324,218588,1095248
2023-04-27 02:50,1095277,376365,500324,218588,1095277
2023-04-27 02:51,1095304,376391,500325,218588,1095304
2023-04-27 02:52,1095331,376418,500325,218588,1095331
2023-04-27 02:53,1095358,376445,500325,218588,1095358
2023-04-27 02:54,1095388,376473,500326,218589,1095388
2023-04-27 02:55,1095415,376499,500326,218590,1095415
2023-04-27 02:56,1095441,376524,500327,218590,1095441
2023-04-27 02:57,1095470,376553,500327,218590,1095470
2023-04-27 02:58,1095497,376580,500327,218590,1095497
2023-04-27 02:59,1095526,376609,500327,218590,1095526
2023-04-27 03:00,1095543,376624,500329,218590,1095543
2023-04-27 03:01,1095555,376635,500329,218591,1095555
2023-04-27 03:02,1095568,376646,500330,218592,1095568
2023-04-27 03:03,1095582,376660,500330,218592,1095582
2023-04-27 03:04,1095594,376671,500331,218592,1095594
2023-04-27 03:05,1095607,376684,500331,218592,1095607
2023-04-27 03:06,1095620,376697,500331,218592,1095620
2023-04-27 03:07,1095634,376710,500331,218593,1095634
2023-04-27 03:08,1095647,376722,500331,218594,1095647
2023-04-27 03:09,1095660,376734,500331,218595,1095660
2023-04-27 03:10,1095673,376746,500332,218595,1095673
2023-04-27 03:12,1095686,376759,500332,218595,1095686
2023-04-27 03:13,1095698,376771,500332,218595,1095698
2023-04-27 03:14,1095712,376785,500332,218595,1095712
2023-04-27 03:15,1095725,376798,500332,218595,1095725
2023-04-27 03:16,1095738,376811,500332,218595,1095738
2023-04-27 03:17,1095750,376823,500332,218595,1095750
2023-04-27 03:18,1095764,376837,500332,218595,1095764
2023-04-27 03:19,1095777,376850,500332,218595,1095777
2023-04-27 03:20,1095790,376863,500332,218595,1095790
2023-04-27 03:21,1095803,376875,500333,218595,1095803
2023-04-27 03:22,1095816,376888,500333,218595,1095816
2023-04-27 03:23,1095829,376901,500333,218595,1095829
2023-04-27 03:24,1095842,376914,500333,218595,1095842
2023-04-27 03:25,1095855,376927,500333,218595,1095855
2023-04-27 03:26,1095868,376940,500333,218595,1095868
2023-04-27 03:27,1095881,376953,500333,218595,1095881
2023-04-27 03:28,1095894,376965,500333,218596,1095894
2023-04-27 03:29,1095907,376978,500333,218596,1095907
2023-04-27 03:30,1095920,376991,500333,218596,1095920
2023-04-27 03:31,1095934,377005,500333,218596,1095934
2023-04-27 03:32,1095946,377017,500333,218596,1095946
2023-04-27 03:33,1095959,377030,500333,218596,1095959
2023-04-27 03:34,1095973,377044,500333,218596,1095973
2023-04-27 03:35,1095985,377056,500333,218596,1095985
2023-04-27 03:36,1095998,377068,500333,218597,1095998
2023-04-27 03:37,1096012,377080,500335,218597,1096012
2023-04-27 03:38,1096024,377092,500335,218597,1096024
2023-04-27 03:39,1096038,377104,500336,218598,1096038
2023-04-27 03:40,1096051,377117,500336,218598,1096051
2023-04-27 03:41,1096064,377129,500337,218598,1096064
2023-04-27 03:42,1096077,377142,500337,218598,1096077
2023-04-27 03:43,1096090,377153,500339,218598,1096090
2023-04-27 03:44,1096103,377166,500339,218598,1096103
2023-04-27 03:45,1096116,377177,500341,218598,1096116
2023-04-27 03:46,1096129,377190,500341,218598,1096129
2023-04-27 03:47,1096142,377203,500341,218598,1096142
2023-04-27 03:48,1096155,377216,500341,218598,1096155
2023-04-27 03:49,1096168,377228,500341,218599,1096168
2023-04-27 03:50,1096181,377240,500341,218600,1096181
2023-04-27 03:51,1096194,377253,500341,218600,1096194
2023-04-27 03:52,1096207,377266,500341,218600,1096207
2023-04-27 03:53,1096220,377279,500341,218600,1096220
2023-04-27 03:54,1096234,377293,500341,218600,1096234
2023-04-27 03:55,1096246,377304,500342,218600,1096246
2023-04-27 03:56,1096259,377317,500342,218600,1096259
2023-04-27 03:57,1096272,377330,500342,218600,1096272
2023-04-27 03:59,1096286,377344,500342,218600,1096286
2023-04-27 04:00,1096298,377356,500342,218600,1096298
2023-04-27 04:01,1096324,377382,500342,218600,1096324
2023-04-27 04:02,1096353,377411,500342,218600,1096353
2023-04-27 04:03,1096381,377438,500342,218601,1096381
2023-04-27 04:04,1096409,377466,500342,218601,1096409
2023-04-27 04:05,1096436,377493,500342,218601,1096436
2023-04-27 04:06,1096462,377519,500342,218601,1096462
2023-04-27 04:07,1096489,377546,500342,218601,1096489
2023-04-27 04:08,1096517,377574,500342,218601,1096517
2023-04-27 04:09,1096545,377602,500342,218601,1096545
2023-04-27 04:10,1096572,377629,500342,218601,1096572
2023-04-27 04:11,1096598,377655,500342,218601,1096598
2023-04-27 04:12,1096625,377681,500342,218602,1096625
2023-04-27 04:13,1096652,377708,500342,218602,1096652
2023-04-27 04:14,1096681,377737,500342,218602,1096681
2023-04-27 04:15,1096708,377764,500342,218602,1096708
2023-04-27 04:16,1096735,377791,500342,218602,1096735
2023-04-27 04:17,1096763,377819,500342,218602,1096763
2023-04-27 04:18,1096790,377845,500343,218602,1096790
2023-04-27 04:19,1096816,377870,500343,218603,1096816
2023-04-27 04:20,1096844,377898,500343,218603,1096844
2023-04-27 04:21,1096870,377924,500343,218603,1096870
2023-04-27 04:22,1096900,377954,500343,218603,1096900
2023-04-27 04:23,1096927,377980,500343,218604,1096927
2023-04-27 04:24,1096953,378006,500343,218604,1096953
2023-04-27 04:25,1096981,378034,500343,218604,1096981
2023-04-27 04:26,1097009,378062,500343,218604,1097009
2023-04-27 04:27,1097035,378088,500343,218604,1097035
2023-04-27 04:28,1097062,378115,500343,218604,1097062
2023-04-27 04:29,1097090,378143,500343,218604,1097090
2023-04-27 04:30,1097118,378171,500343,218604,1097118
2023-04-27 04:31,1097144,378197,500343,218604,1097144
2023-04-27 04:32,1097172,378225,500343,218604,1097172
2023-04-27 04:33,1097198,378251,500343,218604,1097198
2023-04-27 04:34,1097227,378279,500344,218604,1097227
2023-04-27 04:35,1097254,378306,500344,218604,1097254
2023-04-27 04:36,1097280,378333,500343,218604,1097280
2023-04-27 04:37,1097309,378362,500343,218604,1097309
2023-04-27 04:38,1097335,378388,500343,218604,1097335
2023-04-27 04:39,1097363,378416,500343,218604,1097363
2023-04-27 04:40,1097389,378442,500343,218604,1097389
2023-04-27 04:41,1097417,378470,500343,218604,1097417
2023-04-27 04:42,1097445,378497,500344,218604,1097445
2023-04-27 04:43,1097473,378525,500344,218604,1097473
2023-04-27 04:45,1097499,378551,500344,218604,1097499
2023-04-27 04:46,1097526,378578,500344,218604,1097526
2023-04-27 04:47,1097553,378605,500344,218604,1097553
2023-04-27 04:48,1097581,378633,500344,218604,1097581
2023-04-27 04:49,1097608,378660,500344,218604,1097608
2023-04-27 04:50,1097635,378687,500344,218604,1097635
2023-04-27 04:51,1097663,378715,500344,218604,1097663
2023-04-27 04:52,1097689,378741,500344,218604,1097689
2023-04-27 04:53,1097717,378767,500346,218604,1097717
2023-04-27 04:54,1097743,378793,500346,218604,1097743
2023-04-27 04:55,1097771,378820,500347,218604,1097771
2023-04-27 04:56,1097798,378846,500347,218605,1097798
2023-04-27 04:57,1097827,378875,500347,218605,1097827
2023-04-27 04:58,1097853,378901,500347,218605,1097853
2023-04-27 04:59,1097881,378924,500350,218607,1097881
2023-04-27 05:00,1097906,378949,500350,218607,1097906
2023-04-27 05:01,1097923,378966,500350,218607,1097923
2023-04-27 05:02,1097941,378984,500350,218607,1097941
2023-04-27 05:03,1097958,379001,500350,218607,1097958
2023-04-27 05:04,1097976,379019,500350,218607,1097976
2023-04-27 05:05,1097994,379037,500350,218607,1097994
2023-04-27 05:06,1098012,379055,500350,218607,1098012
2023-04-27 05:07,1098029,379072,500350,218607,1098029
2023-04-27 05:08,1098047,379089,500350,218608,1098047
2023-04-27 05:09,1098064,379106,500350,218608,1098064
2023-04-27 05:10,1098083,379125,500350,218608,1098083
2023-04-27 05:11,1098100,379142,500350,218608,1098100
2023-04-27 05:12,1098117,379159,500350,218608,1098117
2023-04-27 05:13,1098135,379177,500350,218608,1098135
2023-04-27 05:14,1098153,379194,500350,218609,1098153
2023-04-27 05:15,1098171,379211,500351,218609,1098171
2023-04-27 05:16,1098188,379228,500351,218609,1098188
2023-04-27 05:17,1098205,379245,500351,218609,1098205
2023-04-27 05:18,1098224,379264,500351,218609,1098224
2023-04-27 05:19,1098242,379282,500351,218609,1098242
2023-04-27 05:20,1098259,379299,500351,218609,1098259
2023-04-27 05:21,1098276,379316,500351,218609,1098276
2023-04-27 05:22,1098295,379334,500351,218610,1098295
2023-04-27 05:23,1098313,379351,500351,218611,1098313
2023-04-27 05:24,1098330,379367,500351,218612,1098330
2023-04-27 05:25,1098347,379381,500353,218613,1098347
2023-04-27 05:26,1098365,379399,500353,218613,1098365
2023-04-27 05:27,1098383,379417,500353,218613,1098383
2023-04-27 05:28,1098400,379434,500353,218613,1098400
2023-04-27 05:29,1098418,379452,500353,218613,1098418
2023-04-27 05:30,1098436,379470,500353,218613,1098436
2023-04-27 05:32,1098453,379487,500353,218613,1098453
2023-04-27 05:33,1098472,379506,500353,218613,1098472
2023-04-27 05:34,1098489,379523,500353,218613,1098489
2023-04-27 05:35,1098507,379541,500353,218613,1098507
2023-04-27 05:36,1098524,379557,500354,218613,1098524
2023-04-27 05:37,1098543,379576,500354,218613,1098543
2023-04-27 05:38,1098560,379593,500354,218613,1098560
2023-04-27 05:39,1098577,379610,500354,218613,1098577
2023-04-27 05:40,1098595,379628,500354,218613,1098595
2023-04-27 05:41,1098613,379646,500354,218613,1098613
2023-04-27 05:42,1098630,379663,500354,218613,1098630
2023-04-27 05:43,1098648,379681,500354,218613,1098648
2023-04-27 05:44,1098666,379699,500354,218613,1098666
2023-04-27 05:45,1098684,379717,500354,218613,1098684
2023-04-27 05:46,1098701,379734,500354,218613,1098701
2023-04-27 05:47,1098719,379752,500354,218613,1098719
2023-04-27 05:48,1098736,379768,500355,218613,1098736
2023-04-27 05:49,1098755,379787,500355,218613,1098755
2023-04-27 05:50,1098772,379804,500355,218613,1098772
2023-04-27 05:51,1098790,379822,500355,218613,1098790
2023-04-27 05:52,1098807,379837,500356,218614,1098807
2023-04-27 05:53,1098826,379855,500356,218615,1098826
2023-04-27 05:54,1098842,379871,500356,218615,1098842
2023-04-27 05:55,1098860,379889,500356,218615,1098860
2023-04-27 05:56,1098879,379905,500358,218616,1098879
2023-04-27 05:57,1098895,379921,500358,218616,1098895
2023-04-27 05:58,1098914,379940,500358,218616,1098914
2023-04-27 05:59,1098931,379957,500358,218616,1098931
2023-04-27 06:00,1098951,379977,500358,218616,1098951
2023-04-27 06:01,1098971,379997,500358,218616,1098971
2023-04-27 06:02,1098992,380017,500359,218616,1098992
2023-04-27 06:03,1099012,380037,500359,218616,1099012
2023-04-27 06:04,1099033,380057,500360,218616,1099033
2023-04-27 06:05,1099054,380078,500360,218616,1099054
2023-04-27 06:06,1099074,380098,500360,218616,1099074
2023-04-27 06:07,1099095,380119,500360,218616,1099095
2023-04-27 06:08,1099116,380140,500360,218616,1099116
2023-04-27 06:09,1099137,380161,500360,218616,1099137
2023-04-27 06:10,1099157,380181,500360,218616,1099157
2023-04-27 06:11,1099177,380201,500360,218616,1099177
2023-04-27 06:12,1099199,380222,500361,218616,1099199
2023-04-27 06:13,1099219,380242,500361,218616,1099219
2023-04-27 06:14,1099239,380261,500362,218616,1099239
2023-04-27 06:15,1099260,380282,500362,218616,1099260
2023-04-27 06:16,1099281,380302,500362,218617,1099281
2023-04-27 06:17,1099301,380321,500362,218618,1099301
2023-04-27 06:18,1099322,380342,500362,218618,1099322
2023-04-27 06:20,1099342,380362,500362,218618,1099342
2023-04-27 06:21,1099363,380381,500363,218619,1099363
2023-04-27 06:22,1099384,380402,500363,218619,1099384
2023-04-27 06:23,1099404,380422,500363,218619,1099404
2023-04-27 06:24,1099425,380441,500363,218621,1099425
2023-04-27 06:25,1099446,380462,500363,218621,1099446
2023-04-27 06:26,1099466,380482,500363,218621,1099466
2023-04-27 06:27,1099488,380503,500364,218621,1099488
2023-04-27 06:28,1099507,380522,500364,218621,1099507
2023-04-27 06:29,1099528,380542,500365,218621,1099528
2023-04-27 06:30,1099549,380563,500365,218621,1099549
2023-04-27 06:31,1099569,380583,500365,218621,1099569
2023-04-27 06:32,1099589,380603,500365,218621,1099589
2023-04-27 06:33,1099611,380625,500365,218621,1099611
2023-04-27 06:34,1099631,380645,500365,218621,1099631
2023-04-27 06:35,1099652,380666,500365,218621,1099652
2023-04-27 06:36,1099672,380686,500365,218621,1099672
2023-04-27 06:37,1099693,380704,500367,218622,1099693
2023-04-27 06:38,1099713,380724,500367,218622,1099713
2023-04-27 06:39,1099735,380746,500368,218621,1099735
2023-04-27 06:40,1099755,380765,500368,218622,1099755
2023-04-27 06:41,1099775,380784,500369,218622,1099775
2023-04-27 06:42,1099796,380803,500369,218624,1099796
2023-04-27 06:43,1099816,380823,500369,218624,1099816
2023-04-27 06:44,1099837,380844,500369,218624,1099837
2023-04-27 06:45,1099858,380865,500369,218624,1099858
2023-04-27 06:46,1099878,380885,500369,218624,1099878
2023-04-27 06:47,1099900,380905,500370,218625,1099900
2023-04-27 06:48,1099919,380924,500370,218625,1099919
2023-04-27 06:49,1099940,380945,500370,218625,1099940
2023-04-27 06:50,1099962,380967,500370,218625,1099962
2023-04-27 06:51,1099982,380986,500371,218625,1099982
2023-04-27 06:52,1100002,381005,500371,218626,1100002
2023-04-27 06:53,1100023,381020,500373,218630,1100023
2023-04-27 06:54,1100044,381041,500373,218630,1100044
2023-04-27 06:55,1100064,381060,500374,218630,1100064
2023-04-27 06:56,1100086,381081,500374,218631,1100086
2023-04-27 06:57,1100106,381100,500374,218632,1100106
2023-04-27 06:58,1100128,381122,500374,218632,1100128
2023-04-27 06:59,1100148,381140,500376,218632,1100148
2023-04-27 07:00,1100174,381166,500376,218632,1100174
2023-04-27 07:01,1100202,381194,500376,218632,1100202
2023-04-27 07:02,1100229,381220,500376,218633,1100229
2023-04-27 07:03,1100258,381247,500378,218633,1100258
2023-04-27 07:04,1100284,381272,500378,218634,1100284
2023-04-27 07:05,1100311,381299,500378,218634,1100311
2023-04-27 07:06,1100339,381327,500378,218634,1100339
2023-04-27 07:08,1100367,381355,500378,218634,1100367
2023-04-27 07:09,1100396,381383,500378,218635,1100396
2023-04-27 07:10,1100423,381410,500378,218635,1100423
2023-04-27 07:11,1100450,381437,500378,218635,1100450
2023-04-27 07:12,1100476,381463,500378,218635,1100476
2023-04-27 07:13,1100505,381492,500378,218635,1100505
2023-04-27 07:14,1100532,381519,500378,218635,1100532
2023-04-27 07:15,1100560,381547,500378,218635,1100560
2023-04-27 07:16,1100587,381574,500378,218635,1100587
2023-04-27 07:17,1100616,381603,500378,218635,1100616
2023-04-27 07:18,1100643,381629,500378,218636,1100643
2023-04-27 07:19,1100673,381658,500378,218637,1100673
2023-04-27 07:20,1100701,381681,500383,218637,1100701
2023-04-27 07:21,1100728,381706,500383,218639,1100728
2023-04-27 07:22,1100755,381729,500385,218641,1100755
2023-04-27 07:23,1100781,381754,500385,218642,1100781
2023-04-27 07:24,1100810,381782,500385,218643,1100810
2023-04-27 07:25,1100836,381808,500385,218643,1100836
2023-04-27 07:26,1100865,381833,500387,218645,1100865
2023-04-27 07:27,1100893,381861,500387,218645,1100893
2023-04-27 07:28,1100920,381887,500388,218645,1100920
2023-04-27 07:29,1100948,381914,500388,218646,1100948
2023-04-27 07:30,1100974,381937,500391,218646,1100974
2023-04-27 07:31,1101002,381965,500391,218646,1101002
2023-04-27 07:32,1101031,381993,500391,218647,1101031
2023-04-27 07:33,1101060,382020,500391,218649,1101060
2023-04-27 07:34,1101086,382042,500395,218649,1101086
2023-04-27 07:35,1101114,382069,500395,218650,1101114
2023-04-27 07:36,1101142,382094,500397,218651,1101142
2023-04-27 07:37,1101168,382119,500397,218652,1101168
2023-04-27 07:38,1101197,382146,500399,218652,1101197
2023-04-27 07:39,1101224,382171,500399,218654,1101224
2023-04-27 07:40,1101252,382196,500401,218655,1101252
2023-04-27 07:41,1101279,382221,500403,218655,1101279
2023-04-27 07:42,1101306,382248,500403,218655,1101306
2023-04-27 07:43,1101333,382272,500406,218655,1101333
2023-04-27 07:44,1101362,382301,500406,218655,1101362
2023-04-27 07:45,1101390,382327,500405,218658,1101390
2023-04-27 07:46,1101417,382353,500405,218659,1101417
2023-04-27 07:47,1101444,382379,500405,218660,1101444
2023-04-27 07:48,1101472,382405,500405,218662,1101472
2023-04-27 07:49,1101500,382432,500405,218663,1101500
2023-04-27 07:50,1101526,382457,500405,218664,1101526
2023-04-27 07:51,1101554,382484,500405,218665,1101554
2023-04-27 07:52,1101582,382511,500405,218666,1101582
2023-04-27 07:53,1101610,382536,500408,218666,1101610
2023-04-27 07:54,1101639,382563,500409,218667,1101639
2023-04-27 07:56,1101666,382589,500409,218668,1101666
2023-04-27 07:57,1101696,382616,500412,218668,1101696
2023-04-27 07:58,1101724,382642,500412,218670,1101724
2023-04-27 07:59,1101751,382668,500412,218671,1101751
2023-04-27 08:00,1101778,382695,500412,218671,1101778
2023-04-27 08:01,1101800,382715,500414,218671,1101800
2023-04-27 08:02,1101822,382736,500414,218672,1101822
2023-04-27 08:03,1101845,382758,500415,218672,1101845
2023-04-27 08:04,1101866,382778,500415,218673,1101866
2023-04-27 08:05,1101888,382800,500415,218673,1101888
2023-04-27 08:06,1101911,382823,500415,218673,1101911
2023-04-27 08:07,1101932,382843,500416,218673,1101932
2023-04-27 08:08,1101955,382865,500416,218674,1101955
2023-04-27 08:09,1101977,382886,500417,218674,1101977
2023-04-27 08:10,1101999,382907,500417,218675,1101999
2023-04-27 08:11,1102020,382927,500417,218676,1102020
2023-04-27 08:12,1102043,382950,500417,218676,1102043
2023-04-27 08:13,1102065,382971,500417,218677,1102065
2023-04-27 08:14,1102088,382993,500417,218678,1102088
2023-04-27 08:15,1102109,383008,500419,218682,1102109
2023-04-27 08:16,1102131,383029,500419,218683,1102131
2023-04-27 08:17,1102153,383049,500419,218685,1102153
2023-04-27 08:18,1102175,383069,500419,218687,1102175
2023-04-27 08:19,1102197,383090,500419,218688,1102197
2023-04-27 08:20,1102220,383111,500419,218690,1102220
2023-04-27 08:21,1102242,383133,500419,218690,1102242
2023-04-27 08:22,1102264,383155,500419,218690,1102264
2023-04-27 08:23,1102287,383176,500420,218691,1102287
2023-04-27 08:24,1102309,383198,500420,218691,1102309
2023-04-27 08:25,1102330,383216,500422,218692,1102330
2023-04-27 08:26,1102352,383238,500422,218692,1102352
2023-04-27 08:27,1102373,383258,500422,218693,1102373
2023-04-27 08:28,1102396,383281,500422,218693,1102396
2023-04-27 08:29,1102420,383303,500424,218693,1102420
2023-04-27 08:30,1102442,383325,500424,218693,1102442
2023-04-27 08:31,1102463,383344,500426,218693,1102463
2023-04-27 08:32,1102485,383366,500426,218693,1102485
2023-04-27 08:33,1102507,383385,500427,218695,1102507
2023-04-27 08:34,1102529,383407,500427,218695,1102529
2023-04-27 08:35,1102550,383427,500427,218696,1102550
2023-04-27 08:36,1102572,383449,500427,218696,1102572
2023-04-27 08:37,1102595,383467,500430,218698,1102595
2023-04-27 08:38,1102616,383487,500431,218698,1102616
2023-04-27 08:39,1102638,383509,500431,218698,1102638
2023-04-27 08:40,1102661,383529,500434,218698,1102661
2023-04-27 08:41,1102683,383550,500434,218699,1102683
2023-04-27 08:43,1102704,383566,500436,218702,1102704
2023-04-27 08:44,1102726,383588,500436,218702,1102726
2023-04-27 08:45,1102749,383607,500436,218706,1102749
2023-04-27 08:46,1102770,383627,500436,218707,1102770
2023-04-27 08:47,1102792,383647,500437,218708,1102792
2023-04-27 08:48,1102814,383667,500437,218710,1102814
2023-04-27 08:49,1102836,383687,500438,218711,1102836
2023-04-27 08:50,1102858,383708,500438,218712,1102858
2023-04-27 08:51,1102880,383729,500438,218713,1102880
2023-04-27 08:52,1102901,383749,500438,218714,1102901
2023-04-27 08:53,1102923,383769,500439,218715,1102923
2023-04-27 08:54,1102945,383790,500439,218716,1102945
2023-04-27 08:55,1102967,383808,500440,218719,1102967
2023-04-27 08:56,1102991,383832,500440,218719,1102991
2023-04-27 08:57,1103013,383849,500443,218721,1103013
2023-04-27 08:58,1103035,383870,500443,218722,1103035
2023-04-27 08:59,1103056,383888,500446,218722,1103056
2023-04-27 09:00,1103075,383905,500446,218724,1103075
2023-04-27 09:01,1103085,383910,500448,218727,1103085
2023-04-27 09:02,1103095,383918,500448,218729,1103095
2023-04-27 09:03,1103105,383924,500450,218731,1103105
2023-04-27 09:04,1103115,383934,500450,218731,1103115
2023-04-27 09:05,1103123,383938,500453,218732,1103123
2023-04-27 09:06,1103133,383947,500453,218733,1103133
2023-04-27 09:07,1103142,383956,500453,218733,1103142
2023-04-27 09:08,1103151,383962,500454,218735,1103151
2023-04-27 09:09,1103160,383971,500454,218735,1103160
2023-04-27 09:10,1103169,383972,500459,218738,1103169
2023-04-27 09:11,1103178,383981,500459,218738,1103178
2023-04-27 09:12,1103188,383990,500459,218739,1103188
2023-04-27 09:13,1103198,383999,500459,218740,1103198
2023-04-27 09:14,1103207,384008,500459,218740,1103207
2023-04-27 09:15,1103216,384014,500459,218743,1103216
2023-04-27 09:16,1103224,384020,500459,218745,1103224
2023-04-27 09:17,1103234,384030,500459,218745,1103234
2023-04-27 09:18,1103243,384038,500459,218746,1103243
2023-04-27 09:19,1103252,384047,500459,218746,1103252
2023-04-27 09:20,1103261,384048,500466,218747,1103261
2023-04-27 09:21,1103271,384057,500466,218748,1103271
2023-04-27 09:22,1103280,384064,500469,218747,1103280
2023-04-27 09:23,1103291,384074,500469,218748,1103291
2023-04-27 09:24,1103300,384075,500475,218750,1103300
2023-04-27 09:25,1103309,384083,500475,218751,1103309
2023-04-27 09:26,1103318,384087,500478,218753,1103318
2023-04-27 09:27,1103327,384096,500478,218753,1103327
2023-04-27 09:28,1103337,384103,500481,218753,1103337
2023-04-27 09:29,1103346,384111,500481,218754,1103346
2023-04-27 09:31,1103355,384114,500486,218755,1103355
2023-04-27 09:32,1103364,384123,500486,218755,1103364
2023-04-27 09:33,1103373,384126,500491,218756,1103373
2023-04-27 09:34,1103382,384133,500491,218758,1103382
2023-04-27 09:35,1103391,384138,500493,218760,1103391
2023-04-27 09:36,1103400,384146,500493,218761,1103400
2023-04-27 09:37,1103409,384154,500493,218762,1103409
2023-04-27 09:38,1103418,384162,500493,218763,1103418
2023-04-27 09:39,1103427,384166,500497,218764,1103427
2023-04-27 09:40,1103436,384174,500497,218765,1103436
2023-04-27 09:41,1103445,384180,500498,218767,1103445
2023-04-27 09:42,1103454,384188,500498,218768,1103454
2023-04-27 09:43,1103464,384194,500501,218769,1103464
2023-04-27 09:44,1103473,384203,500501,218769,1103473
2023-04-27 09:45,1103484,384211,500502,218771,1103484
2023-04-27 09:46,1103494,384216,500502,218776,1103494
2023-04-27 09:47,1103503,384220,500505,218778,1103503
2023-04-27 09:48,1103512,384228,500505,218779,1103512
2023-04-27 09:49,1103521,384232,500509,218780,1103521
2023-04-27 09:50,1103530,384240,500509,218781,1103530
2023-04-27 09:51,1103539,384247,500510,218782,1103539
2023-04-27 09:52,1103548,384254,500510,218784,1103548
2023-04-27 09:53,1103558,384261,500512,218785,1103558
2023-04-27 09:54,1103568,384271,500512,218785,1103568
2023-04-27 09:55,1103577,384278,500514,218785,1103577
2023-04-27 09:56,1103588,384287,500514,218787,1103588
2023-04-27 09:57,1103597,384292,500517,218788,1103597
2023-04-27 09:58,1103605,384297,500517,218791,1103605
2023-04-27 09:59,1103616,384306,500517,218793,1103616
2023-04-27 10:00,1103628,384316,500517,218795,1103628
2023-04-27 10:01,1103642,384325,500519,218798,1103642
2023-04-27 10:02,1103656,384338,500519,218799,1103656
2023-04-27 10:03,1103670,384349,500522,218799,1103670
2023-04-27 10:04,1103684,384362,500522,218800,1103684
2023-04-27 10:05,1103698,384374,500523,218801,1103698
2023-04-27 10:06,1103712,384387,500523,218802,1103712
2023-04-27 10:07,1103727,384400,500523,218804,1103727
2023-04-27 10:08,1103740,384412,500523,218805,1103740
2023-04-27 10:09,1103754,384426,500523,218805,1103754
2023-04-27 10:10,1103769,384440,500523,218806,1103769
2023-04-27 10:11,1103783,384449,500526,218808,1103783
2023-04-27 10:12,1103797,384460,500526,218811,1103797
2023-04-27 10:13,1103810,384471,500528,218811,1103810
2023-04-27 10:14,1103825,384485,500528,218812,1103825
2023-04-27 10:15,1103839,384496,500530,218813,1103839
2023-04-27 10:17,1103854,384509,500530,218815,1103854
2023-04-27 10:18,1103870,384525,500530,218815,1103870
2023-04-27 10:19,1103883,384538,500530,218815,1103883
2023-04-27 10:20,1103897,384550,500532,218815,1103897
2023-04-27 10:21,1103911,384563,500532,218816,1103911
2023-04-27 10:22,1103925,384575,500532,218818,1103925
2023-04-27 10:23,1103940,384585,500535,218820,1103940
2023-04-27 10:24,1103954,384599,500535,218820,1103954
2023-04-27 10:25,1103968,384611,500536,218821,1103968
2023-04-27 10:26,1103983,384625,500536,218822,1103983
2023-04-27 10:27,1103997,384636,500537,218824,1103997
2023-04-27 10:28,1104011,384646,500537,218828,1104011
2023-04-27 10:29,1104025,384659,500537,218829,1104025
2023-04-27 10:30,1104040,384673,500537,218830,1104040
2023-04-27 10:31,1104055,384686,500538,218831,1104055
2023-04-27 10:32,1104070,384700,500538,218832,1104070
2023-04-27 10:33,1104083,384711,500540,218832,1104083
2023-04-27 10:34,1104097,384725,500540,218832,1104097
2023-04-27 10:35,1104111,384738,500541,218832,1104111
2023-04-27 10:36,1104125,384749,500541,218835,1104125
2023-04-27 10:37,1104140,384762,500542,218836,1104140
2023-04-27 10:38,1104154,384774,500542,218838,1104154
2023-04-27 10:39,1104168,384785,500545,218838,1104168
2023-04-27 10:40,1104182,384795,500545,218842,1104182
2023-04-27 10:41,1104196,384807,500546,218843,1104196
2023-04-27 10:42,1104210,384820,500546,218844,1104210
2023-04-27 10:43,1104224,384833,500547,218844,1104224
2023-04-27 10:44,1104238,384847,500547,218844,1104238
2023-04-27 10:45,1104252,384856,500552,218844,1104252
2023-04-27 10:46,1104266,384870,500552,218844,1104266
2023-04-27 10:47,1104281,384883,500554,218844,1104281
2023-04-27 10:48,1104294,384894,500554,218846,1104294
2023-04-27 10:49,1104309,384906,500556,218847,1104309
2023-04-27 10:50,1104322,384916,500556,218850,1104322
2023-04-27 10:51,1104338,384928,500560,218850,1104338
2023-04-27 10:52,1104352,384941,500560,218851,1104352
2023-04-27 10:53,1104365,384953,500561,218851,1104365
2023-04-27 10:54,1104380,384965,500561,218854,1104380
2023-04-27 10:55,1104395,384975,500564,218856,1104395
2023-04-27 10:56,1104408,384983,500564,218861,1104408
2023-04-27 10:57,1104423,384996,500566,218861,1104423
2023-04-27 10:58,1104437,385009,500566,218862,1104437
2023-04-27 10:59,1104451,385021,500568,218862,1104451
2023-04-27 11:00,1104477,385045,500568,218864,1104477
2023-04-27 11:01,1104507,385072,500571,218864,1104507
2023-04-27 11:02,1104534,385098,500571,218865,1104534
2023-04-27 11:04,1104564,385126,500573,218865,1104564
2023-04-27 11:05,1104591,385152,500573,218866,1104591
2023-04-27 11:06,1104621,385180,500574,218867,1104621
2023-04-27 11:07,1104650,385208,500574,218868,1104650
2023-04-27 11:08,1104676,385232,500575,218869,1104676
2023-04-27 11:09,1104708,385264,500575,218869,1104708
2023-04-27 11:10,1104735,385292,500574,218869,1104735
2023-04-27 11:11,1104765,385321,500574,218870,1104765
2023-04-27 11:12,1104793,385343,500579,218871,1104793
2023-04-27 11:13,1104821,385368,500579,218874,1104821
2023-04-27 11:14,1104849,385393,500581,218875,1104849
2023-04-27 11:15,1104881,385424,500581,218876,1104881
2023-04-27 11:16,1104908,385448,500583,218877,1104908
2023-04-27 11:17,1104936,385476,500583,218877,1104936
2023-04-27 11:18,1104967,385507,500583,218877,1104967
2023-04-27 11:19,1104994,385534,500583,218877,1104994
2023-04-27 11:20,1105022,385561,500583,218878,1105022
2023-04-27 11:21,1105052,385590,500583,218879,1105052
2023-04-27 11:22,1105082,385619,500583,218880,1105082
2023-04-27 11:23,1105110,385646,500583,218881,1105110
2023-04-27 11:24,1105137,385673,500583,218881,1105137
2023-04-27 11:25,1105167,385700,500583,218884,1105167
2023-04-27 11:26,1105195,385714,500595,218886,1105195
2023-04-27 11:27,1105222,385736,500598,218888,1105222
2023-04-27 11:28,1105250,385763,500598,218889,1105250
2023-04-27 11:29,1105281,385792,500599,218890,1105281
2023-04-27 11:30,1105309,385819,500599,218891,1105309
2023-04-27 11:31,1105340,385846,500602,218892,1105340
2023-04-27 11:32,1105369,385874,500603,218892,1105369
2023-04-27 11:33,1105397,385901,500603,218893,1105397
2023-04-27 11:34,1105428,385931,500605,218892,1105428
2023-04-27 11:35,1105457,385960,500605,218892,1105457
2023-04-27 11:36,1105487,385990,500605,218892,1105487
2023-04-27 11:37,1105515,386014,500605,218896,1105515
2023-04-27 11:38,1105543,386038,500608,218897,1105543
2023-04-27 11:39,1105571,386066,500608,218897,1105571
2023-04-27 11:40,1105599,386087,500613,218899,1105599
2023-04-27 11:41,1105628,386115,500613,218900,1105628
2023-04-27 11:42,1105656,386139,500617,218900,1105656
2023-04-27 11:43,1105685,386167,500617,218901,1105685
2023-04-27 11:44,1105713,386190,500621,218902,1105713
2023-04-27 11:45,1105742,386215,500623,218904,1105742
2023-04-27 11:46,1105771,386242,500623,218906,1105771
2023-04-27 11:47,1105798,386267,500625,218906,1105798
2023-04-27 11:48,1105826,386295,500625,218906,1105826
2023-04-27 11:49,1105855,386318,500631,218906,1105855
2023-04-27 11:50,1105883,386343,500631,218909,1105883
2023-04-27 11:52,1105912,386365,500637,218910,1105912
2023-04-27 11:53,1105941,386391,500637,218913,1105941
2023-04-27 11:54,1105968,386415,500639,218914,1105968
2023-04-27 11:55,1105999,386445,500639,218915,1105999
2023-04-27 11:56,1106027,386467,500645,218915,1106027
2023-04-27 11:57,1106054,386494,500645,218915,1106054
2023-04-27 11:58,1106083,386519,500646,218918,1106083
2023-04-27 11:59,1106112,386547,500647,218918,1106112
2023-04-27 12:00,1106139,386573,500647,218919,1106139
2023-04-27 12:01,1106150,386577,500653,218920,1106150
2023-04-27 12:02,1106163,386589,500653,218921,1106163
2023-04-27 12:03,1106174,386597,500655,218922,1106174
2023-04-27 12:04,1106187,386607,500655,218925,1106187
2023-04-27 12:05,1106198,386616,500656,218926,1106198
2023-04-27 12:06,1106211,386626,500656,218929,1106211
2023-04-27 12:07,1106222,386633,500656,218933,1106222
2023-04-27 12:08,1106234,386643,500656,218935,1106234
2023-04-27 12:09,1106246,386652,500657,218937,1106246
2023-04-27 12:10,1106258,386663,500657,218938,1106258
2023-04-27 12:11,1106269,386671,500657,218941,1106269
2023-04-27 12:12,1106280,386681,500657,218942,1106280
2023-04-27 12:13,1106291,386691,500657,218943,1106291
2023-04-27 12:14,1106303,386701,500657,218945,1106303
2023-04-27 12:15,1106315,386708,500660,218947,1106315
2023-04-27 12:16,1106326,386719,500660,218947,1106326
2023-04-27 12:17,1106337,386727,500662,218948,1106337
2023-04-27 12:18,1106349,386738,500662,218949,1106349
2023-04-27 12:19,1106360,386747,500664,218949,1106360
2023-04-27 12:20,1106372,386758,500664,218950,1106372
2023-04-27 12:21,1106383,386767,500665,218951,1106383
2023-04-27 12:22,1106396,386777,500665,218954,1106396
2023-04-27 12:23,1106408,386784,500668,218956,1106408
2023-04-27 12:24,1106419,386793,500668,218958,1106419
2023-04-27 12:25,1106432,386798,500675,218959,1106432
2023-04-27 12:26,1106443,386807,500675,218961,1106443
2023-04-27 12:27,1106454,386816,500677,218961,1106454
2023-04-27 12:28,1106466,386825,500677,218964,1106466
2023-04-27 12:29,1106477,386834,500678,218965,1106477
2023-04-27 12:30,1106489,386844,500678,218967,1106489
2023-04-27 12:31,1106501,386852,500682,218967,1106501
2023-04-27 12:32,1106513,386863,500682,218968,1106513
2023-04-27 12:33,1106524,386871,500684,218969,1106524
2023-04-27 12:34,1106537,386880,500685,218972,1106537
2023-04-27 12:35,1106548,386886,500689,218973,1106548
2023-04-27 12:36,1106560,386897,500689,218974,1106560
2023-04-27 12:37,1106572,386908,500689,218975,1106572
2023-04-27 12:39,1106583,386916,500689,218978,1106583
2023-04-27 12:40,1106596,386927,500689,218980,1106596
2023-04-27 12:41,1106609,386938,500689,218982,1106609
2023-04-27 12:42,1106620,386949,500689,218982,1106620
2023-04-27 12:43,1106631,386951,500697,218983,1106631
2023-04-27 12:44,1106643,386960,500697,218986,1106643
2023-04-27 12:45,1106654,386964,500702,218988,1106654
2023-04-27 12:46,1106665,386972,500702,218991,1106665
2023-04-27 12:47,1106677,386982,500704,218991,1106677
2023-04-27 12:48,1106689,386993,500704,218992,1106689
2023-04-27 12:49,1106700,387003,500706,218991,1106700
2023-04-27 12:50,1106713,387015,500706,218992,1106713
2023-04-27 12:51,1106724,387022,500708,218994,1106724
2023-04-27 12:52,1106736,387033,500708,218995,1106736
2023-04-27 12:53,1106748,387041,500712,218995,1106748
2023-04-27 12:54,1106760,387052,500712,218996,1106760
2023-04-27 12:55,1106770,387056,500715,218999,1106770
2023-04-27 12:56,1106782,387063,500716,219003,1106782
2023-04-27 12:57,1106793,387073,500716,219004,1106793
2023-04-27 12:58,1106805,387079,500721,219005,1106805
2023-04-27 12:59,1106816,387086,500721,219009,1106816
2023-04-27 13:00,1106833,387101,500723,219009,1106833
2023-04-27 13:01,1106863,387130,500723,219010,1106863
2023-04-27 13:02,1106892,387151,500727,219014,1106892
2023-04-27 13:03,1106918,387175,500728,219015,1106918
2023-04-27 13:04,1106947,387203,500728,219016,1106947
2023-04-27 13:05,1106975,387227,500730,219018,1106975
2023-04-27 13:06,1107003,387254,500731,219018,1107003
2023-04-27 13:07,1107031,387281,500731,219019,1107031
2023-04-27 13:08,1107061,387305,500734,219022,1107061
2023-04-27 13:09,1107089,387331,500734,219024,1107089
2023-04-27 13:10,1107117,387355,500737,219025,1107117
2023-04-27 13:11,1107145,387382,500738,219025,1107145
2023-04-27 13:12,1107173,387408,500738,219027,1107173
2023-04-27 13:13,1107200,387435,500738,219027,1107200
2023-04-27 13:14,1107228,387461,500738,219029,1107228
2023-04-27 13:15,1107256,387487,500738,219031,1107256
2023-04-27 13:16,1107286,387516,500738,219032,1107286
2023-04-27 13:17,1107314,387543,500738,219033,1107314
2023-04-27 13:18,1107342,387570,500738,219034,1107342
2023-04-27 13:19,1107370,387596,500738,219036,1107370
2023-04-27 13:20,1107399,387624,500738,219037,1107399
2023-04-27 13:21,1107426,387636,500751,219039,1107426
2023-04-27 13:22,1107456,387664,500751,219041,1107456
2023-04-27 13:23,1107484,387690,500752,219042,1107484
2023-04-27 13:24,1107511,387715,500752,219044,1107511
2023-04-27 13:26,1107539,387740,500753,219046,1107539
2023-04-27 13:27,1107569,387769,500753,219047,1107569
2023-04-27 13:28,1107596,387789,500758,219049,1107596
2023-04-27 13:29,1107625,387818,500758,219049,1107625
2023-04-27 13:30,1107653,387843,500761,219049,1107653
2023-04-27 13:31,1107681,387871,500761,219049,1107681
2023-04-27 13:32,1107707,387896,500761,219050,1107707
2023-04-27 13:33,1107736,387923,500761,219052,1107736
2023-04-27 13:34,1107763,387947,500763,219053,1107763
2023-04-27 13:35,1107791,387974,500763,219054,1107791
2023-04-27 13:36,1107820,387995,500769,219056,1107820
2023-04-27 13:37,1107849,388024,500769,219056,1107849
2023-04-27 13:38,1107876,388047,500772,219057,1107876
2023-04-27 13:39,1107905,388072,500776,219057,1107905
2023-04-27 13:40,1107933,388100,500775,219058,1107933
2023-04-27 13:41,1107962,388128,500775,219059,1107962
2023-04-27 13:42,1107990,388154,500776,219060,1107990
2023-04-27 13:43,1108019,388180,500776,219063,1108019
2023-04-27 13:44,1108047,388204,500778,219065,1108047
2023-04-27 13:45,1108075,388230,500780,219065,1108075
2023-04-27 13:46,1108102,388256,500780,219066,1108102
2023-04-27 13:47,1108132,388285,500781,219066,1108132
2023-04-27 13:48,1108160,388311,500781,219068,1108160
2023-04-27 13:49,1108188,388335,500784,219069,1108188
2023-04-27 13:50,1108217,388361,500784,219072,1108217
2023-04-27 13:51,1108245,388389,500784,219072,1108245
2023-04-27 13:52,1108274,388417,500784,219073,1108274
2023-04-27 13:53,1108302,388444,500785,219073,1108302
2023-04-27 13:54,1108331,388472,500785,219074,1108331
2023-04-27 13:55,1108358,388497,500786,219075,1108358
2023-04-27 13:56,1108386,388523,500788,219075,1108386
2023-04-27 13:57,1108416,388552,500788,219076,1108416
2023-04-27 13:58,1108443,388575,500790,219078,1108443
2023-04-27 13:59,1108471,388602,500790,219079,1108471
2023-04-27 14:00,1108497,388626,500790,219081,1108497
2023-04-27 14:01,1108518,388646,500790,219082,1108518
2023-04-27 14:02,1108540,388668,500790,219082,1108540
2023-04-27 14:03,1108562,388688,500790,219084,1108562
2023-04-27 14:04,1108585,388708,500793,219084,1108585
2023-04-27 14:05,1108606,388729,500793,219084,1108606
2023-04-27 14:06,1108630,388749,500797,219084,1108630
2023-04-27 14:07,1108653,388772,500797,219084,1108653
2023-04-27 14:08,1108674,388791,500798,219085,1108674
2023-04-27 14:09,1108697,388813,500798,219086,1108697
2023-04-27 14:10,1108718,388833,500799,219086,1108718
2023-04-27 14:11,1108740,388852,500799,219089,1108740
2023-04-27 14:12,1108764,388876,500799,219089,1108764
2023-04-27 14:14,1108786,388895,500799,219092,1108786
2023-04-27 14:15,1108808,388916,500799,219093,1108808
2023-04-27 14:16,1108831,388939,500799,219093,1108831
2023-04-27 14:17,1108855,388961,500800,219094,1108855
2023-04-27 14:18,1108877,388980,500800,219097,1108877
2023-04-27 14:19,1108900,389000,500802,219098,1108900
2023-04-27 14:20,1108923,389022,500802,219099,1108923
2023-04-27 14:21,1108945,389040,500804,219101,1108945
2023-04-27 14:22,1108967,389062,500804,219101,1108967
2023-04-27 14:23,1108989,389083,500805,219101,1108989
2023-04-27 14:24,1109012,389106,500805,219101,1109012
2023-04-27 14:25,1109034,389127,500806,219101,1109034
2023-04-27 14:26,1109058,389150,500806,219102,1109058
2023-04-27 14:27,1109080,389170,500807,219103,1109080
2023-04-27 14:28,1109102,389191,500807,219104,1109102
2023-04-27 14:29,1109126,389210,500810,219106,1109126
2023-04-27 14:30,1109148,389232,500810,219106,1109148
2023-04-27 14:31,1109169,389242,500815,219112,1109169
2023-04-27 14:32,1109193,389262,500815,219116,1109193
2023-04-27 14:33,1109216,389283,500816,219117,1109216
2023-04-27 14:34,1109237,389303,500816,219118,1109237
2023-04-27 14:35,1109260,389325,500816,219119,1109260
2023-04-27 14:36,1109281,389346,500816,219119,1109281
2023-04-27 14:37,1109304,389366,500816,219122,1109304
2023-04-27 14:38,1109326,389386,500816,219124,1109326
2023-04-27 14:39,1109348,389407,500817,219124,1109348
2023-04-27 14:40,1109370,389427,500817,219126,1109370
2023-04-27 14:41,1109392,389447,500819,219126,1109392
2023-04-27 14:42,1109415,389469,500819,219127,1109415
2023-04-27 14:43,1109437,389492,500819,219126,1109437
2023-04-27 14:44,1109458,389511,500819,219128,1109458
2023-04-27 14:45,1109480,389531,500819,219130,1109480
2023-04-27 14:46,1109504,389555,500819,219130,1109504
2023-04-27 14:47,1109525,389574,500820,219131,1109525
2023-04-27 14:48,1109548,389595,500820,219133,1109548
2023-04-27 14:49,1109571,389618,500820,219133,1109571
2023-04-27 14:50,1109593,389639,500820,219134,1109593
2023-04-27 14:51,1109615,389656,500823,219136,1109615
2023-04-27 14:52,1109636,389675,500823,219138,1109636
2023-04-27 14:53,1109658,389694,500825,219139,1109658
2023-04-27 14:54,1109680,389713,500825,219142,1109680
2023-04-27 14:55,1109704,389735,500824,219145,1109704
2023-04-27 14:56,1109726,389757,500824,219145,1109726
2023-04-27 14:57,1109748,389771,500828,219149,1109748
2023-04-27 14:58,1109770,389792,500828,219150,1109770
2023-04-27 14:59,1109792,389812,500829,219151,1109792
2023-04-27 15:00,1109807,389827,500829,219151,1109807
2023-04-27 15:02,1109821,389834,500834,219153,1109821
2023-04-27 15:03,1109835,389847,500834,219154,1109835
2023-04-27 15:04,1109848,389857,500836,219155,1109848
2023-04-27 15:05,1109862,389870,500836,219156,1109862
2023-04-27 15:06,1109877,389883,500838,219156,1109877
2023-04-27 15:07,1109891,389896,500838,219157,1109891
2023-04-27 15:08,1109906,389911,500838,219157,1109906
2023-04-27 15:09,1109921,389926,500838,219157,1109921
2023-04-27 15:10,1109935,389938,500840,219157,1109935
2023-04-27 15:11,1109948,389950,500840,219158,1109948
2023-04-27 15:12,1109962,389962,500841,219159,1109962
2023-04-27 15:13,1109976,389975,500841,219160,1109976
2023-04-27 15:14,1109991,389990,500841,219160,1109991
2023-04-27 15:15,1110005,390003,500841,219161,1110005
2023-04-27 15:16,1110019,390017,500841,219161,1110019
2023-04-27 15:17,1110034,390031,500841,219162,1110034
2023-04-27 15:18,1110048,390044,500842,219162,1110048
2023-04-27 15:19,1110063,390059,500842,219162,1110063
2023-04-27 15:20,1110078,390071,500844,219163,1110078
2023-04-27 15:21,1110092,390085,500844,219163,1110092
2023-04-27 15:22,1110106,390097,500845,219164,1110106
2023-04-27 15:23,1110120,390111,500845,219164,1110120
2023-04-27 15:24,1110134,390123,500846,219165,1110134
2023-04-27 15:25,1110148,390136,500847,219165,1110148
2023-04-27 15:26,1110162,390147,500847,219168,1110162
2023-04-27 15:27,1110176,390156,500852,219168,1110176
2023-04-27 15:28,1110190,390170,500852,219168,1110190
2023-04-27 15:29,1110205,390180,500856,219169,1110205
2023-04-27 15:30,1110220,390194,500856,219170,1110220
2023-04-27 15:31,1110234,390204,500859,219171,1110234
2023-04-27 15:32,1110248,390218,500859,219171,1110248
2023-04-27 15:33,1110262,390231,500860,219171,1110262
2023-04-27 15:34,1110276,390244,500860,219172,1110276
2023-04-27 15:35,1110290,390254,500864,219172,1110290
2023-04-27 15:36,1110304,390266,500864,219174,1110304
2023-04-27 15:37,1110318,390279,500865,219174,1110318
2023-04-27 15:38,1110333,390293,500865,219175,1110333
2023-04-27 15:39,1110347,390306,500866,219175,1110347
2023-04-27 15:40,1110361,390319,500866,219176,1110361
2023-04-27 15:41,1110375,390330,500868,219177,1110375
2023-04-27 15:42,1110390,390343,500868,219179,1110390
2023-04-27 15:43,1110404,390356,500869,219179,1110404
2023-04-27 15:44,1110418,390370,500869,219179,1110418
2023-04-27 15:45,1110432,390380,500869,219183,1110432
2023-04-27 15:46,1110447,390392,500871,219184,1110447
2023-04-27 15:47,1110462,390405,500871,219186,1110462
2023-04-27 15:48,1110475,390415,500872,219188,1110475
2023-04-27 15:50,1110490,390429,500872,219189,1110490
2023-04-27 15:51,1110504,390441,500874,219189,1110504
2023-04-27 15:52,1110519,390455,500874,219190,1110519
2023-04-27 15:53,1110533,390468,500873,219192,1110533
2023-04-27 15:54,1110548,390482,500873,219193,1110548
2023-04-27 15:55,1110562,390495,500873,219194,1110562
2023-04-27 15:56,1110577,390507,500873,219197,1110577
2023-04-27 15:57,1110591,390520,500874,219197,1110591
2023-04-27 15:58,1110608,390537,500874,219197,1110608
2023-04-27 15:59,1110621,390545,500877,219199,1110621
2023-04-27 16:00,1110636,390560,500877,219199,1110636
2023-04-27 16:01,1110648,390571,500877,219200,1110648
2023-04-27 16:02,1110660,390582,500877,219201,1110660
2023-04-27 16:03,1110672,390592,500878,219202,1110672
2023-04-27 16:04,1110685,390602,500878,219205,1110685
2023-04-27 16:05,1110698,390615,500878,219205,1110698
2023-04-27 16:06,1110710,390624,500878,219208,1110710
2023-04-27 16:07,1110722,390629,500883,219210,1110722
2023-04-27 16:08,1110735,390641,500883,219211,1110735
2023-04-27 16:09,1110747,390651,500885,219211,1110747
2023-04-27 16:10,1110760,390665,500885,219210,1110760
2023-04-27 16:11,1110773,390676,500887,219210,1110773
2023-04-27 16:12,1110786,390688,500887,219211,1110786
2023-04-27 16:13,1110797,390696,500890,219211,1110797
2023-04-27 16:14,1110813,390711,500890,219212,1110813
2023-04-27 16:15,1110825,390718,500892,219215,1110825
2023-04-27 16:16,1110838,390730,500892,219216,1110838
2023-04-27 16:17,1110851,390740,500895,219216,1110851
2023-04-27 16:18,1110863,390751,500895,219217,1110863
2023-04-27 16:19,1110876,390761,500897,219218,1110876
2023-04-27 16:20,1110889,390774,500897,219218,1110889
2023-04-27 16:21,1110900,390785,500897,219218,1110900
2023-04-27 16:22,1110913,390797,500897,219219,1110913
2023-04-27 16:23,1110926,390809,500898,219219,1110926
2023-04-27 16:24,1110938,390820,500898,219220,1110938
2023-04-27 16:25,1110950,390829,500898,219223,1110950
2023-04-27 16:26,1110963,390842,500898,219223,1110963
2023-04-27 16:27,1110975,390852,500900,219223,1110975
2023-04-27 16:28,1110988,390864,500901,219223,1110988
2023-04-27 16:29,1111001,390876,500901,219224,1111001
2023-04-27 16:30,1111015,390889,500901,219225,1111015
2023-04-27 16:31,1111028,390898,500904,219226,1111028
2023-04-27 16:32,1111040,390910,500904,219226,1111040
2023-04-27 16:33,1111053,390917,500909,219227,1111053
2023-04-27 16:34,1111065,390928,500909,219228,1111065
2023-04-27 16:35,1111077,390939,500910,219228,1111077
2023-04-27 16:36,1111090,390950,500912,219228,1111090
2023-04-27 16:37,1111102,390960,500912,219230,1111102
2023-04-27 16:39,1111114,390971,500912,219231,1111114
2023-04-27 16:40,1111127,390982,500913,219232,1111127
2023-04-27 16:41,1111139,390994,500913,219232,1111139
2023-04-27 16:42,1111151,391003,500916,219232,1111151
2023-04-27 16:43,1111165,391017,500916,219232,1111165
2023-04-27 16:44,1111178,391029,500917,219232,1111178
2023-04-27 16:45,1111191,391041,500917,219233,1111191
2023-04-27 16:46,1111203,391052,500917,219234,1111203
2023-04-27 16:47,1111216,391062,500917,219237,1111216
2023-04-27 16:48,1111227,391072,500917,219238,1111227
2023-04-27 16:49,1111241,391085,500917,219239,1111241
2023-04-27 16:50,1111252,391092,500921,219239,1111252
2023-04-27 16:51,1111265,391104,500921,219240,1111265
2023-04-27 16:52,1111277,391112,500924,219241,1111277
2023-04-27 16:53,1111290,391125,500924,219241,1111290
2023-04-27 16:54,1111303,391134,500927,219242,1111303
2023-04-27 16:55,1111314,391144,500927,219243,1111314
2023-04-27 16:56,1111327,391157,500928,219242,1111327
2023-04-27 16:57,1111340,391166,500930,219244,1111340
2023-04-27 16:58,1111352,391178,500930,219244,1111352
2023-04-27 16:59,1111364,391190,500930,219244,1111364
2023-04-27 17:00,1111377,391197,500935,219245,1111377
2023-04-27 17:01,1111392,391211,500935,219246,1111392
2023-04-27 17:02,1111408,391222,500938,219248,1111408
2023-04-27 17:03,1111422,391235,500938,219249,1111422
2023-04-27 17:04,1111437,391247,500939,219251,1111437
2023-04-27 17:05,1111452,391262,500939,219251,1111452
2023-04-27 17:06,1111466,391276,500939,219251,1111466
2023-04-27 17:07,1111481,391289,500939,219253,1111481
2023-04-27 17:08,1111495,391298,500942,219255,1111495
2023-04-27 17:09,1111510,391312,500942,219256,1111510
2023-04-27 17:10,1111525,391324,500945,219256,1111525
2023-04-27 17:11,1111539,391336,500945,219258,1111539
2023-04-27 17:12,1111553,391348,500946,219259,1111553
2023-04-27 17:13,1111569,391363,500946,219260,1111569
2023-04-27 17:14,1111584,391376,500948,219260,1111584
2023-04-27 17:15,1111597,391387,500948,219262,1111597
2023-04-27 17:16,1111612,391398,500952,219262,1111612
2023-04-27 17:17,1111627,391411,500952,219264,1111627
2023-04-27 17:18,1111641,391421,500955,219265,1111641
2023-04-27 17:19,1111655,391433,500955,219267,1111655
2023-04-27 17:20,1111671,391448,500954,219269,1111671
2023-04-27 17:21,1111685,391461,500954,219270,1111685
2023-04-27 17:22,1111700,391466,500960,219274,1111700
2023-04-27 17:23,1111715,391481,500960,219274,1111715
2023-04-27 17:24,1111731,391495,500961,219275,1111731
2023-04-27 17:26,1111745,391509,500961,219275,1111745
2023-04-27 17:27,1111759,391522,500961,219276,1111759
2023-04-27 17:28,1111774,391539,500961,219274,1111774
2023-04-27 17:29,1111789,391551,500962,219276,1111789
2023-04-27 17:30,1111803,391565,500962,219276,1111803
2023-04-27 17:31,1111817,391578,500962,219277,1111817
2023-04-27 17:32,1111832,391592,500962,219278,1111832
2023-04-27 17:33,1111846,391605,500963,219278,1111846
2023-04-27 17:34,1111861,391615,500967,219279,1111861
2023-04-27 17:35,1111875,391628,500967,219280,1111875
2023-04-27 17:36,1111889,391638,500971,219280,1111889
2023-04-27 17:37,1111904,391650,500971,219283,1111904
2023-04-27 17:38,1111918,391663,500971,219284,1111918
2023-04-27 17:39,1111932,391676,500971,219285,1111932
2023-04-27 17:40,1111947,391686,500975,219286,1111947
2023-04-27 17:41,1111962,391700,500975,219287,1111962
2023-04-27 17:42,1111977,391713,500976,219288,1111977
2023-04-27 17:43,1111991,391727,500976,219288,1111991
2023-04-27 17:44,1112005,391738,500978,219289,1112005
2023-04-27 17:45,1112019,391750,500978,219291,1112019
2023-04-27 17:46,1112034,391760,500981,219293,1112034
2023-04-27 17:47,1112050,391776,500981,219293,1112050
2023-04-27 17:48,1112064,391788,500983,219293,1112064
2023-04-27 17:49,1112078,391802,500983,219293,1112078
2023-04-27 17:50,1112093,391815,500984,219294,1112093
2023-04-27 17:51,1112107,391828,500984,219295,1112107
2023-04-27 17:52,1112122,391842,500985,219295,1112122
2023-04-27 17:53,1112136,391855,500985,219296,1112136
2023-04-27 17:54,1112151,391869,500986,219296,1112151
2023-04-27 17:55,1112165,391882,500986,219297,1112165
2023-04-27 17:56,1112179,391894,500988,219297,1112179
2023-04-27 17:57,1112194,391905,500988,219301,1112194
2023-04-27 17:58,1112209,391917,500990,219302,1112209
2023-04-27 17:59,1112223,391928,500990,219305,1112223
2023-04-27 18:00,1112234,391937,500990,219307,1112234
2023-04-27 18:01,1112244,391947,500990,219307,1112244
2023-04-27 18:02,1112256,391956,500992,219308,1112256
2023-04-27 18:03,1112266,391966,500992,219308,1112266
2023-04-27 18:04,1112275,391970,500996,219309,1112275
2023-04-27 18:05,1112285,391980,500996,219309,1112285
2023-04-27 18:06,1112295,391987,500999,219309,1112295
2023-04-27 18:07,1112306,391998,500999,219309,1112306
2023-04-27 18:08,1112316,392007,500999,219310,1112316
2023-04-27 18:09,1112327,392017,500999,219311,1112327
2023-04-27 18:10,1112338,392026,501001,219311,1112338
2023-04-27 18:11,1112347,392034,501001,219312,1112347
2023-04-27 18:13,1112357,392039,501005,219313,1112357
2023-04-27 18:14,1112367,392047,501005,219315,1112367
2023-04-27 18:15,1112377,392055,501007,219315,1112377
2023-04-27 18:16,1112387,392064,501007,219316,1112387
2023-04-27 18:17,1112397,392072,501007,219318,1112397
2023-04-27 18:18,1112407,392080,501007,219320,1112407
2023-04-27 18:19,1112418,392085,501011,219322,1112418
2023-04-27 18:20,1112428,392095,501011,219322,1112428
2023-04-27 18:21,1112438,392100,501013,219325,1112438
2023-04-27 18:22,1112449,392110,501013,219326,1112449
2023-04-27 18:23,1112459,392119,501013,219327,1112459
2023-04-27 18:24,1112469,392128,501013,219328,1112469
2023-04-27 18:25,1112479,392135,501014,219330,1112479
2023-04-27 18:26,1112489,392145,501014,219330,1112489
2023-04-27 18:27,1112498,392149,501019,219330,1112498
2023-04-27 18:28,1112508,392159,501019,219330,1112508
2023-04-27 18:29,1112518,392166,501021,219331,1112518
2023-04-27 18:30,1112529,392176,501021,219332,1112529
2023-04-27 18:31,1112539,392181,501025,219333,1112539
2023-04-27 18:32,1112549,392189,501025,219335,1112549
2023-04-27 18:33,1112559,392198,501026,219335,1112559
2023-04-27 18:34,1112569,392205,501026,219338,1112569
2023-04-27 18:35,1112579,392209,501029,219341,1112579
2023-04-27 18:36,1112589,392218,501029,219342,1112589
2023-04-27 18:37,1112600,392225,501032,219343,1112600
2023-04-27 18:38,1112610,392232,501032,219346,1112610
2023-04-27 18:39,1112621,392241,501033,219347,1112621
2023-04-27 18:40,1112631,392251,501033,219347,1112631
2023-04-27 18:41,1112640,392255,501036,219349,1112640
2023-04-27 18:42,1112651,392264,501036,219351,1112651
2023-04-27 18:43,1112661,392273,501036,219352,1112661
2023-04-27 18:44,1112670,392282,501036,219352,1112670
2023-04-27 18:45,1112682,392292,501038,219352,1112682
2023-04-27 18:46,1112692,392302,501038,219352,1112692
2023-04-27 18:47,1112704,392312,501040,219352,1112704
2023-04-27 18:48,1112715,392320,501042,219353,1112715
2023-04-27 18:49,1112725,392330,501042,219353,1112725
2023-04-27 18:50,1112735,392336,501045,219354,1112735
2023-04-27 18:51,1112746,392347,501045,219354,1112746
2023-04-27 18:52,1112756,392352,501047,219357,1112756
2023-04-27 18:53,1112766,392362,501047,219357,1112766
2023-04-27 18:54,1112775,392366,501051,219358,1112775
2023-04-27 18:55,1112785,392376,501051,219358,1112785
2023-04-27 18:56,1112796,392385,501052,219359,1112796
2023-04-27 18:57,1112806,392395,501052,219359,1112806
2023-04-27 18:58,1112816,392402,501054,219360,1112816
2023-04-27 19:00,1112827,392410,501055,219362,1112827
2023-04-27 19:01,1112847,392428,501055,219364,1112847
2023-04-27 19:02,1112866,392444,501057,219365,1112866
2023-04-27 19:03,1112885,392459,501057,219369,1112885
2023-04-27 19:04,1112905,392477,501058,219370,1112905
2023-04-27 19:05,1112924,392492,501058,219374,1112924
2023-04-27 19:06,1112946,392511,501059,219376,1112946
2023-04-27 19:07,1112965,392527,501059,219379,1112965
2023-04-27 19:08,1112985,392544,501061,219380,1112985
2023-04-27 19:09,1113004,392562,501061,219381,1113004
2023-04-27 19:10,1113024,392580,501063,219381,1113024
2023-04-27 19:11,1113044,392598,501063,219383,1113044
2023-04-27 19:12,1113063,392613,501066,219384,1113063
2023-04-27 19:13,1113084,392634,501066,219384,1113084
2023-04-27 19:14,1113103,392651,501068,219384,1113103
2023-04-27 19:15,1113123,392669,501068,219386,1113123
2023-04-27 19:16,1113142,392686,501068,219388,1113142
2023-04-27 19:17,1113164,392707,501068,219389,1113164
2023-04-27 19:18,1113183,392720,501072,219391,1113183
2023-04-27 19:19,1113203,392737,501072,219394,1113203
2023-04-27 19:20,1113222,392755,501073,219394,1113222
2023-04-27 19:21,1113240,392770,501074,219396,1113240
2023-04-27 19:22,1113260,392788,501074,219398,1113260
2023-04-27 19:23,1113280,392803,501077,219400,1113280
2023-04-27 19:24,1113299,392818,501077,219404,1113299
2023-04-27 19:25,1113317,392832,501081,219404,1113317
2023-04-27 19:26,1113337,392849,501081,219407,1113337
2023-04-27 19:27,1113357,392867,501083,219407,1113357
2023-04-27 19:28,1113376,392883,501083,219410,1113376
2023-04-27 19:29,1113396,392902,501083,219411,1113396
2023-04-27 19:30,1113415,392919,501083,219413,1113415
2023-04-27 19:31,1113435,392936,501086,219413,1113435
2023-04-27 19:32,1113455,392954,501087,219414,1113455
2023-04-27 19:33,1113474,392970,501089,219415,1113474
2023-04-27 19:34,1113495,392987,501092,219416,1113495
2023-04-27 19:35,1113513,393004,501092,219417,1113513
2023-04-27 19:36,1113533,393021,501094,219418,1113533
2023-04-27 19:37,1113553,393040,501094,219419,1113553
2023-04-27 19:38,1113571,393055,501096,219420,1113571
2023-04-27 19:39,1113591,393074,501096,219421,1113591
2023-04-27 19:40,1113610,393089,501098,219423,1113610
2023-04-27 19:41,1113630,393105,501100,219425,1113630
2023-04-27 19:42,1113649,393122,501100,219427,1113649
2023-04-27 19:43,1113670,393140,501103,219427,1113670
2023-04-27 19:44,1113688,393157,501104,219427,1113688
2023-04-27 19:45,1113707,393174,501104,219429,1113707
2023-04-27 19:47,1113729,393193,501105,219431,1113729
2023-04-27 19:48,1113749,393213,501105,219431,1113749
2023-04-27 19:49,1113768,393231,501105,219432,1113768
2023-04-27 19:50,1113787,393246,501108,219433,1113787
2023-04-27 19:51,1113807,393265,501108,219434,1113807
2023-04-27 19:52,1113828,393282,501111,219435,1113828
2023-04-27 19:53,1113848,393300,501111,219437,1113848
2023-04-27 19:54,1113867,393317,501111,219439,1113867
2023-04-27 19:55,1113885,393335,501111,219439,1113885
2023-04-27 19:56,1113907,393350,501117,219440,1113907
2023-04-27 19:57,1113927,393370,501117,219440,1113927
2023-04-27 19:58,1113947,393387,501120,219440,1113947
2023-04-27 19:59,1113966,393402,501120,219444,1113966
2023-04-27 20:00,1113987,393417,501124,219446,1113987
2023-04-27 20:01,1114017,393446,501124,219447,1114017
2023-04-27 20:02,1114047,393474,501126,219447,1114047
2023-04-27 20:03,1114078,393504,501126,219448,1114078
2023-04-27 20:04,1114107,393532,501127,219448,1114107
2023-04-27 20:05,1114141,393565,501127,219449,1114141
2023-04-27 20:06,1114171,393589,501131,219451,1114171
2023-04-27 20:07,1114203,393621,501131,219451,1114203
2023-04-27 20:08,1114232,393648,501132,219452,1114232
2023-04-27 20:09,1114266,393683,501132,219451,1114266
2023-04-27 20:10,1114295,393706,501136,219453,1114295
2023-04-27 20:11,1114326,393737,501136,219453,1114326
2023-04-27 20:12,1114358,393768,501136,219454,1114358
2023-04-27 20:13,1114389,393798,501136,219455,1114389
2023-04-27 20:14,1114419,393823,501138,219458,1114419
2023-04-27 20:15,1114450,393854,501138,219458,1114450
2023-04-27 20:16,1114480,393879,501141,219460,1114480
2023-04-27 20:17,1114512,393910,501141,219461,1114512
2023-04-27 20:18,1114542,393938,501141,219463,1114542
2023-04-27 20:19,1114573,393968,501141,219464,1114573
2023-04-27 20:20,1114604,393996,501143,219465,1114604
2023-04-27 20:21,1114636,394026,501143,219467,1114636
2023-04-27 20:22,1114667,394051,501146,219470,1114667
2023-04-27 20:23,1114697,394080,501145,219472,1114697
2023-04-27 20:24,1114727,394108,501145,219474,1114727
2023-04-27 20:25,1114760,394139,501147,219474,1114760
2023-04-27 20:26,1114790,394169,501147,219474,1114790
2023-04-27 20:27,1114821,394195,501151,219475,1114821
2023-04-27 20:28,1114852,394226,501151,219475,1114852
2023-04-27 20:29,1114883,394250,501156,219477,1114883
2023-04-27 20:30,1114915,394279,501156,219480,1114915
2023-04-27 20:31,1114946,394306,501158,219482,1114946
2023-04-27 20:32,1114976,394335,501158,219483,1114976
2023-04-27 20:34,1115007,394361,501161,219485,1115007
2023-04-27 20:35,1115037,394389,501161,219487,1115037
2023-04-27 20:36,1115069,394418,501163,219488,1115069
2023-04-27 20:37,1115099,394448,501163,219488,1115099
2023-04-27 20:38,1115131,394478,501163,219490,1115131
2023-04-27 20:39,1115162,394510,501163,219489,1115162
2023-04-27 20:40,1115191,394534,501166,219491,1115191
2023-04-27 20:41,1115222,394564,501166,219492,1115222
2023-04-27 20:42,1115253,394590,501169,219494,1115253
2023-04-27 20:43,1115284,394619,501169,219496,1115284
2023-04-27 20:44,1115318,394647,501171,219500,1115318
2023-04-27 20:45,1115348,394676,501172,219500,1115348
2023-04-27 20:46,1115378,394702,501174,219502,1115378
2023-04-27 20:47,1115409,394733,501174,219502,1115409
2023-04-27 20:48,1115440,394762,501176,219502,1115440
2023-04-27 20:49,1115469,394790,501176,219503,1115469
2023-04-27 20:50,1115501,394817,501180,219504,1115501
2023-04-27 20:51,1115530,394845,501180,219505,1115530
2023-04-27 20:52,1115565,394878,501181,219506,1115565
2023-04-27 20:53,1115595,394905,501181,219509,1115595
2023-04-27 20:54,1115624,394929,501183,219512,1115624
2023-04-27 20:55,1115657,394959,501183,219515,1115657
2023-04-27 20:56,1115688,394986,501185,219517,1115688
2023-04-27 20:57,1115717,395015,501185,219517,1115717
2023-04-27 20:58,1115749,395046,501185,219518,1115749
2023-04-27 20:59,1115779,395071,501189,219519,1115779
2023-04-27 21:00,1115804,395095,501189,219520,1115804
2023-04-27 21:01,1115826,395113,501193,219520,1115826
2023-04-27 21:02,1115850,395136,501193,219521,1115850
2023-04-27 21:03,1115872,395155,501195,219522,1115872
2023-04-27 21:04,1115895,395176,501195,219524,1115895
2023-04-27 21:05,1115917,395194,501197,219526,1115917
2023-04-27 21:06,1115939,395214,501197,219528,1115939
2023-04-27 21:07,1115962,395234,501199,219529,1115962
2023-04-27 21:08,1115983,395252,501199,219532,1115983
2023-04-27 21:09,1116006,395270,501202,219534,1116006
2023-04-27 21:10,1116027,395290,501202,219535,1116027
2023-04-27 21:11,1116049,395310,501204,219535,1116049
2023-04-27 21:12,1116071,395331,501204,219536,1116071
2023-04-27 21:13,1116094,395351,501206,219537,1116094
2023-04-27 21:14,1116114,395370,501206,219538,1116114
2023-04-27 21:15,1116139,395393,501207,219539,1116139
2023-04-27 21:16,1116160,395412,501207,219541,1116160
2023-04-27 21:17,1116183,395427,501210,219546,1116183
2023-04-27 21:18,1116205,395448,501210,219547,1116205
2023-04-27 21:20,1116228,395465,501214,219549,1116228
2023-04-27 21:21,1116250,395486,501214,219550,1116250
2023-04-27 21:22,1116271,395501,501218,219552,1116271
2023-04-27 21:23,1116294,395522,501218,219554,1116294
2023-04-27 21:24,1116317,395544,501219,219554,1116317
2023-04-27 21:25,1116340,395567,501219,219554,1116340
2023-04-27 21:26,1116361,395588,501219,219554,1116361
2023-04-27 21:27,1116385,395611,501219,219555,1116385
2023-04-27 21:28,1116407,395629,501219,219559,1116407
2023-04-27 21:29,1116429,395651,501219,219559,1116429
2023-04-27 21:30,1116452,395667,501224,219561,1116452
2023-04-27 21:31,1116475,395688,501224,219563,1116475
2023-04-27 21:32,1116499,395705,501229,219565,1116499
2023-04-27 21:33,1116521,395725,501229,219567,1116521
2023-04-27 21:34,1116543,395746,501229,219568,1116543
2023-04-27 21:35,1116565,395767,501229,219569,1116565
2023-04-27 21:36,1116587,395783,501235,219569,1116587
2023-04-27 21:37,1116608,395804,501235,219569,1116608
2023-04-27 21:38,1116633,395829,501234,219570,1116633
2023-04-27 21:39,1116654,395848,501234,219572,1116654
2023-04-27 21:40,1116677,395870,501235,219572,1116677
2023-04-27 21:41,1116698,395890,501235,219573,1116698
2023-04-27 21:42,1116721,395909,501237,219575,1116721
2023-04-27 21:43,1116742,395927,501237,219578,1116742
2023-04-27 21:44,1116766,395953,501235,219578,1116766
2023-04-27 21:45,1116788,395974,501235,219579,1116788
2023-04-27 21:46,1116810,395993,501236,219581,1116810
2023-04-27 21:47,1116833,396015,501236,219582,1116833
2023-04-27 21:48,1116855,396031,501240,219584,1116855
2023-04-27 21:49,1116877,396053,501240,219584,1116877
2023-04-27 21:50,1116899,396072,501241,219586,1116899
2023-04-27 21:51,1116922,396090,501244,219588,1116922
2023-04-27 21:52,1116943,396109,501244,219590,1116943
2023-04-27 21:53,1116966,396126,501246,219594,1116966
2023-04-27 21:54,1116988,396144,501246,219598,1116988
2023-04-27 21:55,1117009,396160,501250,219599,1117009
2023-04-27 21:56,1117031,396181,501250,219600,1117031
2023-04-27 21:57,1117054,396199,501254,219601,1117054
2023-04-27 21:58,1117077,396218,501254,219605,1117077
2023-04-27 21:59,1117099,396238,501254,219607,1117099
2023-04-27 22:00,1117113,396250,501254,219609,1117113
2023-04-27 22:01,1117128,396259,501258,219611,1117128
2023-04-27 22:02,1117142,396273,501258,219611,1117142
2023-04-27 22:03,1117158,396283,501262,219613,1117158
2023-04-27 22:04,1117172,396297,501262,219613,1117172
2023-04-27 22:05,1117186,396308,501264,219614,1117186
2023-04-27 22:07,1117201,396321,501264,219616,1117201
2023-04-27 22:08,1117215,396331,501268,219616,1117215
2023-04-27 22:09,1117229,396344,501268,219617,1117229
2023-04-27 22:10,1117246,396354,501272,219620,1117246
2023-04-27 22:11,1117260,396367,501272,219621,1117260
2023-04-27 22:12,1117274,396377,501275,219622,1117274
2023-04-27 22:13,1117289,396389,501275,219625,1117289
2023-04-27 22:14,1117305,396396,501283,219626,1117305
2023-04-27 22:15,1117319,396409,501283,219627,1117319
2023-04-27 22:16,1117335,396420,501287,219628,1117335
2023-04-27 22:17,1117348,396433,501287,219628,1117348
2023-04-27 22:18,1117366,396447,501290,219629,1117366
2023-04-27 22:19,1117381,396461,501290,219630,1117381
2023-04-27 22:20,1117396,396471,501293,219632,1117396
2023-04-27 22:21,1117411,396482,501293,219636,1117411
2023-04-27 22:22,1117426,396492,501296,219638,1117426
2023-04-27 22:23,1117440,396503,501296,219641,1117440
2023-04-27 22:24,1117455,396512,501301,219642,1117455
2023-04-27 22:25,1117471,396526,501301,219644,1117471
2023-04-27 22:26,1117487,396539,501302,219646,1117487
2023-04-27 22:27,1117500,396548,501302,219650,1117500
2023-04-27 22:28,1117515,396555,501308,219652,1117515
2023-04-27 22:29,1117530,396568,501308,219654,1117530
2023-04-27 22:30,1117547,396579,501311,219657,1117547
2023-04-27 22:31,1117562,396590,501311,219661,1117562
2023-04-27 22:32,1117576,396601,501314,219661,1117576
2023-04-27 22:33,1117590,396612,501314,219664,1117590
2023-04-27 22:34,1117604,396621,501318,219665,1117604
2023-04-27 22:35,1117618,396634,501318,219666,1117618
2023-04-27 22:36,1117634,396646,501320,219668,1117634
2023-04-27 22:37,1117648,396659,501320,219669,1117648
2023-04-27 22:38,1117665,396672,501321,219672,1117665
2023-04-27 22:39,1117678,396682,501321,219675,1117678
2023-04-27 22:40,1117693,396694,501323,219676,1117693
2023-04-27 22:41,1117708,396704,501323,219681,1117708
2023-04-27 22:42,1117722,396714,501324,219684,1117722
2023-04-27 22:43,1117736,396723,501324,219689,1117736
2023-04-27 22:44,1117751,396731,501325,219695,1117751
2023-04-27 22:45,1117766,396743,501325,219698,1117766
2023-04-27 22:46,1117782,396752,501331,219699,1117782
2023-04-27 22:47,1117796,396762,501331,219703,1117796
2023-04-27 22:48,1117811,396772,501332,219707,1117811
2023-04-27 22:49,1117826,396786,501332,219708,1117826
2023-04-27 22:50,1117839,396795,501334,219710,1117839
2023-04-27 22:51,1117854,396809,501334,219711,1117854
2023-04-27 22:53,1117871,396821,501337,219713,1117871
2023-04-27 22:54,1117885,396835,501337,219713,1117885
2023-04-27 22:55,1117899,396847,501339,219713,1117899
2023-04-27 22:56,1117914,396859,501339,219716,1117914
2023-04-27 22:57,1117931,396871,501341,219719,1117931
2023-04-27 22:58,1117945,396881,501341,219723,1117945
2023-04-27 22:59,1117960,396892,501345,219723,1117960
2023-04-27 23:00,1117974,396905,501345,219724,1117974
2023-04-27 23:01,1117995,396916,501350,219729,1117995
2023-04-27 23:02,1118016,396934,501351,219731,1118016
2023-04-27 23:03,1118036,396954,501351,219731,1118036
2023-04-27 23:04,1118056,396967,501353,219736,1118056
2023-04-27 23:05,1118077,396987,501353,219737,1118077
2023-04-27 23:06,1118097,397001,501355,219741,1118097
2023-04-27 23:07,1118117,397021,501355,219741,1118117
2023-04-27 23:08,1118140,397039,501359,219742,1118140
2023-04-27 23:09,1118161,397054,501362,219745,1118161
2023-04-27 23:10,1118182,397073,501362,219747,1118182
2023-04-27 23:11,1118202,397089,501366,219747,1118202
2023-04-27 23:12,1118222,397106,501367,219749,1118222
2023-04-27 23:13,1118243,397124,501368,219751,1118243
2023-04-27 23:14,1118264,397141,501368,219755,1118264
2023-04-27 23:15,1118284,397159,501370,219755,1118284
2023-04-27 23:16,1118306,397180,501370,219756,1118306
2023-04-27 23:17,1118327,397196,501370,219761,1118327
2023-04-27 23:18,1118347,397212,501370,219765,1118347
2023-04-27 23:19,1118367,397223,501375,219769,1118367
2023-04-27 23:20,1118388,397243,501375,219770,1118388
2023-04-27 23:21,1118408,397260,501377,219771,1118408
2023-04-27 23:22,1118429,397277,501377,219775,1118429
2023-04-27 23:23,1118450,397294,501380,219776,1118450
2023-04-27 23:24,1118470,397311,501380,219779,1118470
2023-04-27 23:25,1118490,397330,501381,219779,1118490
2023-04-27 23:26,1118509,397348,501381,219780,1118509
2023-04-27 23:27,1118530,397363,501383,219784,1118530
2023-04-27 23:28,1118550,397382,501383,219785,1118550
2023-04-27 23:29,1118570,397398,501384,219788,1118570
2023-04-27 23:30,1118590,397414,501384,219792,1118590
2023-04-27 23:31,1118610,397429,501388,219793,1118610
2023-04-27 23:32,1118632,397448,501388,219796,1118632
2023-04-27 23:33,1118651,397461,501390,219800,1118651
2023-04-27 23:34,1118674,397484,501390,219800,1118674
2023-04-27 23:35,1118693,397500,501392,219801,1118693
2023-04-27 23:36,1118713,397518,501392,219803,1118713
2023-04-27 23:37,1118734,397534,501395,219805,1118734
2023-04-27 23:38,1118755,397551,501395,219809,1118755
2023-04-27 23:40,1118776,397569,501396,219811,1118776
2023-04-27 23:41,1118797,397589,501396,219812,1118797
2023-04-27 23:42,1118818,397604,501398,219816,1118818
2023-04-27 23:43,1118838,397621,501398,219819,1118838
2023-04-27 23:44,1118858,397638,501400,219820,1118858
2023-04-27 23:45,1118878,397658,501400,219820,1118878
2023-04-27 23:46,1118899,397676,501401,219822,1118899
2023-04-27 23:47,1118919,397694,501401,219824,1118919
2023-04-27 23:48,1118940,397715,501400,219825,1118940
2023-04-27 23:49,1118961,397734,501400,219827,1118961
2023-04-27 23:50,1118981,397748,501402,219831,1118981
2023-04-27 23:51,1119001,397765,501403,219833,1119001
2023-04-27 23:52,1119022,397783,501403,219836,1119022
2023-04-27 23:53,1119043,397797,501407,219839,1119043
2023-04-27 23:54,1119062,397814,501407,219841,1119062
2023-04-27 23:55,1119084,397830,501411,219843,1119084
2023-04-27 23:56,1119104,397846,501411,219847,1119104
2023-04-27 23:57,1119124,397862,501415,219847,1119124
2023-04-27 23:58,1119146,397881,501415,219850,1119146
2023-04-27 23:59,1119165,397894,501420,219851,1119165
2023-04-28 00:00,1119188,397911,501425,219852,1119188
2023-04-28 00:01,1119212,397933,501425,219854,1119212
2023-04-28 00:02,1119235,397950,501428,219857,1119235
2023-04-28 00:03,1119256,397971,501428,219857,1119256
2023-04-28 00:04,1119278,397989,501430,219859,1119278
2023-04-28 00:05,1119302,398011,501430,219861,1119302
2023-04-28 00:06,1119323,398026,501433,219864,1119323
2023-04-28 00:07,1119346,398048,501433,219865,1119346
2023-04-28 00:08,1119368,398065,501435,219868,1119368
2023-04-28 00:09,1119391,398088,501435,219868,1119391
2023-04-28 00:10,1119413,398108,501436,219869,1119413
2023-04-28 00:11,1119435,398130,501436,219869,1119435
2023-04-28 00:12,1119458,398147,501439,219872,1119458
2023-04-28 00:13,1119478,398166,501439,219873,1119478
2023-04-28 00:14,1119502,398185,501442,219875,1119502
2023-04-28 00:15,1119525,398206,501442,219877,1119525
2023-04-28 00:16,1119546,398223,501445,219878,1119546
2023-04-28 00:17,1119570,398245,501445,219880,1119570
2023-04-28 00:18,1119593,398266,501445,219882,1119593
2023-04-28 00:19,1119616,398289,501445,219882,1119616
2023-04-28 00:20,1119638,398307,501448,219883,1119638
2023-04-28 00:21,1119663,398331,501448,219884,1119663
2023-04-28 00:22,1119685,398350,501450,219885,1119685
2023-04-28 00:23,1119706,398370,501450,219886,1119706
2023-04-28 00:24,1119728,398388,501454,219886,1119728
2023-04-28 00:25,1119751,398410,501454,219887,1119751
2023-04-28 00:26,1119772,398431,501453,219888,1119772
2023-04-28 00:27,1119796,398453,501453,219890,1119796
2023-04-28 00:29,1119817,398471,501455,219891,1119817
2023-04-28 00:30,1119839,398493,501455,219891,1119839
2023-04-28 00:31,1119861,398513,501457,219891,1119861
2023-04-28 00:32,1119883,398532,501457,219894,1119883
2023-04-28 00:33,1119906,398551,501460,219895,1119906
2023-04-28 00:34,1119929,398574,501460,219895,1119929
2023-04-28 00:35,1119950,398590,501462,219898,1119950
2023-04-28 00:36,1119972,398611,501462,219899,1119972
2023-04-28 00:37,1119995,398630,501463,219902,1119995
2023-04-28 00:38,1120019,398652,501463,219904,1120019
2023-04-28 00:39,1120041,398671,501465,219905,1120041
2023-04-28 00:40,1120062,398691,501465,219906,1120062
2023-04-28 00:41,1120085,398707,501469,219909,1120085
2023-04-28 00:42,1120108,398730,501469,219909,1120108
2023-04-28 00:43,1120129,398749,501470,219910,1120129
2023-04-28 00:44,1120151,398771,501470,219910,1120151
2023-04-28 00:45,1120173,398788,501472,219913,1120173
2023-04-28 00:46,1120196,398810,501472,219914,1120196
2023-04-28 00:47,1120217,398827,501475,219915,1120217
2023-04-28 00:48,1120240,398849,501475,219916,1120240
2023-04-28 00:49,1120262,398867,501479,219916,1120262
2023-04-28 00:50,1120284,398888,501479,219917,1120284
2023-04-28 00:51,1120306,398909,501480,219917,1120306
2023-04-28 00:52,1120328,398931,501480,219917,1120328
2023-04-28 00:53,1120350,398949,501481,219920,1120350
2023-04-28 00:54,1120372,398969,501481,219922,1120372
2023-04-28 00:55,1120394,398990,501481,219923,1120394
2023-04-28 00:56,1120417,399012,501481,219924,1120417
2023-04-28 00:57,1120438,399030,501483,219925,1120438
2023-04-28 00:58,1120460,399051,501483,219926,1120460
2023-04-28 00:59,1120483,399070,501485,219928,1120483
2023-04-28 01:00,1120498,399084,501485,219929,1120498
2023-04-28 01:01,1120507,399092,501485,219930,1120507
2023-04-28 01:02,1120517,399100,501486,219931,1120517
2023-04-28 01:03,1120527,399109,501486,219932,1120527
2023-04-28 01:04,1120538,399117,501486,219935,1120538
2023-04-28 01:05,1120548,399126,501487,219935,1120548
2023-04-28 01:06,1120558,399135,501487,219936,1120558
2023-04-28 01:07,1120568,399141,501489,219938,1120568
2023-04-28 01:08,1120578,399149,501489,219940,1120578
2023-04-28 01:09,1120588,399157,501490,219941,1120588
2023-04-28 01:10,1120598,399165,501490,219943,1120598
2023-04-28 01:11,1120609,399175,501491,219943,1120609
2023-04-28 01:12,1120619,399183,501491,219945,1120619
2023-04-28 01:13,1120629,399189,501493,219947,1120629
2023-04-28 01:14,1120640,399200,501493,219947,1120640
2023-04-28 01:16,1120650,399209,501494,219947,1120650
2023-04-28 01:17,1120661,399220,501494,219947,1120661
2023-04-28 01:18,1120671,399228,501494,219949,1120671
2023-04-28 01:19,1120680,399237,501494,219949,1120680
2023-04-28 01:20,1120691,399250,501492,219949,1120691
2023-04-28 01:21,1120701,399259,501492,219950,1120701
2023-04-28 01:22,1120712,399270,501492,219950,1120712
2023-04-28 01:23,1120723,399279,501492,219952,1120723
2023-04-28 01:24,1120733,399287,501493,219953,1120733
2023-04-28 01:25,1120743,399296,501493,219954,1120743
2023-04-28 01:26,1120753,399305,501494,219954,1120753
2023-04-28 01:27,1120763,399314,501494,219955,1120763
2023-04-28 01:28,1120773,399323,501493,219957,1120773
2023-04-28 01:29,1120783,399333,501493,219957,1120783
2023-04-28 01:30,1120793,399341,501493,219959,1120793
2023-04-28 01:31,1120804,399351,501493,219960,1120804
2023-04-28 01:32,1120815,399362,501493,219960,1120815
2023-04-28 01:33,1120825,399372,501493,219960,1120825
2023-04-28 01:34,1120835,399382,501493,219960,1120835
2023-04-28 01:35,1120845,399392,501493,219960,1120845
2023-04-28 01:36,1120855,399399,501494,219962,1120855
2023-04-28 01:37,1120865,399409,501494,219962,1120865
2023-04-28 01:38,1120875,399416,501496,219963,1120875
2023-04-28 01:39,1120886,399426,501496,219964,1120886
2023-04-28 01:40,1120896,399436,501496,219964,1120896
2023-04-28 01:41,1120906,399445,501496,219965,1120906
2023-04-28 01:42,1120916,399452,501498,219966,1120916
2023-04-28 01:43,1120927,399464,501498,219965,1120927
2023-04-28 01:44,1120938,399472,501501,219965,1120938
2023-04-28 01:45,1120947,399481,501501,219965,1120947
2023-04-28 01:46,1120957,399489,501503,219965,1120957
2023-04-28 01:47,1120968,399499,501503,219966,1120968
2023-04-28 01:48,1120977,399508,501502,219967,1120977
2023-04-28 01:49,1120988,399519,501502,219967,1120988
2023-04-28 01:50,1120998,399527,501502,219969,1120998
2023-04-28 01:51,1121008,399534,501502,219972,1121008
2023-04-28 01:52,1121018,399542,501502,219974,1121018
2023-04-28 01:53,1121029,399552,501502,219975,1121029
2023-04-28 01:54,1121039,399561,501502,219976,1121039
2023-04-28 01:55,1121049,399571,501502,219976,1121049
2023-04-28 01:56,1121060,399580,501502,219978,1121060
2023-04-28 01:57,1121070,399590,501502,219978,1121070
2023-04-28 01:58,1121079,399598,501503,219978,1121079
2023-04-28 01:59,1121090,399607,501503,219980,1121090
2023-04-28 02:00,1121104,399618,501504,219982,1121104
2023-04-28 02:01,1121121,399635,501504,219982,1121121
2023-04-28 02:02,1121138,399650,501506,219982,1121138
2023-04-28 02:03,1121154,399666,501506,219982,1121154
2023-04-28 02:04,1121169,399679,501508,219982,1121169
2023-04-28 02:05,1121186,399696,501508,219982,1121186
2023-04-28 02:07,1121202,399710,501509,219983,1121202
2023-04-28 02:08,1121218,399726,501509,219983,1121218
2023-04-28 02:09,1121234,399740,501510,219984,1121234
2023-04-28 02:10,1121250,399755,501510,219985,1121250
2023-04-28 02:11,1121266,399770,501511,219985,1121266
2023-04-28 02:12,1121283,399787,501511,219985,1121283
2023-04-28 02:13,1121299,399802,501511,219986,1121299
2023-04-28 02:14,1121315,399815,501513,219987,1121315
2023-04-28 02:15,1121331,399831,501513,219987,1121331
2023-04-28 02:16,1121348,399847,501513,219988,1121348
2023-04-28 02:17,1121363,399862,501513,219988,1121363
2023-04-28 02:18,1121380,399877,501514,219989,1121380
2023-04-28 02:19,1121396,399892,501514,219990,1121396
2023-04-28 02:20,1121412,399906,501514,219992,1121412
2023-04-28 02:21,1121429,399923,501514,219992,1121429
2023-04-28 02:22,1121445,399939,501514,219992,1121445
2023-04-28 02:23,1121461,399955,501514,219992,1121461
2023-04-28 02:24,1121478,399974,501512,219992,1121478
2023-04-28 02:25,1121495,399989,501512,219994,1121495
2023-04-28 02:26,1121512,400005,501512,219995,1121512
2023-04-28 02:27,1121528,400021,501512,219995,1121528
2023-04-28 02:28,1121544,400036,501513,219995,1121544
2023-04-28 02:29,1121560,400052,501513,219995,1121560
2023-04-28 02:30,1121576,400066,501514,219996,1121576
2023-04-28 02:31,1121592,400081,501514,219997,1121592
2023-04-28 02:32,1121610,400099,501514,219997,1121610
2023-04-28 02:33,1121625,400113,501514,219998,1121625
2023-04-28 02:34,1121642,400130,501514,219998,1121642
2023-04-28 02:35,1121658,400146,501514,219998,1121658
2023-04-28 02:36,1121675,400162,501515,219998,1121675
2023-04-28 02:37,1121691,400178,501515,219998,1121691
2023-04-28 02:38,1121707,400194,501515,219998,1121707
2023-04-28 02:39,1121723,400210,501515,219998,1121723
2023-04-28 02:40,1121739,400226,501515,219998,1121739
2023-04-28 02:41,1121755,400241,501515,219999,1121755
2023-04-28 02:42,1121771,400257,501515,219999,1121771
2023-04-28 02:43,1121788,400274,501515,219999,1121788
2023-04-28 02:44,1121804,400289,501516,219999,1121804
2023-04-28 02:45,1121820,400302,501517,220001,1121820
2023-04-28 02:46,1121837,400318,501517,220002,1121837
2023-04-28 02:47,1121853,400332,501517,220004,1121853
2023-04-28 02:48,1121868,400346,501517,220005,1121868
2023-04-28 02:49,1121885,400363,501517,220005,1121885
2023-04-28 02:50,1121901,400379,501517,220005,1121901
2023-04-28 02:51,1121918,400396,501517,220005,1121918
2023-04-28 02:52,1121934,400412,501517,220005,1121934
2023-04-28 02:53,1121951,400428,501517,220006,1121951
2023-04-28 02:55,1121967,400444,501517,220006,1121967
2023-04-28 02:56,1121983,400460,501517,220006,1121983
2023-04-28 02:57,1122000,400476,501517,220007,1122000
2023-04-28 02:58,1122015,400491,501517,220007,1122015
2023-04-28 02:59,1122032,400507,501517,220008,1122032
2023-04-28 03:00,1122051,400525,501517,220009,1122051
2023-04-28 03:01,1122086,400560,501517,220009,1122086
2023-04-28 03:02,1122121,400595,501517,220009,1122121
2023-04-28 03:03,1122155,400629,501517,220009,1122155
2023-04-28 03:04,1122193,400666,501517,220010,1122193
2023-04-28 03:05,1122227,400699,501517,220011,1122227
2023-04-28 03:06,1122263,400735,501517,220011,1122263
2023-04-28 03:07,1122297,400769,501517,220011,1122297
2023-04-28 03:08,1122334,400803,501520,220011,1122334
2023-04-28 03:09,1122369,400838,501520,220011,1122369
2023-04-28 03:10,1122404,400873,501520,220011,1122404
2023-04-28 03:11,1122441,400909,501520,220012,1122441
2023-04-28 03:12,1122476,400944,501520,220012,1122476
2023-04-28 03:13,1122512,400979,501520,220013,1122512
2023-04-28 03:14,1122547,401014,501520,220013,1122547
2023-04-28 03:15,1122581,401048,501520,220013,1122581
2023-04-28 03:16,1122619,401086,501520,220013,1122619
2023-04-28 03:17,1122653,401119,501520,220014,1122653
2023-04-28 03:18,1122689,401153,501522,220014,1122689
2023-04-28 03:19,1122724,401188,501522,220014,1122724
2023-04-28 03:20,1122759,401222,501522,220015,1122759
2023-04-28 03:21,1122795,401258,501522,220015,1122795
2023-04-28 03:22,1122831,401294,501522,220015,1122831
2023-04-28 03:23,1122867,401330,501522,220015,1122867
2023-04-28 03:24,1122900,401363,501522,220015,1122900
2023-04-28 03:25,1122937,401400,501522,220015,1122937
2023-04-28 03:26,1122972,401435,501522,220015,1122972
2023-04-28 03:27,1123009,401472,501522,220015,1123009
2023-04-28 03:28,1123043,401507,501521,220015,1123043
2023-04-28 03:29,1123078,401541,501521,220016,1123078
2023-04-28 03:30,1123113,401576,501521,220016,1123113
2023-04-28 03:31,1123152,401615,501521,220016,1123152
2023-04-28 03:32,1123186,401649,501521,220016,1123186
2023-04-28 03:33,1123223,401686,501521,220016,1123223
2023-04-28 03:34,1123258,401721,501521,220016,1123258
2023-04-28 03:35,1123292,401755,501521,220016,1123292
2023-04-28 03:36,1123329,401792,501521,220016,1123329
2023-04-28 03:37,1123365,401827,501521,220017,1123365
2023-04-28 03:38,1123398,401857,501523,220018,1123398
2023-04-28 03:39,1123434,401892,501523,220019,1123434
2023-04-28 03:41,1123469,401927,501523,220019,1123469
2023-04-28 03:42,1123506,401964,501523,220019,1123506
2023-04-28 03:43,1123540,401996,501523,220021,1123540
2023-04-28 03:44,1123575,402031,501523,220021,1123575
2023-04-28 03:45,1123612,402068,501523,220021,1123612
2023-04-28 03:46,1123649,402105,501523,220021,1123649
2023-04-28 03:47,1123684,402140,501523,220021,1123684
2023-04-28 03:48,1123720,402175,501523,220022,1123720
2023-04-28 03:49,1123754,402209,501523,220022,1123754
2023-04-28 03:50,1123789,402244,501523,220022,1123789
2023-04-28 03:51,1123824,402279,501523,220022,1123824
2023-04-28 03:52,1123862,402317,501523,220022,1123862
2023-04-28 03:53,1123897,402351,501523,220023,1123897
2023-04-28 03:54,1123932,402386,501523,220023,1123932
2023-04-28 03:55,1123967,402420,501523,220024,1123967
2023-04-28 03:56,1124001,402453,501523,220025,1124001
2023-04-28 03:57,1124036,402487,501523,220026,1124036
2023-04-28 03:58,1124074,402525,501523,220026,1124074
2023-04-28 03:59,1124108,402557,501525,220026,1124108
2023-04-28 04:00,1124142,402591,501525,220026,1124142
2023-04-28 04:01,1124172,402621,501525,220026,1124172
2023-04-28 04:02,1124200,402648,501525,220027,1124200
2023-04-28 04:03,1124228,402676,501525,220027,1124228
2023-04-28 04:04,1124257,402705,501525,220027,1124257
2023-04-28 04:05,1124287,402735,501525,220027,1124287
2023-04-28 04:06,1124315,402763,501525,220027,1124315
2023-04-28 04:07,1124346,402794,501525,220027,1124346
2023-04-28 04:08,1124373,402819,501527,220027,1124373
2023-04-28 04:09,1124402,402848,501527,220027,1124402
2023-04-28 04:10,1124433,402879,501527,220027,1124433
2023-04-28 04:11,1124461,402905,501527,220029,1124461
2023-04-28 04:12,1124490,402934,501527,220029,1124490
2023-04-28 04:13,1124519,402963,501527,220029,1124519
2023-04-28 04:14,1124548,402992,501527,220029,1124548
2023-04-28 04:15,1124579,403023,501527,220029,1124579
2023-04-28 04:16,1124607,403051,501527,220029,1124607
2023-04-28 04:17,1124636,403080,501527,220029,1124636
2023-04-28 04:18,1124666,403109,501528,220029,1124666
2023-04-28 04:19,1124696,403139,501528,220029,1124696
2023-04-28 04:20,1124724,403167,501528,220029,1124724
2023-04-28 04:21,1124752,403195,501528,220029,1124752
2023-04-28 04:22,1124783,403224,501529,220030,1124783
2023-04-28 04:23,1124811,403251,501529,220031,1124811
2023-04-28 04:24,1124842,403281,501529,220032,1124842
2023-04-28 04:25,1124870,403309,501529,220032,1124870
2023-04-28 04:26,1124898,403337,501529,220032,1124898
2023-04-28 04:28,1124929,403368,501529,220032,1124929
2023-04-28 04:29,1124957,403396,501529,220032,1124957
2023-04-28 04:30,1124985,403424,501529,220032,1124985
2023-04-28 04:31,1125014,403453,501529,220032,1125014
2023-04-28 04:32,1125045,403484,501529,220032,1125045
2023-04-28 04:33,1125072,403511,501529,220032,1125072
2023-04-28 04:34,1125101,403540,501529,220032,1125101
2023-04-28 04:35,1125131,403570,501529,220032,1125131
2023-04-28 04:36,1125159,403598,501529,220032,1125159
2023-04-28 04:37,1125188,403625,501530,220033,1125188
2023-04-28 04:38,1125219,403656,501530,220033,1125219
2023-04-28 04:39,1125248,403685,501530,220033,1125248
2023-04-28 04:40,1125277,403713,501530,220034,1125277
2023-04-28 04:41,1125307,403742,501530,220035,1125307
2023-04-28 04:42,1125335,403770,501530,220035,1125335
2023-04-28 04:43,1125363,403798,501530,220035,1125363
2023-04-28 04:44,1125393,403828,501530,220035,1125393
2023-04-28 04:45,1125423,403858,501530,220035,1125423
2023-04-28 04:46,1125452,403887,501530,220035,1125452
2023-04-28 04:47,1125479,403914,501530,220035,1125479
2023-04-28 04:48,1125509,403944,501530,220035,1125509
2023-04-28 04:49,1125538,403973,501530,220035,1125538
2023-04-28 04:50,1125567,404002,501530,220035,1125567
2023-04-28 04:51,1125597,404033,501529,220035,1125597
2023-04-28 04:52,1125626,404062,501529,220035,1125626
2023-04-28 04:53,1125655,404091,501529,220035,1125655
2023-04-28 04:54,1125683,404118,501529,220036,1125683
2023-04-28 04:55,1125713,404147,501530,220036,1125713
2023-04-28 04:56,1125740,404174,501530,220036,1125740
2023-04-28 04:57,1125770,404204,501530,220036,1125770
2023-04-28 04:58,1125801,404235,501530,220036,1125801
2023-04-28 04:59,1125828,404260,501531,220037,1125828
2023-04-28 05:00,1125848,404280,501531,220037,1125848
2023-04-28 05:01,1125861,404293,501531,220037,1125861
2023-04-28 05:02,1125875,404307,501531,220037,1125875
2023-04-28 05:03,1125888,404320,501531,220037,1125888
2023-04-28 05:04,1125903,404335,501531,220037,1125903
2023-04-28 05:05,1125916,404348,501531,220037,1125916
2023-04-28 05:06,1125929,404361,501531,220037,1125929
2023-04-28 05:07,1125944,404376,501531,220037,1125944
2023-04-28 05:08,1125957,404389,501531,220037,1125957
2023-04-28 05:09,1125971,404403,501531,220037,1125971
2023-04-28 05:10,1125985,404416,501531,220038,1125985
2023-04-28 05:11,1125999,404430,501531,220038,1125999
2023-04-28 05:12,1126012,404441,501531,220040,1126012
2023-04-28 05:14,1126026,404455,501531,220040,1126026
2023-04-28 05:15,1126040,404469,501531,220040,1126040
2023-04-28 05:16,1126053,404482,501531,220040,1126053
2023-04-28 05:17,1126067,404497,501531,220039,1126067
2023-04-28 05:18,1126081,404510,501532,220039,1126081
2023-04-28 05:19,1126094,404523,501532,220039,1126094
2023-04-28 05:20,1126108,404535,501532,220041,1126108
2023-04-28 05:21,1126122,404549,501532,220041,1126122
2023-04-28 05:22,1126135,404562,501532,220041,1126135
2023-04-28 05:23,1126149,404575,501532,220042,1126149
2023-04-28 05:24,1126162,404588,501532,220042,1126162
2023-04-28 05:25,1126177,404603,501532,220042,1126177
2023-04-28 05:26,1126191,404617,501532,220042,1126191
2023-04-28 05:27,1126204,404630,501532,220042,1126204
2023-04-28 05:28,1126218,404644,501532,220042,1126218
2023-04-28 05:29,1126231,404657,501532,220042,1126231
2023-04-28 05:30,1126245,404671,501532,220042,1126245
2023-04-28 05:31,1126258,404684,501532,220042,1126258
2023-04-28 05:32,1126272,404695,501534,220043,1126272
2023-04-28 05:33,1126287,404710,501534,220043,1126287
2023-04-28 05:34,1126300,404722,501535,220043,1126300
2023-04-28 05:35,1126314,404736,501535,220043,1126314
2023-04-28 05:36,1126327,404748,501535,220044,1126327
2023-04-28 05:37,1126341,404762,501535,220044,1126341
2023-04-28 05:38,1126355,404775,501535,220045,1126355
2023-04-28 05:39,1126368,404787,501535,220046,1126368
2023-04-28 05:40,1126383,404801,501536,220046,1126383
2023-04-28 05:41,1126396,404814,501536,220046,1126396
2023-04-28 05:42,1126410,404827,501537,220046,1126410
2023-04-28 05:43,1126423,404840,501537,220046,1126423
2023-04-28 05:44,1126437,404854,501537,220046,1126437
2023-04-28 05:45,1126451,404868,501537,220046,1126451
2023-04-28 05:46,1126464,404881,501537,220046,1126464
2023-04-28 05:47,1126478,404895,501537,220046,1126478
2023-04-28 05:48,1126492,404908,501538,220046,1126492
2023-04-28 05:49,1126505,404921,501538,220046,1126505
2023-04-28 05:50,1126519,404935,501538,220046,1126519
2023-04-28 05:51,1126533,404948,501538,220047,1126533
2023-04-28 05:52,1126547,404962,501538,220047,1126547
2023-04-28 05:53,1126560,404975,501538,220047,1126560
2023-04-28 05:54,1126574,404989,501538,220047,1126574
2023-04-28 05:55,1126588,405003,501538,220047,1126588
2023-04-28 05:56,1126602,405016,501538,220048,1126602
2023-04-28 05:57,1126616,405030,501538,220048,1126616
2023-04-28 05:58,1126629,405043,501538,220048,1126629
2023-04-28 06:00,1126643,405055,501538,220050,1126643
2023-04-28 06:01,1126660,405072,501538,220050,1126660
2023-04-28 06:02,1126677,405089,501538,220050,1126677
2023-04-28 06:03,1126694,405105,501539,220050,1126694
2023-04-28 06:04,1126712,405122,501539,220051,1126712
2023-04-28 06:05,1126729,405138,501539,220052,1126729
2023-04-28 06:06,1126747,405156,501539,220052,1126747
2023-04-28 06:07,1126764,405172,501540,220052,1126764
2023-04-28 06:08,1126781,405189,501540,220052,1126781
2023-04-28 06:09,1126799,405208,501539,220052,1126799
2023-04-28 06:10,1126817,405224,501539,220054,1126817
2023-04-28 06:11,1126834,405241,501539,220054,1126834
2023-04-28 06:12,1126851,405257,501539,220055,1126851
2023-04-28 06:13,1126868,405272,501541,220055,1126868
2023-04-28 06:14,1126886,405289,501541,220056,1126886
2023-04-28 06:15,1126904,405306,501542,220056,1126904
2023-04-28 06:16,1126921,405323,501542,220056,1126921
2023-04-28 06:17,1126938,405340,501542,220056,1126938
2023-04-28 06:18,1126955,405356,501542,220057,1126955
2023-04-28 06:19,1126972,405372,501543,220057,1126972
2023-04-28 06:20,1126989,405387,501545,220057,1126989
2023-04-28 06:21,1127007,405405,501545,220057,1127007
2023-04-28 06:22,1127025,405423,501545,220057,1127025
2023-04-28 06:23,1127042,405438,501545,220059,1127042
2023-04-28 06:24,1127059,405455,501545,220059,1127059
2023-04-28 06:25,1127077,405472,501545,220060,1127077
2023-04-28 06:26,1127093,405487,501546,220060,1127093
2023-04-28 06:27,1127112,405506,501546,220060,1127112
2023-04-28 06:28,1127128,405522,501546,220060,1127128
2023-04-28 06:29,1127146,405540,501546,220060,1127146
2023-04-28 06:30,1127163,405557,501546,220060,1127163
2023-04-28 06:31,1127180,405574,501546,220060,1127180
2023-04-28 06:32,1127198,405590,501548,220060,1127198
2023-04-28 06:33,1127215,405607,501548,220060,1127215
2023-04-28 06:34,1127232,405624,501548,220060,1127232
2023-04-28 06:35,1127249,405641,501548,220060,1127249
2023-04-28 06:36,1127266,405658,501548,220060,1127266
2023-04-28 06:37,1127284,405676,501548,220060,1127284
2023-04-28 06:38,1127301,405693,501548,220060,1127301
2023-04-28 06:39,1127319,405711,501548,220060,1127319
2023-04-28 06:40,1127336,405727,501549,220060,1127336
2023-04-28 06:41,1127353,405744,501549,220060,1127353
2023-04-28 06:42,1127371,405762,501549,220060,1127371
2023-04-28 06:43,1127388,405775,501549,220064,1127388
2023-04-28 06:44,1127405,405791,501550,220064,1127405
2023-04-28 06:46,1127422,405806,501550,220066,1127422
2023-04-28 06:47,1127439,405823,501550,220066,1127439
2023-04-28 06:48,1127457,405841,501550,220066,1127457
2023-04-28 06:49,1127475,405858,501550,220067,1127475
2023-04-28 06:50,1127493,405876,501550,220067,1127493
2023-04-28 06:51,1127510,405892,501550,220068,1127510
2023-04-28 06:52,1127528,405909,501550,220069,1127528
2023-04-28 06:53,1127545,405925,501551,220069,1127545
2023-04-28 06:54,1127562,405942,501551,220069,1127562
2023-04-28 06:55,1127580,405960,501551,220069,1127580
2023-04-28 06:56,1127596,405976,501551,220069,1127596
2023-04-28 06:57,1127614,405995,501550,220069,1127614
2023-04-28 06:58,1127631,406012,501550,220069,1127631
2023-04-28 06:59,1127649,406028,501550,220071,1127649
2023-04-28 07:00,1127670,406049,501550,220071,1127670
2023-04-28 07:01,1127706,406083,501552,220071,1127706
2023-04-28 07:02,1127738,406114,501552,220072,1127738
2023-04-28 07:03,1127773,406146,501552,220075,1127773
2023-04-28 07:04,1127807,406180,501552,220075,1127807
2023-04-28 07:05,1127842,406215,501552,220075,1127842
2023-04-28 07:06,1127877,406250,501552,220075,1127877
2023-04-28 07:07,1127911,406283,501552,220076,1127911
2023-04-28 07:08,1127945,406317,501552,220076,1127945
2023-04-28 07:09,1127978,406348,501553,220077,1127978
2023-04-28 07:10,1128011,406380,501553,220078,1128011
2023-04-28 07:11,1128047,406414,501553,220080,1128047
2023-04-28 07:12,1128082,406448,501553,220081,1128082
2023-04-28 07:13,1128115,406480,501554,220081,1128115
2023-04-28 07:14,1128150,406515,501554,220081,1128150
2023-04-28 07:15,1128182,406544,501556,220082,1128182
2023-04-28 07:16,1128218,406580,501556,220082,1128218
2023-04-28 07:17,1128251,406613,501556,220082,1128251
2023-04-28 07:18,1128284,406646,501556,220082,1128284
2023-04-28 07:19,1128320,406681,501557,220082,1128320
2023-04-28 07:20,1128353,406713,501557,220083,1128353
2023-04-28 07:21,1128388,406747,501558,220083,1128388
2023-04-28 07:22,1128424,406783,501558,220083,1128424
2023-04-28 07:23,1128459,406817,501559,220083,1128459
2023-04-28 07:24,1128493,406850,501559,220084,1128493
2023-04-28 07:25,1128527,406884,501559,220084,1128527
2023-04-28 07:26,1128561,406918,501559,220084,1128561
2023-04-28 07:27,1128596,406952,501559,220085,1128596
2023-04-28 07:28,1128630,406984,501560,220086,1128630
2023-04-28 07:29,1128663,407016,501560,220087,1128663
2023-04-28 07:30,1128698,407047,501563,220088,1128698
2023-04-28 07:31,1128732,407080,501563,220089,1128732
2023-04-28 07:33,1128765,407111,501565,220089,1128765
2023-04-28 07:34,1128801,407147,501565,220089,1128801
2023-04-28 07:35,1128834,407180,501565,220089,1128834
2023-04-28 07:36,1128869,407214,501565,220090,1128869
2023-04-28 07:37,1128904,407249,501565,220090,1128904
2023-04-28 07:38,1128940,407285,501565,220090,1128940
2023-04-28 07:39,1128974,407317,501567,220090,1128974
2023-04-28 07:40,1129007,407350,501567,220090,1129007
2023-04-28 07:41,1129042,407381,501569,220092,1129042
2023-04-28 07:42,1129074,407413,501569,220092,1129074
2023-04-28 07:43,1129109,407445,501572,220092,1129109
2023-04-28 07:44,1129144,407480,501572,220092,1129144
2023-04-28 07:45,1129177,407513,501572,220092,1129177
2023-04-28 07:46,1129213,407549,501572,220092,1129213
2023-04-28 07:47,1129247,407583,501572,220092,1129247
2023-04-28 07:48,1129283,407618,501572,220093,1129283
2023-04-28 07:49,1129317,407652,501572,220093,1129317
2023-04-28 07:50,1129352,407686,501572,220094,1129352
2023-04-28 07:51,1129387,407720,501573,220094,1129387
2023-04-28 07:52,1129420,407752,501573,220095,1129420
2023-04-28 07:53,1129455,407786,501574,220095,1129455
2023-04-28 07:54,1129488,407816,501574,220098,1129488
2023-04-28 07:55,1129524,407850,501573,220101,1129524
2023-04-28 07:56,1129558,407883,501573,220102,1129558
2023-04-28 07:57,1129591,407915,501573,220103,1129591
2023-04-28 07:58,1129624,407948,501573,220103,1129624
2023-04-28 07:59,1129661,407983,501575,220103,1129661
2023-04-28 08:00,1129689,408011,501575,220103,1129689
2023-04-28 08:01,1129712,408034,501575,220103,1129712
2023-04-28 08:02,1129735,408057,501575,220103,1129735
2023-04-28 08:03,1129760,408079,501576,220105,1129760
2023-04-28 08:04,1129783,408102,501576,220105,1129783
2023-04-28 08:05,1129807,408124,501578,220105,1129807
2023-04-28 08:06,1129830,408147,501578,220105,1129830
2023-04-28 08:07,1129854,408171,501578,220105,1129854
2023-04-28 08:08,1129877,408194,501578,220105,1129877
2023-04-28 08:09,1129901,408217,501578,220106,1129901
2023-04-28 08:10,1129925,408241,501578,220106,1129925
2023-04-28 08:11,1129949,408265,501578,220106,1129949
2023-04-28 08:12,1129972,408288,501578,220106,1129972
2023-04-28 08:13,1129996,408311,501579,220106,1129996
2023-04-28 08:14,1130021,408336,501579,220106,1130021
2023-04-28 08:15,1130046,408360,501580,220106,1130046
2023-04-28 08:16,1130069,408383,501580,220106,1130069
2023-04-28 08:17,1130091,408403,501582,220106,1130091
2023-04-28 08:18,1130115,408427,501582,220106,1130115
2023-04-28 08:20,1130140,408453,501581,220106,1130140
2023-04-28 08:21,1130165,408478,501581,220106,1130165
2023-04-28 08:22,1130188,408498,501582,220108,1130188
2023-04-28 08:23,1130212,408521,501582,220109,1130212
2023-04-28 08:24,1130235,408542,501583,220110,1130235
2023-04-28 08:25,1130259,408566,501583,220110,1130259
2023-04-28 08:26,1130283,408586,501586,220111,1130283
2023-04-28 08:27,1130306,408607,501586,220113,1130306
2023-04-28 08:28,1130330,408630,501587,220113,1130330
2023-04-28 08:29,1130353,408652,501587,220114,1130353
2023-04-28 08:30,1130378,408676,501588,220114,1130378
2023-04-28 08:31,1130401,408697,501588,220116,1130401
2023-04-28 08:32,1130425,408714,501591,220120,1130425
2023-04-28 08:33,1130450,408739,501591,220120,1130450
2023-04-28 08:34,1130474,408762,501592,220120,1130474
2023-04-28 08:35,1130498,408786,501592,220120,1130498
2023-04-28 08:36,1130521,408807,501594,220120,1130521
2023-04-28 08:37,1130545,408829,501594,220122,1130545
2023-04-28 08:38,1130569,408850,501594,220125,1130569
2023-04-28 08:39,1130594,408873,501594,220127,1130594
2023-04-28 08:40,1130618,408892,501595,220131,1130618
2023-04-28 08:41,1130640,408914,501595,220131,1130640
2023-04-28 08:42,1130663,408935,501595,220133,1130663
2023-04-28 08:43,1130687,408959,501595,220133,1130687
2023-04-28 08:44,1130713,408983,501596,220134,1130713
2023-04-28 08:45,1130736,409005,501596,220135,1130736
2023-04-28 08:46,1130759,409026,501597,220136,1130759
2023-04-28 08:47,1130783,409049,501597,220137,1130783
2023-04-28 08:48,1130809,409073,501597,220139,1130809
2023-04-28 08:49,1130831,409095,501597,220139,1130831
2023-04-28 08:50,1130855,409115,501600,220140,1130855
2023-04-28 08:51,1130880,409140,501600,220140,1130880
2023-04-28 08:52,1130902,409161,501600,220141,1130902
2023-04-28 08:53,1130928,409187,501600,220141,1130928
2023-04-28 08:54,1130952,409211,501600,220141,1130952
2023-04-28 08:55,1130975,409231,501600,220144,1130975
2023-04-28 08:56,1130999,409250,501605,220144,1130999
2023-04-28 08:57,1131023,409271,501605,220147,1131023
2023-04-28 08:58,1131049,409293,501607,220149,1131049
2023-04-28 08:59,1131073,409315,501607,220151,1131073
2023-04-28 09:00,1131094,409334,501607,220153,1131094
2023-04-28 09:01,1131117,409357,501607,220153,1131117
2023-04-28 09:02,1131139,409377,501609,220153,1131139
2023-04-28 09:03,1131159,409396,501609,220154,1131159
2023-04-28 09:04,1131182,409417,501611,220154,1131182
2023-04-28 09:05,1131205,409438,501611,220156,1131205
2023-04-28 09:06,1131227,409459,501612,220156,1131227
2023-04-28 09:08,1131248,409480,501612,220156,1131248
2023-04-28 09:09,1131270,409501,501613,220156,1131270
2023-04-28 09:10,1131293,409524,501613,220156,1131293
2023-04-28 09:11,1131313,409542,501615,220156,1131313
2023-04-28 09:12,1131338,409567,501615,220156,1131338
2023-04-28 09:13,1131360,409586,501616,220158,1131360
2023-04-28 09:14,1131383,409608,501616,220159,1131383
2023-04-28 09:15,1131405,409629,501617,220159,1131405
2023-04-28 09:16,1131427,409649,501617,220161,1131427
2023-04-28 09:17,1131449,409669,501618,220162,1131449
2023-04-28 09:18,1131470,409690,501618,220162,1131470
2023-04-28 09:19,1131492,409712,501618,220162,1131492
2023-04-28 09:20,1131514,409734,501618,220162,1131514
2023-04-28 09:21,1131536,409754,501619,220163,1131536
2023-04-28 09:22,1131560,409778,501619,220163,1131560
2023-04-28 09:23,1131581,409799,501619,220163,1131581
2023-04-28 09:24,1131604,409821,501619,220164,1131604
2023-04-28 09:25,1131626,409842,501620,220164,1131626
2023-04-28 09:26,1131650,409865,501620,220165,1131650
2023-04-28 09:27,1131671,409884,501621,220166,1131671
2023-04-28 09:28,1131692,409903,501622,220167,1131692
2023-04-28 09:29,1131715,409926,501622,220167,1131715
2023-04-28 09:30,1131736,409944,501622,220170,1131736
2023-04-28 09:31,1131759,409967,501622,220170,1131759
2023-04-28 09:32,1131780,409987,501622,220171,1131780
2023-04-28 09:33,1131802,410008,501622,220172,1131802
2023-04-28 09:34,1131825,410030,501623,220172,1131825
2023-04-28 09:35,1131847,410052,501623,220172,1131847
2023-04-28 09:36,1131868,410071,501624,220173,1131868
2023-04-28 09:37,1131890,410092,501624,220174,1131890
2023-04-28 09:38,1131911,410112,501625,220174,1131911
2023-04-28 09:39,1131934,410134,501625,220175,1131934
2023-04-28 09:40,1131956,410155,501625,220176,1131956
2023-04-28 09:41,1131976,410174,501625,220177,1131976
2023-04-28 09:42,1132000,410198,501625,220177,1132000
2023-04-28 09:43,1132021,410218,501625,220178,1132021
2023-04-28 09:44,1132044,410238,501627,220179,1132044
2023-04-28 09:45,1132066,410260,501627,220179,1132066
2023-04-28 09:46,1132087,410280,501628,220179,1132087
2023-04-28 09:47,1132109,410301,501628,220180,1132109
2023-04-28 09:48,1132132,410323,501630,220179,1132132
2023-04-28 09:49,1132152,410343,501630,220179,1132152
2023-04-28 09:50,1132176,410364,501633,220179,1132176
2023-04-28 09:51,1132198,410385,501633,220180,1132198
2023-04-28 09:52,1132219,410404,501635,220180,1132219
2023-04-28 09:53,1132240,410424,501635,220181,1132240
2023-04-28 09:55,1132263,410442,501637,220184,1132263
2023-04-28 09:56,1132284,410462,501637,220185,1132284
2023-04-28 09:57,1132306,410482,501638,220186,1132306
2023-04-28 09:58,1132329,410504,501639,220186,1132329
2023-04-28 09:59,1132350,410525,501639,220186,1132350
2023-04-28 10:00,1132372,410545,501641,220186,1132372
2023-04-28 10:01,1132392,410564,501641,220187,1132392
2023-04-28 10:02,1132411,410581,501642,220188,1132411
2023-04-28 10:03,1132430,410598,501642,220190,1132430
2023-04-28 10:04,1132449,410612,501646,220191,1132449
2023-04-28 10:05,1132470,410633,501646,220191,1132470
2023-04-28 10:06,1132488,410650,501647,220191,1132488
2023-04-28 10:07,1132508,410668,501648,220192,1132508
2023-04-28 10:08,1132527,410684,501650,220193,1132527
2023-04-28 10:09,1132547,410704,501650,220193,1132547
2023-04-28 10:10,1132566,410720,501652,220194,1132566
2023-04-28 10:11,1132586,410739,501652,220195,1132586
2023-04-28 10:12,1132607,410758,501654,220195,1132607
2023-04-28 10:13,1132625,410775,501654,220196,1132625
2023-04-28 10:14,1132646,410795,501654,220197,1132646
2023-04-28 10:15,1132665,410813,501654,220198,1132665
2023-04-28 10:16,1132685,410831,501654,220200,1132685
2023-04-28 10:17,1132704,410849,501654,220201,1132704
2023-04-28 10:18,1132724,410868,501654,220202,1132724
2023-04-28 10:19,1132743,410886,501654,220203,1132743
2023-04-28 10:20,1132762,410904,501654,220204,1132762
2023-04-28 10:21,1132783,410924,501654,220205,1132783
2023-04-28 10:22,1132802,410934,501663,220205,1132802
2023-04-28 10:23,1132822,410953,501663,220206,1132822
2023-04-28 10:24,1132842,410973,501663,220206,1132842
2023-04-28 10:25,1132861,410990,501663,220208,1132861
2023-04-28 10:26,1132881,411010,501663,220208,1132881
2023-04-28 10:27,1132900,411027,501663,220210,1132900
2023-04-28 10:28,1132920,411046,501663,220211,1132920
2023-04-28 10:29,1132940,411063,501663,220214,1132940
2023-04-28 10:30,1132960,411073,501673,220214,1132960
2023-04-28 10:31,1132980,411092,501673,220215,1132980
2023-04-28 10:32,1132999,411107,501674,220218,1132999
2023-04-28 10:33,1133018,411125,501674,220219,1133018
2023-04-28 10:34,1133039,411141,501678,220220,1133039
2023-04-28 10:35,1133059,411161,501678,220220,1133059
2023-04-28 10:36,1133078,411178,501680,220220,1133078
2023-04-28 10:37,1133098,411197,501680,220221,1133098
2023-04-28 10:38,1133118,411216,501680,220222,1133118
2023-04-28 10:39,1133136,411234,501680,220222,1133136
2023-04-28 10:40,1133157,411251,501683,220223,1133157
2023-04-28 10:42,1133176,411269,501683,220224,1133176
2023-04-28 10:43,1133195,411285,501686,220224,1133195
2023-04-28 10:44,1133216,411305,501686,220225,1133216
2023-04-28 10:45,1133235,411321,501688,220226,1133235
2023-04-28 10:46,1133255,411340,501688,220227,1133255
2023-04-28 10:47,1133275,411358,501690,220227,1133275
2023-04-28 10:48,1133294,411374,501690,220230,1133294
2023-04-28 10:49,1133314,411393,501690,220231,1133314
2023-04-28 10:50,1133334,411411,501690,220233,1133334
2023-04-28 10:51,1133354,411426,501694,220234,1133354
2023-04-28 10:52,1133374,411446,501694,220234,1133374
2023-04-28 10:53,1133394,411465,501695,220234,1133394
2023-04-28 10:54,1133412,411481,501697,220234,1133412
2023-04-28 10:55,1133433,411501,501697,220235,1133433
2023-04-28 10:56,1133452,411518,501698,220236,1133452
2023-04-28 10:57,1133471,411537,501698,220236,1133471
2023-04-28 10:58,1133493,411559,501698,220236,1133493
2023-04-28 10:59,1133512,411577,501698,220237,1133512
2023-04-28 11:00,1133528,411591,501699,220238,1133528
2023-04-28 11:01,1133539,411600,501699,220240,1133539
2023-04-28 11:02,1133550,411609,501701,220240,1133550
2023-04-28 11:03,1133560,411618,501701,220241,1133560
2023-04-28 11:04,1133571,411626,501702,220243,1133571
2023-04-28 11:05,1133583,411634,501702,220247,1133583
2023-04-28 11:06,1133594,411637,501707,220250,1133594
2023-04-28 11:07,1133605,411648,501707,220250,1133605
2023-04-28 11:08,1133615,411656,501708,220251,1133615
2023-04-28 11:09,1133627,411667,501708,220252,1133627
2023-04-28 11:10,1133637,411676,501709,220252,1133637
2023-04-28 11:11,1133648,411683,501709,220256,1133648
2023-04-28 11:12,1133659,411693,501710,220256,1133659
2023-04-28 11:13,1133671,411704,501710,220257,1133671
2023-04-28 11:14,1133681,411711,501712,220258,1133681
2023-04-28 11:15,1133692,411722,501712,220258,1133692
2023-04-28 11:16,1133703,411729,501712,220262,1133703
2023-04-28 11:17,1133715,411740,501712,220263,1133715
2023-04-28 11:18,1133726,411750,501713,220263,1133726
2023-04-28 11:19,1133737,411760,501713,220264,1133737
2023-04-28 11:20,1133748,411769,501715,220264,1133748
2023-04-28 11:21,1133758,411776,501717,220265,1133758
2023-04-28 11:22,1133769,411786,501717,220266,1133769
2023-04-28 11:23,1133780,411795,501718,220267,1133780
2023-04-28 11:24,1133791,411804,501719,220268,1133791
2023-04-28 11:25,1133802,411815,501719,220268,1133802
2023-04-28 11:26,1133813,411824,501720,220269,1133813
2023-04-28 11:27,1133824,411835,501720,220269,1133824
2023-04-28 11:29,1133835,411842,501721,220272,1133835
2023-04-28 11:30,1133847,411852,501721,220274,1133847
2023-04-28 11:31,1133858,411862,501721,220275,1133858
2023-04-28 11:32,1133868,411872,501721,220275,1133868
2023-04-28 11:33,1133879,411880,501724,220275,1133879
2023-04-28 11:34,1133891,411892,501724,220275,1133891
2023-04-28 11:35,1133902,411902,501725,220275,1133902
2023-04-28 11:36,1133913,411912,501725,220276,1133913
2023-04-28 11:37,1133923,411919,501726,220278,1133923
2023-04-28 11:38,1133934,411928,501726,220280,1133934
2023-04-28 11:39,1133945,411938,501727,220280,1133945
2023-04-28 11:40,1133956,411947,501727,220282,1133956
2023-04-28 11:41,1133966,411953,501730,220283,1133966
2023-04-28 11:42,1133978,411963,501730,220285,1133978
2023-04-28 11:43,1133989,411974,501731,220284,1133989
2023-04-28 11:44,1134001,411985,501731,220285,1134001
2023-04-28 11:45,1134012,411995,501732,220285,1134012
2023-04-28 11:46,1134023,412006,501732,220285,1134023
2023-04-28 11:47,1134034,412014,501733,220287,1134034
2023-04-28 11:48,1134045,412022,501733,220290,1134045
2023-04-28 11:49,1134055,412032,501733,220290,1134055
2023-04-28 11:50,1134067,412044,501733,220290,1134067
2023-04-28 11:51,1134078,412052,501735,220291,1134078
2023-04-28 11:52,1134090,412062,501735,220293,1134090
2023-04-28 11:53,1134101,412070,501737,220294,1134101
2023-04-28 11:54,1134111,412078,501737,220296,1134111
2023-04-28 11:55,1134122,412087,501738,220297,1134122
2023-04-28 11:56,1134133,412096,501738,220299,1134133
2023-04-28 11:57,1134144,412104,501741,220299,1134144
2023-04-28 11:58,1134154,412113,501741,220300,1134154
2023-04-28 11:59,1134166,412120,501744,220302,1134166
2023-04-28 12:00,1134182,412136,501744,220302,1134182
2023-04-28 12:01,1134201,412154,501745,220302,1134201
2023-04-28 12:02,1134222,412174,501745,220303,1134222
2023-04-28 12:03,1134242,412187,501749,220306,1134242
2023-04-28 12:04,1134263,412207,501749,220307,1134263
2023-04-28 12:05,1134284,412223,501753,220308,1134284
2023-04-28 12:06,1134304,412239,501756,220309,1134304
2023-04-28 12:07,1134322,412257,501756,220309,1134322
2023-04-28 12:08,1134343,412273,501758,220312,1134343
2023-04-28 12:09,1134363,412291,501758,220314,1134363
2023-04-28 12:10,1134384,412311,501759,220314,1134384
2023-04-28 12:11,1134403,412329,501759,220315,1134403
2023-04-28 12:12,1134422,412346,501760,220316,1134422
2023-04-28 12:13,1134442,412366,501760,220316,1134442
2023-04-28 12:14,1134461,412381,501763,220317,1134461
2023-04-28 12:16,1134482,412401,501763,220318,1134482
2023-04-28 12:17,1134502,412419,501765,220318,1134502
2023-04-28 12:18,1134523,412438,501765,220320,1134523
2023-04-28 12:19,1134543,412456,501765,220322,1134543
2023-04-28 12:20,1134562,412473,501765,220324,1134562
2023-04-28 12:21,1134581,412488,501766,220327,1134581
2023-04-28 12:22,1134601,412508,501766,220327,1134601
2023-04-28 12:23,1134622,412527,501767,220328,1134622
2023-04-28 12:24,1134641,412545,501767,220329,1134641
2023-04-28 12:25,1134661,412563,501767,220331,1134661
2023-04-28 12:26,1134680,412581,501767,220332,1134680
2023-04-28 12:27,1134699,412593,501772,220334,1134699
2023-04-28 12:28,1134719,412613,501772,220334,1134719
2023-04-28 12:29,1134740,412632,501773,220335,1134740
2023-04-28 12:30,1134760,412649,501775,220336,1134760
2023-04-28 12:31,1134779,412665,501775,220339,1134779
2023-04-28 12:32,1134799,412681,501776,220342,1134799
2023-04-28 12:33,1134819,412699,501776,220344,1134819
2023-04-28 12:34,1134838,412718,501775,220345,1134838
2023-04-28 12:35,1134858,412734,501777,220347,1134858
2023-04-28 12:36,1134878,412754,501777,220347,1134878
2023-04-28 12:37,1134897,412770,501780,220347,1134897
2023-04-28 12:38,1134917,412790,501780,220347,1134917
2023-04-28 12:39,1134938,412810,501780,220348,1134938
2023-04-28 12:40,1134958,412830,501780,220348,1134958
2023-04-28 12:41,1134978,412850,501780,220348,1134978
2023-04-28 12:42,1134998,412869,501780,220349,1134998
2023-04-28 12:43,1135018,412889,501780,220349,1135018
2023-04-28 12:44,1135039,412907,501780,220352,1135039
2023-04-28 12:45,1135058,412924,501780,220354,1135058
2023-04-28 12:46,1135078,412943,501780,220355,1135078
2023-04-28 12:47,1135097,412945,501796,220356,1135097
2023-04-28 12:48,1135118,412965,501796,220357,1135118
2023-04-28 12:49,1135137,412981,501798,220358,1135137
2023-04-28 12:50,1135158,413002,501798,220358,1135158
2023-04-28 12:51,1135177,413018,501801,220358,1135177
2023-04-28 12:52,1135197,413037,501801,220359,1135197
2023-04-28 12:53,1135217,413053,501804,220360,1135217
2023-04-28 12:54,1135237,413072,501804,220361,1135237
2023-04-28 12:55,1135256,413088,501805,220363,1135256
2023-04-28 12:56,1135276,413107,501805,220364,1135276
2023-04-28 12:57,1135295,413122,501809,220364,1135295
2023-04-28 12:58,1135316,413143,501809,220364,1135316
2023-04-28 12:59,1135337,413161,501811,220365,1135337
2023-04-28 13:00,1135356,413178,501811,220367,1135356
2023-04-28 13:01,1135377,413197,501811,220369,1135377
2023-04-28 13:02,1135397,413214,501812,220371,1135397
2023-04-28 13:04,1135417,413233,501812,220372,1135417
2023-04-28 13:05,1135437,413253,501812,220372,1135437
2023-04-28 13:06,1135455,413270,501812,220373,1135455
2023-04-28 13:07,1135476,413287,501816,220373,1135476
2023-04-28 13:08,1135495,413305,501816,220374,1135495
2023-04-28 13:09,1135516,413322,501819,220375,1135516
2023-04-28 13:10,1135534,413341,501819,220374,1135534
2023-04-28 13:11,1135555,413359,501820,220376,1135555
2023-04-28 13:12,1135575,413376,501821,220378,1135575
2023-04-28 13:13,1135596,413395,501821,220380,1135596
2023-04-28 13:14,1135616,413414,501821,220381,1135616
2023-04-28 13:15,1135636,413434,501821,220381,1135636
2023-04-28 13:16,1135655,413452,501821,220382,1135655
2023-04-28 13:17,1135675,413471,501821,220383,1135675
2023-04-28 13:18,1135694,413489,501821,220384,1135694
2023-04-28 13:19,1135715,413510,501821,220384,1135715
2023-04-28 13:20,1135733,413526,501821,220386,1135733
2023-04-28 13:21,1135753,413546,501821,220386,1135753
2023-04-28 13:22,1135774,413555,501831,220388,1135774
2023-04-28 13:23,1135793,413574,501831,220388,1135793
2023-04-28 13:24,1135812,413591,501833,220388,1135812
2023-04-28 13:25,1135832,413611,501833,220388,1135832
2023-04-28 13:26,1135852,413629,501834,220389,1135852
2023-04-28 13:27,1135874,413650,501834,220390,1135874
2023-04-28 13:28,1135893,413665,501836,220392,1135893
2023-04-28 13:29,1135912,413684,501836,220392,1135912
2023-04-28 13:30,1135932,413701,501838,220393,1135932
2023-04-28 13:31,1135953,413721,501838,220394,1135953
2023-04-28 13:32,1135973,413738,501840,220395,1135973
2023-04-28 13:33,1135992,413753,501844,220395,1135992
2023-04-28 13:34,1136013,413772,501844,220397,1136013
2023-04-28 13:35,1136033,413788,501845,220400,1136033
2023-04-28 13:36,1136054,413808,501845,220401,1136054
2023-04-28 13:37,1136075,413825,501847,220403,1136075
2023-04-28 13:38,1136095,413845,501847,220403,1136095
2023-04-28 13:39,1136116,413866,501847,220403,1136116
2023-04-28 13:40,1136136,413886,501847,220403,1136136
2023-04-28 13:41,1136155,413904,501847,220404,1136155
2023-04-28 13:42,1136175,413920,501847,220408,1136175
2023-04-28 13:43,1136195,413937,501850,220408,1136195
2023-04-28 13:44,1136215,413956,501850,220409,1136215
2023-04-28 13:45,1136234,413975,501850,220409,1136234
2023-04-28 13:46,1136254,413995,501850,220409,1136254
2023-04-28 13:47,1136274,414009,501852,220413,1136274
2023-04-28 13:48,1136294,414027,501852,220415,1136294
2023-04-28 13:49,1136315,414047,501853,220415,1136315
2023-04-28 13:51,1136334,414066,501853,220415,1136334
2023-04-28 13:52,1136354,414083,501856,220415,1136354
2023-04-28 13:53,1136376,414102,501856,220418,1136376
2023-04-28 13:54,1136395,414117,501858,220420,1136395
2023-04-28 13:55,1136416,414134,501858,220424,1136416
2023-04-28 13:56,1136435,414152,501859,220424,1136435
2023-04-28 13:57,1136455,414170,501859,220426,1136455
2023-04-28 13:58,1136476,414186,501860,220430,1136476
2023-04-28 13:59,1136497,414206,501860,220431,1136497
2023-04-28 14:00,1136520,414225,501862,220433,1136520
2023-04-28 14:01,1136556,414260,501862,220434,1136556
2023-04-28 14:02,1136596,414296,501865,220435,1136596
2023-04-28 14:03,1136633,414332,501865,220436,1136633
2023-04-28 14:04,1136670,414365,501868,220437,1136670
2023-04-28 14:05,1136707,414400,501868,220439,1136707
2023-04-28 14:06,1136745,414435,501870,220440,1136745
2023-04-28 14:07,1136783,414472,501870,220441,1136783
2023-04-28 14:08,1136822,414507,501872,220443,1136822
2023-04-28 14:09,1136859,414543,501872,220444,1136859
2023-04-28 14:10,1136896,414577,501873,220446,1136896
2023-04-28 14:11,1136933,414613,501873,220447,1136933
2023-04-28 14:12,1136972,414650,501874,220448,1136972
2023-04-28 14:13,1137012,414686,501875,220451,1137012
2023-04-28 14:14,1137048,414719,501875,220454,1137048
2023-04-28 14:15,1137084,414752,501877,220455,1137084
2023-04-28 14:16,1137122,414787,501877,220458,1137122
2023-04-28 14:17,1137161,414823,501880,220458,1137161
2023-04-28 14:18,1137196,414857,501880,220459,1137196
2023-04-28 14:19,1137235,414893,501881,220461,1137235
2023-04-28 14:20,1137273,414930,501881,220462,1137273
2023-04-28 14:21,1137314,414965,501883,220466,1137314
2023-04-28 14:22,1137349,414999,501883,220467,1137349
2023-04-28 14:23,1137389,415034,501887,220468,1137389
2023-04-28 14:24,1137425,415070,501887,220468,1137425
2023-04-28 14:25,1137461,415104,501888,220469,1137461
2023-04-28 14:26,1137500,415140,501888,220472,1137500
2023-04-28 14:27,1137535,415169,501893,220473,1137535
2023-04-28 14:28,1137575,415209,501893,220473,1137575
2023-04-28 14:29,1137610,415241,501895,220474,1137610
2023-04-28 14:30,1137649,415280,501895,220474,1137649
2023-04-28 14:31,1137687,415317,501896,220474,1137687
2023-04-28 14:32,1137724,415353,501896,220475,1137724
2023-04-28 14:33,1137761,415384,501901,220476,1137761
2023-04-28 14:34,1137801,415422,501902,220477,1137801
2023-04-28 14:35,1137838,415458,501902,220478,1137838
2023-04-28 14:37,1137876,415494,501904,220478,1137876
2023-04-28 14:38,1137917,415535,501904,220478,1137917
2023-04-28 14:39,1137955,415567,501909,220479,1137955
2023-04-28 14:40,1137991,415603,501909,220479,1137991
2023-04-28 14:41,1138030,415636,501913,220481,1138030
2023-04-28 14:42,1138068,415671,501913,220484,1138068
2023-04-28 14:43,1138105,415707,501914,220484,1138105
2023-04-28 14:44,1138142,415742,501914,220486,1138142
2023-04-28 14:45,1138182,415780,501914,220488,1138182
2023-04-28 14:46,1138217,415816,501914,220487,1138217
2023-04-28 14:47,1138256,415852,501914,220490,1138256
2023-04-28 14:48,1138294,415888,501914,220492,1138294
2023-04-28 14:49,1138330,415919,501918,220493,1138330
2023-04-28 14:50,1138367,415956,501918,220493,1138367
2023-04-28 14:51,1138406,415991,501922,220493,1138406
2023-04-28 14:52,1138443,416028,501922,220493,1138443
2023-04-28 14:53,1138482,416064,501924,220494,1138482
2023-04-28 14:54,1138518,416097,501924,220497,1138518
2023-04-28 14:55,1138555,416130,501925,220500,1138555
2023-04-28 14:56,1138592,416166,501925,220501,1138592
2023-04-28 14:57,1138632,416202,501927,220503,1138632
2023-04-28 14:58,1138666,416235,501927,220504,1138666
2023-04-28 14:59,1138704,416272,501928,220504,1138704
2023-04-28 15:00,1138739,416306,501928,220505,1138739
2023-04-28 15:01,1138771,416336,501928,220507,1138771
2023-04-28 15:02,1138804,416367,501928,220509,1138804
2023-04-28 15:03,1138835,416397,501929,220509,1138835
2023-04-28 15:04,1138868,416428,501929,220511,1138868
2023-04-28 15:05,1138900,416457,501929,220514,1138900
2023-04-28 15:06,1138930,416484,501929,220517,1138930
2023-04-28 15:07,1138963,416514,501932,220517,1138963
2023-04-28 15:08,1138994,416545,501932,220517,1138994
2023-04-28 15:09,1139028,416574,501935,220519,1139028
2023-04-28 15:10,1139060,416602,501935,220523,1139060
2023-04-28 15:11,1139092,416630,501938,220524,1139092
2023-04-28 15:12,1139124,416660,501938,220526,1139124
2023-04-28 15:13,1139156,416690,501939,220527,1139156
2023-04-28 15:14,1139186,416717,501940,220529,1139186
2023-04-28 15:15,1139218,416747,501940,220531,1139218
2023-04-28 15:16,1139251,416780,501940,220531,1139251
2023-04-28 15:17,1139284,416813,501940,220531,1139284
2023-04-28 15:18,1139316,416841,501941,220534,1139316
2023-04-28 15:19,1139348,416871,501941,220536,1139348
2023-04-28 15:20,1139379,416899,501942,220538,1139379
2023-04-28 15:21,1139410,416929,501942,220539,1139410
2023-04-28 15:22,1139443,416959,501945,220539,1139443
2023-04-28 15:23,1139475,416990,501945,220540,1139475
2023-04-28 15:24,1139506,417017,501948,220541,1139506
2023-04-28 15:26,1139538,417047,501948,220543,1139538
2023-04-28 15:27,1139571,417076,501951,220544,1139571
2023-04-28 15:28,1139602,417107,501951,220544,1139602
2023-04-28 15:29,1139633,417137,501952,220544,1139633
2023-04-28 15:30,1139665,417168,501952,220545,1139665
2023-04-28 15:31,1139696,417196,501954,220546,1139696
2023-04-28 15:32,1139728,417226,501954,220548,1139728
2023-04-28 15:33,1139761,417255,501956,220550,1139761
2023-04-28 15:34,1139793,417286,501956,220551,1139793
2023-04-28 15:35,1139826,417319,501955,220552,1139826
2023-04-28 15:36,1139857,417348,501955,220554,1139857
2023-04-28 15:37,1139889,417380,501955,220554,1139889
2023-04-28 15:38,1139920,417409,501955,220556,1139920
2023-04-28 15:39,1139954,417440,501957,220557,1139954
2023-04-28 15:40,1139986,417470,501957,220559,1139986
2023-04-28 15:41,1140019,417500,501958,220561,1140019
2023-04-28 15:42,1140050,417528,501958,220564,1140050
2023-04-28 15:43,1140083,417557,501962,220564,1140083
2023-04-28 15:44,1140117,417590,501962,220565,1140117
2023-04-28 15:45,1140147,417614,501965,220568,1140147
2023-04-28 15:46,1140178,417645,501965,220568,1140178
2023-04-28 15:47,1140211,417675,501967,220569,1140211
2023-04-28 15:48,1140243,417704,501967,220572,1140243
2023-04-28 15:49,1140275,417735,501968,220572,1140275
2023-04-28 15:50,1140307,417765,501968,220574,1140307
2023-04-28 15:51,1140339,417794,501970,220575,1140339
2023-04-28 15:52,1140369,417822,501970,220577,1140369
2023-04-28 15:53,1140401,417853,501970,220578,1140401
2023-04-28 15:54,1140434,417882,501970,220582,1140434
2023-04-28 15:55,1140467,417911,501970,220586,1140467
2023-04-28 15:56,1140498,417942,501970,220586,1140498
2023-04-28 15:57,1140530,417972,501971,220587,1140530
2023-04-28 15:58,1140561,418003,501971,220587,1140561
2023-04-28 15:59,1140594,418034,501973,220587,1140594
2023-04-28 16:00,1140612,418051,501973,220588,1140612
2023-04-28 16:01,1140625,418063,501974,220588,1140625
2023-04-28 16:02,1140640,418077,501974,220589,1140640
2023-04-28 16:03,1140653,418087,501975,220591,1140653
2023-04-28 16:04,1140666,418100,501975,220591,1140666
2023-04-28 16:05,1140679,418112,501976,220591,1140679
2023-04-28 16:06,1140691,418119,501976,220596,1140691
2023-04-28 16:07,1140704,418129,501978,220597,1140704
2023-04-28 16:08,1140716,418138,501978,220600,1140716
2023-04-28 16:09,1140728,418146,501981,220601,1140728
2023-04-28 16:10,1140742,418160,501981,220601,1140742
2023-04-28 16:11,1140755,418172,501981,220602,1140755
2023-04-28 16:12,1140768,418185,501981,220602,1140768
2023-04-28 16:14,1140780,418193,501983,220604,1140780
2023-04-28 16:15,1140793,418200,501986,220607,1140793
2023-04-28 16:16,1140806,418212,501986,220608,1140806
2023-04-28 16:17,1140818,418221,501986,220611,1140818
2023-04-28 16:18,1140831,418230,501989,220612,1140831
2023-04-28 16:19,1140843,418242,501989,220612,1140843
2023-04-28 16:20,1140856,418250,501994,220612,1140856
2023-04-28 16:21,1140868,418261,501994,220613,1140868
2023-04-28 16:22,1140882,418267,501999,220616,1140882
2023-04-28 16:23,1140894,418279,501999,220616,1140894
2023-04-28 16:24,1140907,418289,502001,220617,1140907
2023-04-28 16:25,1140920,418299,502001,220620,1140920
2023-04-28 16:26,1140932,418310,502002,220620,1140932
2023-04-28 16:27,1140945,418323,502002,220620,1140945
2023-04-28 16:28,1140957,418330,502005,220622,1140957
2023-04-28 16:29,1140970,418341,502005,220624,1140970
2023-04-28 16:30,1140984,418351,502006,220627,1140984
2023-04-28 16:31,1140996,418360,502006,220630,1140996
2023-04-28 16:32,1141009,418372,502006,220631,1141009
2023-04-28 16:33,1141021,418383,502006,220632,1141021
2023-04-28 16:34,1141034,418392,502007,220635,1141034
2023-04-28 16:35,1141046,418403,502007,220636,1141046
2023-04-28 16:36,1141059,418415,502008,220636,1141059
2023-04-28 16:37,1141071,418422,502011,220638,1141071
2023-04-28 16:38,1141086,418436,502011,220639,1141086
2023-04-28 16:39,1141098,418444,502013,220641,1141098
2023-04-28 16:40,1141110,418455,502013,220642,1141110
2023-04-28 16:41,1141123,418462,502018,220643,1141123
2023-04-28 16:42,1141135,418473,502018,220644,1141135
2023-04-28 16:43,1141148,418482,502020,220646,1141148
2023-04-28 16:44,1141161,418495,502020,220646,1141161
2023-04-28 16:45,1141174,418505,502022,220647,1141174
2023-04-28 16:46,1141187,418517,502022,220648,1141187
2023-04-28 16:47,1141200,418524,502026,220650,1141200
2023-04-28 16:48,1141212,418535,502026,220651,1141212
2023-04-28 16:49,1141225,418545,502028,220652,1141225
2023-04-28 16:50,1141239,418558,502028,220653,1141239
2023-04-28 16:51,1141250,418564,502028,220658,1141250
2023-04-28 16:52,1141263,418576,502028,220659,1141263
2023-04-28 16:53,1141276,418585,502032,220659,1141276
2023-04-28 16:54,1141288,418594,502032,220662,1141288
2023-04-28 16:55,1141301,418597,502037,220667,1141301
2023-04-28 16:56,1141313,418608,502037,220668,1141313
2023-04-28 16:57,1141327,418617,502040,220670,1141327
2023-04-28 16:58,1141339,418628,502040,220671,1141339
2023-04-28 16:59,1141352,418637,502042,220673,1141352
2023-04-28 17:00,1141375,418659,502042,220674,1141375
2023-04-28 17:02,1141400,418681,502044,220675,1141400
2023-04-28 17:03,1141427,418706,502044,220677,1141427
2023-04-28 17:04,1141452,418728,502046,220678,1141452
2023-04-28 17:05,1141478,418751,502046,220681,1141478
2023-04-28 17:06,1141502,418770,502047,220685,1141502
2023-04-28 17:07,1141527,418791,502047,220689,1141527
2023-04-28 17:08,1141552,418809,502049,220694,1141552
2023-04-28 17:09,1141577,418832,502049,220696,1141577
2023-04-28 17:10,1141604,418856,502052,220696,1141604
2023-04-28 17:11,1141629,418877,502055,220697,1141629
2023-04-28 17:12,1141656,418902,502055,220699,1141656
2023-04-28 17:13,1141681,418920,502056,220705,1141681
2023-04-28 17:14,1141705,418943,502056,220706,1141705
2023-04-28 17:15,1141731,418963,502060,220708,1141731
2023-04-28 17:16,1141757,418988,502060,220709,1141757
2023-04-28 17:17,1141780,419004,502065,220711,1141780
2023-04-28 17:18,1141807,419029,502066,220712,1141807
2023-04-28 17:19,1141834,419049,502070,220715,1141834
2023-04-28 17:20,1141859,419074,502070,220715,1141859
2023-04-28 17:21,1141884,419096,502070,220718,1141884
2023-04-28 17:22,1141909,419122,502070,220717,1141909
2023-04-28 17:23,1141933,419142,502073,220718,1141933
2023-04-28 17:24,1141959,419166,502073,220720,1141959
2023-04-28 17:25,1141985,419189,502076,220720,1141985
2023-04-28 17:26,1142009,419212,502076,220721,1142009
2023-04-28 17:27,1142034,419235,502078,220721,1142034
2023-04-28 17:28,1142060,419259,502078,220723,1142060
2023-04-28 17:29,1142084,419282,502079,220723,1142084
2023-04-28 17:30,1142109,419305,502079,220725,1142109
2023-04-28 17:31,1142135,419327,502082,220726,1142135
2023-04-28 17:32,1142160,419351,502082,220727,1142160
2023-04-28 17:33,1142184,419369,502086,220729,1142184
2023-04-28 17:34,1142209,419390,502088,220731,1142209
2023-04-28 17:35,1142234,419412,502089,220733,1142234
2023-04-28 17:36,1142260,419437,502090,220733,1142260
2023-04-28 17:37,1142285,419462,502090,220733,1142285
2023-04-28 17:38,1142311,419481,502095,220735,1142311
2023-04-28 17:39,1142335,419502,502095,220738,1142335
2023-04-28 17:40,1142360,419523,502095,220742,1142360
2023-04-28 17:41,1142387,419545,502095,220747,1142387
2023-04-28 17:42,1142412,419567,502098,220747,1142412
2023-04-28 17:43,1142438,419591,502098,220749,1142438
2023-04-28 17:44,1142461,419610,502099,220752,1142461
2023-04-28 17:45,1142488,419636,502099,220753,1142488
2023-04-28 17:46,1142512,419657,502101,220754,1142512
2023-04-28 17:48,1142537,419679,502101,220757,1142537
2023-04-28 17:49,1142563,419699,502104,220760,1142563
2023-04-28 17:50,1142588,419721,502104,220763,1142588
2023-04-28 17:51,1142614,419743,502106,220765,1142614
2023-04-28 17:52,1142639,419766,502106,220767,1142639
2023-04-28 17:53,1142665,419789,502106,220770,1142665
2023-04-28 17:54,1142690,419812,502106,220772,1142690
2023-04-28 17:55,1142716,419834,502109,220773,1142716
2023-04-28 17:56,1142741,419857,502109,220775,1142741
2023-04-28 17:57,1142766,419879,502113,220774,1142766
2023-04-28 17:58,1142790,419902,502113,220775,1142790
2023-04-28 17:59,1142815,419920,502118,220777,1142815
2023-04-28 18:00,1142843,419948,502118,220777,1142843
2023-04-28 18:01,1142871,419970,502117,220784,1142871
2023-04-28 18:02,1142901,419996,502117,220788,1142901
2023-04-28 18:03,1142930,420021,502120,220789,1142930
2023-04-28 18:04,1142958,420047,502120,220791,1142958
2023-04-28 18:05,1142987,420066,502124,220797,1142987
2023-04-28 18:06,1143015,420094,502124,220797,1143015
2023-04-28 18:07,1143046,420124,502124,220798,1143046
2023-04-28 18:08,1143075,420150,502124,220801,1143075
2023-04-28 18:09,1143105,420174,502125,220806,1143105
2023-04-28 18:10,1143135,420201,502125,220809,1143135
2023-04-28 18:11,1143165,420222,502129,220814,1143165
2023-04-28 18:12,1143193,420245,502129,220819,1143193
2023-04-28 18:13,1143223,420268,502132,220823,1143223
2023-04-28 18:14,1143252,420297,502132,220823,1143252
2023-04-28 18:15,1143281,420320,502135,220826,1143281
2023-04-28 18:16,1143312,420348,502135,220829,1143312
2023-04-28 18:17,1143341,420369,502139,220833,1143341
2023-04-28 18:18,1143369,420396,502139,220834,1143369
2023-04-28 18:19,1143397,420418,502143,220836,1143397
2023-04-28 18:20,1143426,420445,502143,220838,1143426
2023-04-28 18:21,1143456,420468,502145,220843,1143456
2023-04-28 18:22,1143484,420495,502145,220844,1143484
2023-04-28 18:23,1143514,420520,502147,220847,1143514
2023-04-28 18:25,1143543,420543,502147,220853,1143543
2023-04-28 18:26,1143600,420593,502151,220856,1143600
2023-04-28 18:27,1143631,420619,502151,220861,1143631
2023-04-28 18:28,1143658,420636,502155,220867,1143658
2023-04-28 18:29,1143688,420665,502155,220868,1143688
2023-04-28 18:30,1143716,420691,502157,220868,1143716
2023-04-28 18:31,1143744,420713,502159,220872,1143744
2023-04-28 18:32,1143774,420743,502159,220872,1143774
2023-04-28 18:34,1143804,420765,502162,220877,1143804
2023-04-28 18:35,1143831,420791,502162,220878,1143831
2023-04-28 18:36,1143861,420811,502172,220878,1143861
2023-04-28 18:37,1143890,420838,502172,220880,1143890
2023-04-28 18:38,1143918,420858,502179,220881,1143918
2023-04-28 18:39,1143948,420886,502179,220883,1143948
2023-04-28 18:40,1143977,420904,502188,220885,1143977
2023-04-28 18:41,1144006,420933,502188,220885,1144006
2023-04-28 18:42,1144035,420959,502190,220886,1144035
2023-04-28 18:43,1144063,420985,502190,220888,1144063
2023-04-28 18:44,1144093,421012,502193,220888,1144093
2023-04-28 18:45,1144121,421038,502193,220890,1144121
2023-04-28 18:46,1144151,421061,502195,220895,1144151
2023-04-28 18:47,1144181,421089,502195,220897,1144181
2023-04-28 18:48,1144209,421112,502200,220897,1144209
2023-04-28 18:49,1144239,421140,502200,220899,1144239
2023-04-28 18:50,1144267,421158,502205,220904,1144267
2023-04-28 18:51,1144295,421184,502205,220906,1144295
2023-04-28 18:52,1144324,421208,502210,220906,1144324
2023-04-28 18:53,1144354,421235,502210,220909,1144354
2023-04-28 18:54,1144383,421256,502214,220913,1144383
2023-04-28 18:55,1144411,421281,502215,220915,1144411
2023-04-28 18:56,1144440,421308,502215,220917,1144440
2023-04-28 18:57,1144470,421333,502218,220919,1144470
2023-04-28 18:58,1144500,421363,502218,220919,1144500
2023-04-28 18:59,1144530,421391,502219,220920,1144530
2023-04-28 19:00,1144554,421414,502219,220921,1144554
2023-04-28 19:01,1144573,421426,502222,220925,1144573
2023-04-28 19:02,1144592,421443,502222,220927,1144592
2023-04-28 19:03,1144610,421455,502227,220928,1144610
2023-04-28 19:04,1144630,421474,502227,220929,1144630
2023-04-28 19:05,1144649,421488,502230,220931,1144649
2023-04-28 19:06,1144668,421504,502231,220933,1144668
2023-04-28 19:07,1144689,421517,502235,220937,1144689
2023-04-28 19:08,1144707,421525,502242,220940,1144707
2023-04-28 19:09,1144727,421545,502242,220940,1144727
2023-04-28 19:10,1144747,421560,502245,220942,1144747
2023-04-28 19:11,1144768,421580,502245,220943,1144768
2023-04-28 19:12,1144787,421596,502246,220945,1144787
2023-04-28 19:13,1144807,421614,502246,220947,1144807
2023-04-28 19:14,1144826,421627,502249,220950,1144826
2023-04-28 19:15,1144847,421645,502249,220953,1144847
2023-04-28 19:16,1144867,421661,502251,220955,1144867
2023-04-28 19:17,1144885,421676,502251,220958,1144885
2023-04-28 19:18,1144907,421695,502252,220960,1144907
2023-04-28 19:19,1144927,421713,502252,220962,1144927
2023-04-28 19:20,1144945,421727,502255,220963,1144945
2023-04-28 19:22,1144964,421745,502255,220964,1144964
2023-04-28 19:23,1144983,421759,502258,220966,1144983
2023-04-28 19:24,1145003,421777,502258,220968,1145003
2023-04-28 19:25,1145021,421788,502262,220971,1145021
2023-04-28 19:26,1145041,421806,502262,220973,1145041
2023-04-28 19:27,1145061,421820,502266,220975,1145061
2023-04-28 19:28,1145079,421838,502266,220975,1145079
2023-04-28 19:29,1145100,421853,502270,220977,1145100
2023-04-28 19:30,1145118,421869,502270,220979,1145118
2023-04-28 19:31,1145138,421884,502272,220982,1145138
2023-04-28 19:32,1145158,421903,502273,220982,1145158
2023-04-28 19:33,1145178,421919,502276,220983,1145178
2023-04-28 19:34,1145197,421936,502276,220985,1145197
2023-04-28 19:35,1145217,421944,502282,220991,1145217
2023-04-28 19:36,1145236,421960,502283,220993,1145236
2023-04-28 19:37,1145253,421974,502283,220996,1145253
2023-04-28 19:38,1145273,421989,502286,220998,1145273
2023-04-28 19:39,1145294,422008,502286,221000,1145294
2023-04-28 19:40,1145315,422023,502288,221004,1145315
2023-04-28 19:41,1145334,422040,502288,221006,1145334
2023-04-28 19:42,1145353,422056,502291,221006,1145353
2023-04-28 19:43,1145373,422074,502291,221008,1145373
2023-04-28 19:44,1145392,422090,502293,221009,1145392
2023-04-28 19:45,1145410,422106,502295,221009,1145410
2023-04-28 19:46,1145431,422123,502295,221013,1145431
2023-04-28 19:47,1145450,422135,502300,221015,1145450
2023-04-28 19:48,1145469,422154,502300,221015,1145469
2023-04-28 19:49,1145489,422172,502300,221017,1145489
2023-04-28 19:50,1145508,422190,502300,221018,1145508
2023-04-28 19:51,1145529,422202,502308,221019,1145529
2023-04-28 19:52,1145546,422214,502310,221022,1145546
2023-04-28 19:53,1145565,422230,502310,221025,1145565
2023-04-28 19:54,1145586,422246,502314,221026,1145586
2023-04-28 19:55,1145604,422263,502314,221027,1145604
2023-04-28 19:56,1145624,422278,502317,221029,1145624
2023-04-28 19:57,1145645,422296,502317,221032,1145645
2023-04-28 19:58,1145663,422310,502321,221032,1145663
2023-04-28 19:59,1145683,422328,502321,221034,1145683
2023-04-28 20:00,1145702,422339,502327,221036,1145702
2023-04-28 20:01,1145721,422356,502327,221038,1145721
2023-04-28 20:02,1145740,422372,502329,221039,1145740
2023-04-28 20:03,1145759,422390,502329,221040,1145759
2023-04-28 20:04,1145778,422402,502332,221044,1145778
2023-04-28 20:05,1145798,422422,502332,221044,1145798
2023-04-28 20:06,1145816,422436,502334,221046,1145816
2023-04-28 20:07,1145836,422451,502337,221048,1145836
2023-04-28 20:09,1145855,422468,502337,221050,1145855
2023-04-28 20:10,1145876,422488,502337,221051,1145876
2023-04-28 20:11,1145895,422506,502337,221052,1145895
2023-04-28 20:12,1145914,422524,502337,221053,1145914
2023-04-28 20:13,1145934,422538,502340,221056,1145934
2023-04-28 20:14,1145952,422556,502340,221056,1145952
2023-04-28 20:15,1145971,422572,502341,221058,1145971
2023-04-28 20:16,1145989,422589,502341,221059,1145989
2023-04-28 20:17,1146008,422604,502344,221060,1146008
2023-04-28 20:18,1146028,422622,502344,221062,1146028
2023-04-28 20:19,1146047,422634,502349,221064,1146047
2023-04-28 20:20,1146068,422653,502349,221066,1146068
2023-04-28 20:21,1146089,422672,502349,221068,1146089
2023-04-28 20:22,1146108,422690,502350,221068,1146108
2023-04-28 20:23,1146128,422707,502350,221071,1146128
2023-04-28 20:24,1146147,422717,502355,221075,1146147
2023-04-28 20:25,1146167,422736,502355,221076,1146167
2023-04-28 20:26,1146186,422751,502359,221076,1146186
2023-04-28 20:27,1146205,422769,502359,221077,1146205
2023-04-28 20:28,1146225,422787,502360,221078,1146225
2023-04-28 20:29,1146245,422806,502360,221079,1146245
2023-04-28 20:30,1146262,422816,502365,221081,1146262
2023-04-28 20:31,1146282,422835,502365,221082,1146282
2023-04-28 20:32,1146301,422848,502368,221085,1146301
2023-04-28 20:33,1146320,422867,502368,221085,1146320
2023-04-28 20:34,1146340,422886,502368,221086,1146340
2023-04-28 20:35,1146358,422900,502368,221090,1146358
2023-04-28 20:36,1146378,422917,502370,221091,1146378
2023-04-28 20:37,1146398,422935,502370,221093,1146398
2023-04-28 20:38,1146420,422953,502373,221094,1146420
2023-04-28 20:39,1146439,422970,502373,221096,1146439
2023-04-28 20:40,1146458,422985,502375,221098,1146458
2023-04-28 20:41,1146477,423002,502376,221099,1146477
2023-04-28 20:42,1146497,423020,502376,221101,1146497
2023-04-28 20:43,1146518,423038,502379,221101,1146518
2023-04-28 20:44,1146537,423056,502379,221102,1146537
2023-04-28 20:45,1146557,423070,502384,221103,1146557
2023-04-28 20:46,1146576,423084,502384,221108,1146576
2023-04-28 20:47,1146594,423099,502386,221109,1146594
2023-04-28 20:48,1146614,423117,502386,221111,1146614
2023-04-28 20:49,1146633,423130,502390,221113,1146633
2023-04-28 20:50,1146651,423148,502390,221113,1146651
2023-04-28 20:51,1146671,423162,502396,221113,1146671
2023-04-28 20:52,1146690,423179,502396,221115,1146690
2023-04-28 20:53,1146710,423194,502400,221116,1146710
2023-04-28 20:54,1146729,423209,502400,221120,1146729
2023-04-28 20:56,1146748,423223,502405,221120,1146748
2023-04-28 20:57,1146767,423241,502405,221121,1146767
2023-04-28 20:58,1146787,423253,502408,221126,1146787
2023-04-28 20:59,1146807,423272,502408,221127,1146807
2023-04-28 21:00,1146827,423286,502412,221129,1146827
2023-04-28 21:01,1146836,423295,502412,221129,1146836
2023-04-28 21:02,1146845,423299,502412,221134,1146845
2023-04-28 21:03,1146855,423309,502412,221134,1146855
2023-04-28 21:04,1146864,423309,502418,221137,1146864
2023-04-28 21:05,1146873,423314,502418,221141,1146873
2023-04-28 21:06,1146883,423318,502418,221147,1146883
2023-04-28 21:07,1146893,423328,502418,221147,1146893
2023-04-28 21:08,1146902,423335,502420,221147,1146902
2023-04-28 21:09,1146911,423341,502420,221150,1146911
2023-04-28 21:10,1146922,423342,502426,221154,1146922
2023-04-28 21:11,1146933,423351,502426,221156,1146933
2023-04-28 21:12,1146942,423355,502430,221157,1146942
2023-04-28 21:13,1146952,423364,502430,221158,1146952
2023-04-28 21:14,1146961,423368,502432,221161,1146961
2023-04-28 21:15,1146970,423367,502436,221167,1146970
2023-04-28 21:16,1146980,423376,502436,221168,1146980
2023-04-28 21:17,1146991,423382,502439,221170,1146991
2023-04-28 21:18,1147000,423388,502439,221173,1147000
2023-04-28 21:19,1147010,423394,502440,221176,1147010
2023-04-28 21:20,1147019,423402,502439,221178,1147019
2023-04-28 21:21,1147028,423405,502439,221184,1147028
2023-04-28 21:22,1147037,423408,502442,221187,1147037
2023-04-28 21:23,1147046,423411,502442,221193,1147046
2023-04-28 21:24,1147056,423417,502445,221194,1147056
2023-04-28 21:25,1147065,423423,502445,221197,1147065
2023-04-28 21:26,1147074,423428,502447,221199,1147074
2023-04-28 21:27,1147083,423432,502447,221204,1147083
2023-04-28 21:28,1147093,423439,502448,221206,1147093
2023-04-28 21:29,1147102,423446,502448,221208,1147102
2023-04-28 21:30,1147111,423451,502448,221212,1147111
2023-04-28 21:31,1147121,423459,502448,221214,1147121
2023-04-28 21:32,1147131,423464,502450,221217,1147131
2023-04-28 21:33,1147140,423468,502450,221222,1147140
2023-04-28 21:34,1147149,423472,502450,221227,1147149
2023-04-28 21:35,1147159,423481,502450,221228,1147159
2023-04-28 21:36,1147168,423488,502450,221230,1147168
2023-04-28 21:37,1147177,423494,502450,221233,1147177
2023-04-28 21:38,1147186,423499,502450,221237,1147186
2023-04-28 21:39,1147196,423508,502450,221238,1147196
2023-04-28 21:40,1147205,423505,502461,221239,1147205
2023-04-28 21:41,1147214,423513,502461,221240,1147214
2023-04-28 21:43,1147223,423514,502467,221242,1147223
2023-04-28 21:44,1147233,423522,502467,221244,1147233
2023-04-28 21:45,1147242,423523,502473,221246,1147242
2023-04-28 21:46,1147252,423530,502473,221249,1147252
2023-04-28 21:47,1147262,423538,502473,221251,1147262
2023-04-28 21:48,1147271,423545,502473,221253,1147271
2023-04-28 21:49,1147280,423552,502473,221255,1147280
2023-04-28 21:50,1147290,423560,502473,221257,1147290
2023-04-28 21:51,1147299,423563,502478,221258,1147299
2023-04-28 21:52,1147308,423571,502478,221259,1147308
2023-04-28 21:53,1147317,423573,502480,221264,1147317
2023-04-28 21:54,1147326,423581,502480,221265,1147326
2023-04-28 21:55,1147337,423591,502480,221266,1147337
2023-04-28 21:56,1147347,423598,502480,221269,1147347
2023-04-28 21:57,1147357,423601,502480,221276,1147357
2023-04-28 21:58,1147366,423604,502480,221282,1147366
2023-04-28 21:59,1147375,423610,502480,221285,1147375
2023-04-28 22:00,1147387,423619,502480,221288,1147387
2023-04-28 22:01,1147401,423632,502480,221289,1147401
2023-04-28 22:02,1147413,423630,502492,221291,1147413
2023-04-28 22:03,1147425,423642,502492,221291,1147425
2023-04-28 22:04,1147437,423643,502498,221296,1147437
2023-04-28 22:05,1147449,423656,502498,221295,1147449
2023-04-28 22:06,1147461,423660,502504,221297,1147461
2023-04-28 22:07,1147473,423672,502504,221297,1147473
2023-04-28 22:08,1147485,423680,502507,221298,1147485
2023-04-28 22:09,1147496,423691,502507,221298,1147496
2023-04-28 22:10,1147508,423695,502514,221299,1147508
2023-04-28 22:11,1147520,423706,502514,221300,1147520
2023-04-28 22:12,1147532,423711,502519,221302,1147532
2023-04-28 22:13,1147544,423721,502519,221304,1147544
2023-04-28 22:14,1147557,423730,502521,221306,1147557
2023-04-28 22:15,1147568,423739,502521,221308,1147568
2023-04-28 22:16,1147581,423749,502523,221309,1147581
2023-04-28 22:17,1147592,423758,502523,221311,1147592
2023-04-28 22:18,1147605,423761,502529,221315,1147605
2023-04-28 22:19,1147616,423771,502529,221316,1147616
2023-04-28 22:20,1147628,423777,502531,221320,1147628
2023-04-28 22:21,1147640,423786,502531,221323,1147640
2023-04-28 22:22,1147652,423798,502532,221322,1147652
2023-04-28 22:23,1147663,423808,502532,221323,1147663
2023-04-28 22:24,1147677,423811,502539,221327,1147677
2023-04-28 22:25,1147688,423821,502539,221328,1147688
2023-04-28 22:26,1147701,423827,502543,221331,1147701
2023-04-28 22:27,1147713,423837,502543,221333,1147713
2023-04-28 22:28,1147725,423845,502546,221334,1147725
2023-04-28 22:29,1147737,423851,502546,221340,1147737
2023-04-28 22:31,1147750,423860,502549,221341,1147750
2023-04-28 22:32,1147763,423868,502549,221346,1147763
2023-04-28 22:33,1147775,423873,502554,221348,1147775
2023-04-28 22:34,1147786,423882,502554,221350,1147786
2023-04-28 22:35,1147799,423890,502557,221352,1147799
2023-04-28 22:36,1147810,423898,502557,221355,1147810
2023-04-28 22:37,1147823,423900,502562,221361,1147823
2023-04-28 22:38,1147836,423910,502562,221364,1147836
2023-04-28 22:39,1147848,423917,502565,221366,1147848
2023-04-28 22:40,1147859,423928,502565,221366,1147859
2023-04-28 22:41,1147871,423938,502567,221366,1147871
2023-04-28 22:42,1147883,423946,502570,221367,1147883
2023-04-28 22:43,1147895,423956,502570,221369,1147895
2023-04-28 22:44,1147908,423961,502579,221368,1147908
2023-04-28 22:45,1147921,423967,502582,221372,1147921
2023-04-28 22:46,1147933,423971,502582,221380,1147933
2023-04-28 22:47,1147945,423978,502585,221382,1147945
2023-04-28 22:48,1147959,423989,502585,221385,1147959
2023-04-28 22:49,1147971,423998,502586,221387,1147971
2023-04-28 22:50,1147983,424000,502589,221394,1147983
2023-04-28 22:51,1147997,424012,502589,221396,1147997
2023-04-28 22:52,1148010,424018,502593,221399,1148010
2023-04-28 22:53,1148023,424029,502593,221401,1148023
2023-04-28 22:54,1148035,424035,502594,221406,1148035
2023-04-28 22:55,1148047,424044,502595,221408,1148047
2023-04-28 22:56,1148060,424053,502595,221412,1148060
2023-04-28 22:57,1148072,424054,502602,221416,1148072
2023-04-28 22:58,1148084,424064,502602,221418,1148084
2023-04-28 22:59,1148095,424068,502607,221420,1148095
2023-04-28 23:00,1148115,424084,502610,221421,1148115
2023-04-28 23:01,1148138,424101,502614,221423,1148138
2023-04-28 23:02,1148162,424125,502614,221423,1148162
2023-04-28 23:03,1148186,424144,502615,221427,1148186
2023-04-28 23:04,1148212,424167,502615,221430,1148212
2023-04-28 23:05,1148236,424182,502618,221436,1148236
2023-04-28 23:06,1148259,424205,502618,221436,1148259
2023-04-28 23:07,1148282,424222,502622,221438,1148282
2023-04-28 23:08,1148305,424241,502623,221441,1148305
2023-04-28 23:09,1148328,424257,502626,221445,1148328
2023-04-28 23:10,1148351,424273,502631,221447,1148351
2023-04-28 23:11,1148375,424296,502631,221448,1148375
2023-04-28 23:12,1148399,424316,502633,221450,1148399
2023-04-28 23:13,1148423,424337,502633,221453,1148423
2023-04-28 23:14,1148445,424351,502638,221456,1148445
2023-04-28 23:15,1148468,424370,502638,221460,1148468
2023-04-28 23:16,1148492,424389,502639,221464,1148492
2023-04-28 23:18,1148516,424409,502639,221468,1148516
2023-04-28 23:19,1148539,424428,502642,221469,1148539
2023-04-28 23:20,1148564,424452,502642,221470,1148564
2023-04-28 23:21,1148587,424466,502646,221475,1148587
2023-04-28 23:22,1148609,424481,502649,221479,1148609
2023-04-28 23:23,1148633,424497,502649,221487,1148633
2023-04-28 23:24,1148657,424517,502649,221491,1148657
2023-04-28 23:25,1148680,424535,502649,221496,1148680
2023-04-28 23:26,1148703,424550,502655,221498,1148703
2023-04-28 23:27,1148727,424570,502656,221501,1148727
2023-04-28 23:28,1148750,424590,502656,221504,1148750
2023-04-28 23:29,1148773,424602,502663,221508,1148773
2023-04-28 23:30,1148797,424625,502663,221509,1148797
2023-04-28 23:31,1148821,424646,502665,221510,1148821
2023-04-28 23:32,1148845,424667,502665,221513,1148845
2023-04-28 23:33,1148869,424687,502667,221515,1148869
2023-04-28 23:34,1148891,424709,502667,221515,1148891
2023-04-28 23:35,1148915,424728,502671,221516,1148915
2023-04-28 23:36,1148937,424747,502671,221519,1148937
2023-04-28 23:37,1148961,424762,502679,221520,1148961
2023-04-28 23:38,1148985,424783,502679,221523,1148985
2023-04-28 23:39,1149007,424802,502681,221524,1149007
2023-04-28 23:40,1149032,424824,502681,221527,1149032
2023-04-28 23:41,1149056,424844,502683,221529,1149056
2023-04-28 23:42,1149080,424869,502683,221528,1149080
2023-04-28 23:43,1149104,424888,502685,221531,1149104
2023-04-28 23:44,1149126,424908,502685,221533,1149126
2023-04-28 23:45,1149149,424925,502687,221537,1149149
2023-04-28 23:46,1149174,424943,502688,221543,1149174
2023-04-28 23:47,1149197,424964,502688,221545,1149197
2023-04-28 23:48,1149222,424985,502689,221548,1149222
2023-04-28 23:49,1149245,425006,502689,221550,1149245
2023-04-28 23:50,1149267,425023,502691,221553,1149267
2023-04-28 23:51,1149291,425044,502691,221556,1149291
2023-04-28 23:52,1149314,425059,502695,221560,1149314
2023-04-28 23:53,1149338,425081,502695,221562,1149338
2023-04-28 23:54,1149361,425095,502697,221569,1149361
2023-04-28 23:55,1149385,425118,502697,221570,1149385
2023-04-28 23:56,1149410,425138,502701,221571,1149410
2023-04-28 23:57,1149432,425156,502701,221575,1149432
2023-04-28 23:58,1149455,425172,502702,221581,1149455
2023-04-28 23:59,1149478,425194,502702,221582,1149478
2023-04-29 00:00,1149506,425218,502705,221583,1149506
2023-04-29 00:01,1149532,425240,502705,221587,1149532
2023-04-29 00:02,1149558,425263,502707,221588,1149558
2023-04-29 00:03,1149586,425288,502707,221591,1149586
2023-04-29 00:04,1149613,425311,502708,221594,1149613
2023-04-29 00:06,1149640,425335,502708,221597,1149640
2023-04-29 00:07,1149666,425359,502711,221596,1149666
2023-04-29 00:08,1149693,425386,502711,221596,1149693
2023-04-29 00:09,1149721,425411,502712,221598,1149721
2023-04-29 00:10,1149747,425437,502712,221598,1149747
2023-04-29 00:11,1149775,425458,502715,221602,1149775
2023-04-29 00:12,1149802,425477,502715,221610,1149802
2023-04-29 00:13,1149828,425502,502714,221612,1149828
2023-04-29 00:14,1149855,425528,502714,221613,1149855
2023-04-29 00:15,1149882,425553,502716,221613,1149882
2023-04-29 00:16,1149910,425577,502716,221617,1149910
2023-04-29 00:17,1149937,425599,502719,221619,1149937
2023-04-29 00:18,1149964,425623,502719,221622,1149964
2023-04-29 00:19,1149990,425646,502720,221624,1149990
2023-04-29 00:20,1150016,425669,502720,221627,1150016
2023-04-29 00:21,1150046,425692,502724,221630,1150046
2023-04-29 00:22,1150071,425716,502724,221631,1150071
2023-04-29 00:23,1150101,425741,502725,221635,1150101
2023-04-29 00:24,1150127,425766,502725,221636,1150127
2023-04-29 00:25,1150154,425790,502727,221637,1150154
2023-04-29 00:26,1150181,425817,502727,221637,1150181
2023-04-29 00:27,1150209,425841,502732,221636,1150209
2023-04-29 00:28,1150237,425864,502732,221641,1150237
2023-04-29 00:29,1150264,425885,502736,221643,1150264
2023-04-29 00:30,1150291,425907,502736,221648,1150291
2023-04-29 00:31,1150318,425932,502738,221648,1150318
2023-04-29 00:32,1150345,425958,502738,221649,1150345
2023-04-29 00:33,1150370,425977,502740,221653,1150370
2023-04-29 00:34,1150399,426004,502740,221655,1150399
2023-04-29 00:35,1150424,426026,502742,221656,1150424
2023-04-29 00:36,1150453,426053,502742,221658,1150453
2023-04-29 00:37,1150478,426076,502743,221659,1150478
2023-04-29 00:38,1150505,426099,502743,221663,1150505
2023-04-29 00:39,1150534,426125,502744,221665,1150534
2023-04-29 00:40,1150562,426152,502744,221666,1150562
2023-04-29 00:41,1150588,426175,502745,221668,1150588
2023-04-29 00:42,1150615,426200,502745,221670,1150615
2023-04-29 00:43,1150641,426222,502748,221671,1150641
2023-04-29 00:44,1150670,426246,502748,221676,1150670
2023-04-29 00:45,1150696,426263,502753,221680,1150696
2023-04-29 00:46,1150723,426289,502753,221681,1150723
2023-04-29 00:47,1150750,426311,502755,221684,1150750
2023-04-29 00:48,1150778,426337,502755,221686,1150778
2023-04-29 00:49,1150804,426360,502757,221687,1150804
2023-04-29 00:50,1150833,426388,502757,221688,1150833
2023-04-29 00:51,1150859,426411,502759,221689,1150859
2023-04-29 00:52,1150885,426435,502759,221691,1150885
2023-04-29 00:54,1150911,426459,502760,221692,1150911
2023-04-29 00:55,1150938,426484,502760,221694,1150938
2023-04-29 00:56,1150966,426507,502764,221695,1150966
2023-04-29 00:57,1150993,426532,502764,221697,1150993
2023-04-29 00:58,1151018,426552,502767,221699,1151018
2023-04-29 00:59,1151046,426578,502767,221701,1151046
2023-04-29 01:00,1151073,426598,502771,221704,1151073
2023-04-29 01:01,1151102,426623,502772,221707,1151102
2023-04-29 01:02,1151129,426650,502772,221707,1151129
2023-04-29 01:03,1151157,426673,502777,221707,1151157
2023-04-29 01:04,1151185,426700,502777,221708,1151185
2023-04-29 01:05,1151213,426724,502780,221709,1151213
2023-04-29 01:06,1151239,426748,502780,221711,1151239
2023-04-29 01:07,1151267,426770,502783,221714,1151267
2023-04-29 01:08,1151295,426796,502783,221716,1151295
2023-04-29 01:09,1151322,426821,502785,221716,1151322
2023-04-29 01:10,1151350,426849,502785,221716,1151350
2023-04-29 01:11,1151376,426870,502789,221717,1151376
2023-04-29 01:12,1151406,426899,502789,221718,1151406
2023-04-29 01:13,1151433,426923,502790,221720,1151433
2023-04-29 01:14,1151461,426951,502790,221720,1151461
2023-04-29 01:15,1151490,426975,502794,221721,1151490
2023-04-29 01:16,1151516,427000,502794,221722,1151516
2023-04-29 01:17,1151543,427024,502794,221725,1151543
2023-04-29 01:18,1151572,427053,502794,221725,1151572
2023-04-29 01:19,1151600,427079,502795,221726,1151600
2023-04-29 01:20,1151627,427106,502795,221726,1151627
2023-04-29 01:21,1151653,427131,502796,221726,1151653
2023-04-29 01:22,1151682,427157,502796,221729,1151682
2023-04-29 01:23,1151708,427180,502798,221730,1151708
2023-04-29 01:24,1151737,427208,502798,221731,1151737
2023-04-29 01:25,1151763,427232,502798,221733,1151763
2023-04-29 01:26,1151791,427257,502798,221736,1151791
2023-04-29 01:27,1151819,427282,502800,221737,1151819
2023-04-29 01:28,1151846,427307,502800,221739,1151846
2023-04-29 01:29,1151873,427332,502802,221739,1151873
2023-04-29 01:30,1151900,427359,502802,221739,1151900
2023-04-29 01:31,1151928,427386,502803,221739,1151928
2023-04-29 01:32,1151958,427412,502804,221742,1151958
2023-04-29 01:33,1151985,427438,502804,221743,1151985
2023-04-29 01:34,1152012,427460,502808,221744,1152012
2023-04-29 01:35,1152040,427487,502808,221745,1152040
2023-04-29 01:36,1152067,427512,502809,221746,1152067
2023-04-29 01:37,1152094,427538,502809,221747,1152094
2023-04-29 01:38,1152121,427562,502811,221748,1152121
2023-04-29 01:39,1152150,427591,502811,221748,1152150
2023-04-29 01:41,1152177,427616,502813,221748,1152177
2023-04-29 01:42,1152204,427643,502813,221748,1152204
2023-04-29 01:43,1152232,427669,502814,221749,1152232
2023-04-29 01:44,1152258,427695,502814,221749,1152258
2023-04-29 01:45,1152286,427722,502815,221749,1152286
2023-04-29 01:46,1152314,427750,502815,221749,1152314
2023-04-29 01:47,1152342,427775,502818,221749,1152342
2023-04-29 01:48,1152370,427801,502818,221751,1152370
2023-04-29 01:49,1152398,427825,502821,221752,1152398
2023-04-29 01:50,1152425,427852,502821,221752,1152425
2023-04-29 01:51,1152451,427876,502820,221755,1152451
2023-04-29 01:52,1152481,427905,502820,221756,1152481
2023-04-29 01:53,1152508,427933,502820,221755,1152508
2023-04-29 01:54,1152535,427959,502820,221756,1152535
2023-04-29 01:55,1152565,427990,502819,221756,1152565
2023-04-29 01:56,1152592,428014,502819,221759,1152592
2023-04-29 01:57,1152619,428040,502819,221760,1152619
2023-04-29 01:58,1152647,428064,502819,221764,1152647
2023-04-29 01:59,1152674,428089,502820,221765,1152674
2023-04-29 02:00,1152698,428113,502820,221765,1152698
2023-04-29 02:01,1152717,428129,502822,221766,1152717
2023-04-29 02:02,1152737,428148,502822,221767,1152737
2023-04-29 02:03,1152756,428165,502823,221768,1152756
2023-04-29 02:04,1152775,428184,502823,221768,1152775
2023-04-29 02:05,1152796,428204,502823,221769,1152796
2023-04-29 02:06,1152815,428220,502823,221772,1152815
2023-04-29 02:07,1152834,428239,502823,221772,1152834
2023-04-29 02:08,1152854,428256,502823,221775,1152854
2023-04-29 02:09,1152873,428275,502823,221775,1152873
2023-04-29 02:10,1152893,428295,502823,221775,1152893
2023-04-29 02:11,1152911,428310,502823,221778,1152911
2023-04-29 02:12,1152930,428327,502823,221780,1152930
2023-04-29 02:13,1152950,428338,502831,221781,1152950
2023-04-29 02:14,1152969,428357,502831,221781,1152969
2023-04-29 02:15,1152988,428373,502831,221784,1152988
2023-04-29 02:16,1153008,428393,502831,221784,1153008
2023-04-29 02:17,1153027,428412,502831,221784,1153027
2023-04-29 02:18,1153046,428428,502831,221787,1153046
2023-04-29 02:19,1153065,428446,502831,221788,1153065
2023-04-29 02:20,1153085,428464,502831,221790,1153085
2023-04-29 02:21,1153105,428483,502831,221791,1153105
2023-04-29 02:22,1153124,428501,502831,221792,1153124
2023-04-29 02:23,1153143,428512,502838,221793,1153143
2023-04-29 02:24,1153162,428531,502838,221793,1153162
2023-04-29 02:25,1153181,428549,502838,221794,1153181
2023-04-29 02:26,1153201,428567,502838,221796,1153201
2023-04-29 02:27,1153219,428585,502838,221796,1153219
2023-04-29 02:29,1153238,428602,502838,221798,1153238
2023-04-29 02:30,1153257,428621,502838,221798,1153257
2023-04-29 02:31,1153276,428639,502838,221799,1153276
2023-04-29 02:32,1153296,428659,502838,221799,1153296
2023-04-29 02:33,1153314,428677,502838,221799,1153314
2023-04-29 02:34,1153333,428686,502847,221800,1153333
2023-04-29 02:35,1153352,428704,502847,221801,1153352
2023-04-29 02:36,1153373,428722,502847,221804,1153373
2023-04-29 02:37,1153392,428738,502847,221807,1153392
2023-04-29 02:38,1153410,428755,502847,221808,1153410
2023-04-29 02:39,1153430,428773,502847,221810,1153430
2023-04-29 02:40,1153448,428790,502847,221811,1153448
2023-04-29 02:41,1153468,428810,502847,221811,1153468
2023-04-29 02:42,1153487,428829,502847,221811,1153487
2023-04-29 02:43,1153506,428845,502847,221814,1153506
2023-04-29 02:44,1153525,428862,502849,221814,1153525
2023-04-29 02:45,1153543,428878,502849,221816,1153543
2023-04-29 02:46,1153562,428896,502849,221817,1153562
2023-04-29 02:47,1153582,428913,502849,221820,1153582
2023-04-29 02:48,1153601,428932,502849,221820,1153601
2023-04-29 02:49,1153619,428949,502849,221821,1153619
2023-04-29 02:50,1153639,428969,502849,221821,1153639
2023-04-29 02:51,1153658,428988,502849,221821,1153658
2023-04-29 02:52,1153678,429008,502849,221821,1153678
2023-04-29 02:53,1153697,429025,502849,221823,1153697
2023-04-29 02:54,1153715,429038,502853,221824,1153715
2023-04-29 02:55,1153735,429058,502853,221824,1153735
2023-04-29 02:56,1153753,429075,502853,221825,1153753
2023-04-29 02:57,1153773,429095,502853,221825,1153773
2023-04-29 02:58,1153792,429113,502853,221826,1153792
2023-04-29 02:59,1153813,429134,502853,221826,1153813
2023-04-29 03:00,1153834,429154,502853,221827,1153834
2023-04-29 03:01,1153858,429177,502853,221828,1153858
2023-04-29 03:02,1153881,429197,502853,221831,1153881
2023-04-29 03:03,1153906,429222,502853,221831,1153906
2023-04-29 03:04,1153929,429237,502861,221831,1153929
2023-04-29 03:05,1153952,429260,502861,221831,1153952
2023-04-29 03:06,1153976,429284,502861,221831,1153976
2023-04-29 03:07,1154000,429308,502861,221831,1154000
2023-04-29 03:08,1154022,429328,502861,221833,1154022
2023-04-29 03:09,1154046,429352,502861,221833,1154046
2023-04-29 03:10,1154070,429376,502861,221833,1154070
2023-04-29 03:11,1154093,429399,502861,221833,1154093
2023-04-29 03:12,1154118,429424,502861,221833,1154118
2023-04-29 03:13,1154141,429447,502861,221833,1154141
2023-04-29 03:14,1154165,429465,502867,221833,1154165
2023-04-29 03:15,1154189,429488,502867,221834,1154189
2023-04-29 03:17,1154212,429509,502867,221836,1154212
2023-04-29 03:18,1154236,429533,502867,221836,1154236
2023-04-29 03:19,1154259,429553,502869,221837,1154259
2023-04-29 03:20,1154284,429578,502869,221837,1154284
2023-04-29 03:21,1154308,429601,502869,221838,1154308
2023-04-29 03:22,1154330,429622,502869,221839,1154330
2023-04-29 03:23,1154354,429644,502871,221839,1154354
2023-04-29 03:24,1154379,429668,502871,221840,1154379
2023-04-29 03:25,1154401,429690,502871,221840,1154401
2023-04-29 03:26,1154426,429715,502871,221840,1154426
2023-04-29 03:27,1154450,429737,502872,221841,1154450
2023-04-29 03:28,1154472,429759,502872,221841,1154472
2023-04-29 03:29,1154496,429782,502873,221841,1154496
2023-04-29 03:30,1154519,429803,502873,221843,1154519
2023-04-29 03:31,1154544,429828,502873,221843,1154544
2023-04-29 03:32,1154568,429852,502873,221843,1154568
2023-04-29 03:33,1154592,429875,502873,221844,1154592
2023-04-29 03:34,1154616,429898,502873,221845,1154616
2023-04-29 03:35,1154639,429920,502873,221846,1154639
2023-04-29 03:36,1154662,429943,502873,221846,1154662
2023-04-29 03:37,1154686,429965,502874,221847,1154686
2023-04-29 03:38,1154710,429989,502874,221847,1154710
2023-04-29 03:39,1154733,430011,502875,221847,1154733
2023-04-29 03:40,1154757,430035,502875,221847,1154757
2023-04-29 03:41,1154781,430058,502876,221847,1154781
2023-04-29 03:42,1154804,430080,502876,221848,1154804
2023-04-29 03:43,1154827,430101,502878,221848,1154827
2023-04-29 03:44,1154852,430125,502878,221849,1154852
2023-04-29 03:45,1154875,430147,502878,221850,1154875
2023-04-29 03:46,1154899,430170,502878,221851,1154899
2023-04-29 03:47,1154923,430192,502879,221852,1154923
2023-04-29 03:48,1154946,430214,502879,221853,1154946
2023-04-29 03:49,1154969,430237,502879,221853,1154969
2023-04-29 03:50,1154995,430262,502879,221854,1154995
2023-04-29 03:51,1155019,430286,502879,221854,1155019
2023-04-29 03:52,1155042,430309,502879,221854,1155042
2023-04-29 03:53,1155064,430331,502879,221854,1155064
2023-04-29 03:54,1155089,430356,502879,221854,1155089
2023-04-29 03:55,1155112,430375,502880,221857,1155112
2023-04-29 03:56,1155136,430399,502880,221857,1155136
2023-04-29 03:57,1155160,430423,502880,221857,1155160
2023-04-29 03:58,1155183,430446,502880,221857,1155183
2023-04-29 03:59,1155206,430468,502881,221857,1155206
2023-04-29 04:00,1155232,430494,502881,221857,1155232
2023-04-29 04:01,1155258,430520,502881,221857,1155258
2023-04-29 04:03,1155284,430546,502881,221857,1155284
2023-04-29 04:04,1155310,430572,502881,221857,1155310
2023-04-29 04:05,1155337,430599,502881,221857,1155337
2023-04-29 04:06,1155362,430624,502881,221857,1155362
2023-04-29 04:07,1155389,430651,502881,221857,1155389
2023-04-29 04:08,1155415,430677,502881,221857,1155415
2023-04-29 04:09,1155441,430703,502881,221857,1155441
2023-04-29 04:10,1155467,430728,502881,221858,1155467
2023-04-29 04:11,1155493,430749,502886,221858,1155493
2023-04-29 04:12,1155519,430775,502886,221858,1155519
2023-04-29 04:13,1155545,430800,502887,221858,1155545
2023-04-29 04:14,1155572,430827,502887,221858,1155572
2023-04-29 04:15,1155598,430853,502887,221858,1155598
2023-04-29 04:16,1155623,430877,502887,221859,1155623
2023-04-29 04:17,1155650,430904,502887,221859,1155650
2023-04-29 04:18,1155676,430930,502887,221859,1155676
2023-04-29 04:19,1155701,430955,502887,221859,1155701
2023-04-29 04:20,1155728,430982,502887,221859,1155728
2023-04-29 04:21,1155752,431006,502887,221859,1155752
2023-04-29 04:22,1155779,431033,502887,221859,1155779
2023-04-29 04:23,1155805,431059,502887,221859,1155805
2023-04-29 04:24,1155830,431083,502887,221860,1155830
2023-04-29 04:25,1155856,431107,502887,221862,1155856
2023-04-29 04:26,1155884,431135,502887,221862,1155884
2023-04-29 04:27,1155909,431159,502888,221862,1155909
2023-04-29 04:28,1155935,431184,502888,221863,1155935
2023-04-29 04:29,1155960,431208,502888,221864,1155960
2023-04-29 04:30,1155986,431234,502888,221864,1155986
2023-04-29 04:31,1156012,431258,502889,221865,1156012
2023-04-29 04:32,1156039,431285,502889,221865,1156039
2023-04-29 04:33,1156064,431309,502889,221866,1156064
2023-04-29 04:34,1156092,431337,502889,221866,1156092
2023-04-29 04:35,1156117,431361,502890,221866,1156117
2023-04-29 04:36,1156144,431387,502890,221867,1156144
2023-04-29 04:37,1156169,431411,502891,221867,1156169
2023-04-29 04:38,1156194,431437,502891,221866,1156194
2023-04-29 04:39,1156223,431465,502892,221866,1156223
2023-04-29 04:40,1156249,431491,502892,221866,1156249
2023-04-29 04:41,1156273,431513,502894,221866,1156273
2023-04-29 04:42,1156300,431540,502894,221866,1156300
2023-04-29 04:43,1156326,431565,502895,221866,1156326
2023-04-29 04:44,1156351,431589,502895,221867,1156351
2023-04-29 04:45,1156377,431613,502897,221867,1156377
2023-04-29 04:46,1156404,431640,502897,221867,1156404
2023-04-29 04:47,1156429,431663,502898,221868,1156429
2023-04-29 04:48,1156456,431690,502898,221868,1156456
2023-04-29 04:49,1156482,431716,502898,221868,1156482
2023-04-29 04:51,1156508,431742,502898,221868,1156508
2023-04-29 04:52,1156533,431766,502899,221868,1156533
2023-04-29 04:53,1156559,431792,502899,221868,1156559
2023-04-29 04:54,1156586,431819,502899,221868,1156586
2023-04-29 04:55,1156612,431844,502899,221869,1156612
2023-04-29 04:56,1156638,431869,502900,221869,1156638
2023-04-29 04:57,1156665,431896,502900,221869,1156665
2023-04-29 04:58,1156689,431920,502900,221869,1156689
2023-04-29 04:59,1156716,431947,502900,221869,1156716
2023-04-29 05:00,1156743,431973,502901,221869,1156743
2023-04-29 05:01,1156775,432005,502901,221869,1156775
2023-04-29 05:02,1156806,432035,502901,221870,1156806
2023-04-29 05:03,1156837,432066,502901,221870,1156837
2023-04-29 05:04,1156867,432096,502901,221870,1156867
2023-04-29 05:05,1156899,432128,502901,221870,1156899
2023-04-29 05:06,1156931,432160,502901,221870,1156931
2023-04-29 05:07,1156960,432189,502901,221870,1156960
2023-04-29 05:08,1156993,432222,502901,221870,1156993
2023-04-29 05:09,1157023,432252,502901,221870,1157023
2023-04-29 05:10,1157055,432284,502901,221870,1157055
2023-04-29 05:11,1157085,432314,502901,221870,1157085
2023-04-29 05:12,1157118,432347,502901,221870,1157118
2023-04-29 05:13,1157148,432377,502901,221870,1157148
2023-04-29 05:14,1157179,432408,502901,221870,1157179
2023-04-29 05:15,1157209,432438,502901,221870,1157209
2023-04-29 05:16,1157239,432467,502901,221871,1157239
2023-04-29 05:17,1157273,432501,502901,221871,1157273
2023-04-29 05:18,1157302,432529,502901,221872,1157302
2023-04-29 05:19,1157333,432560,502901,221872,1157333
2023-04-29 05:20,1157364,432591,502901,221872,1157364
2023-04-29 05:21,1157396,432622,502901,221873,1157396
2023-04-29 05:22,1157428,432652,502903,221873,1157428
2023-04-29 05:23,1157459,432682,502903,221874,1157459
2023-04-29 05:24,1157490,432713,502903,221874,1157490
2023-04-29 05:25,1157522,432745,502903,221874,1157522
2023-04-29 05:26,1157553,432776,502903,221874,1157553
2023-04-29 05:27,1157582,432805,502903,221874,1157582
2023-04-29 05:28,1157613,432835,502904,221874,1157613
2023-04-29 05:29,1157646,432868,502904,221874,1157646
2023-04-29 05:30,1157675,432897,502904,221874,1157675
2023-04-29 05:31,1157707,432929,502904,221874,1157707
2023-04-29 05:32,1157738,432959,502905,221874,1157738
2023-04-29 05:33,1157770,432991,502905,221874,1157770
2023-04-29 05:34,1157800,433020,502906,221874,1157800
2023-04-29 05:35,1157831,433051,502906,221874,1157831
2023-04-29 05:36,1157864,433084,502906,221874,1157864
2023-04-29 05:38,1157894,433113,502906,221875,1157894
2023-04-29 05:39,1157925,433144,502906,221875,1157925
2023-04-29 05:40,1157956,433175,502906,221875,1157956
2023-04-29 05:41,1157986,433204,502906,221876,1157986
2023-04-29 05:42,1158019,433235,502906,221878,1158019
2023-04-29 05:43,1158048,433262,502907,221879,1158048
2023-04-29 05:44,1158081,433295,502907,221879,1158081
2023-04-29 05:45,1158112,433326,502907,221879,1158112
2023-04-29 05:46,1158143,433357,502907,221879,1158143
2023-04-29 05:47,1158174,433387,502907,221880,1158174
2023-04-29 05:48,1158206,433419,502907,221880,1158206
2023-04-29 05:49,1158237,433450,502907,221880,1158237
2023-04-29 05:50,1158268,433480,502907,221881,1158268
2023-04-29 05:51,1158299,433507,502910,221882,1158299
2023-04-29 05:52,1158330,433538,502910,221882,1158330
2023-04-29 05:53,1158363,433571,502910,221882,1158363
2023-04-29 05:54,1158393,433601,502910,221882,1158393
2023-04-29 05:55,1158424,433628,502911,221885,1158424
2023-04-29 05:56,1158457,433661,502911,221885,1158457
2023-04-29 05:57,1158486,433689,502912,221885,1158486
2023-04-29 05:58,1158518,433721,502912,221885,1158518
2023-04-29 05:59,1158549,433752,502912,221885,1158549
2023-04-29 06:00,1158575,433777,502912,221886,1158575
2023-04-29 06:01,1158598,433800,502912,221886,1158598
2023-04-29 06:02,1158618,433819,502912,221887,1158618
2023-04-29 06:03,1158641,433841,502912,221888,1158641
2023-04-29 06:04,1158661,433860,502912,221889,1158661
2023-04-29 06:05,1158683,433881,502913,221889,1158683
2023-04-29 06:06,1158705,433903,502913,221889,1158705
2023-04-29 06:07,1158726,433924,502913,221889,1158726
2023-04-29 06:08,1158747,433944,502913,221890,1158747
2023-04-29 06:09,1158768,433964,502914,221890,1158768
2023-04-29 06:10,1158790,433985,502914,221891,1158790
2023-04-29 06:11,1158812,434006,502914,221892,1158812
2023-04-29 06:12,1158833,434026,502914,221893,1158833
2023-04-29 06:13,1158856,434048,502914,221894,1158856
2023-04-29 06:14,1158876,434069,502914,221893,1158876
2023-04-29 06:15,1158899,434091,502914,221894,1158899
2023-04-29 06:16,1158920,434112,502914,221894,1158920
2023-04-29 06:17,1158941,434130,502917,221894,1158941
2023-04-29 06:18,1158962,434151,502917,221894,1158962
2023-04-29 06:19,1158983,434170,502919,221894,1158983
2023-04-29 06:20,1159006,434193,502919,221894,1159006
2023-04-29 06:21,1159028,434214,502919,221895,1159028
2023-04-29 06:22,1159050,434235,502919,221896,1159050
2023-04-29 06:23,1159070,434254,502919,221897,1159070
2023-04-29 06:25,1159092,434276,502919,221897,1159092
2023-04-29 06:26,1159113,434295,502921,221897,1159113
2023-04-29 06:27,1159135,434316,502921,221898,1159135
2023-04-29 06:28,1159157,434338,502921,221898,1159157
2023-04-29 06:29,1159178,434359,502921,221898,1159178
2023-04-29 06:30,1159199,434379,502921,221899,1159199
2023-04-29 06:31,1159220,434400,502921,221899,1159220
2023-04-29 06:32,1159243,434423,502921,221899,1159243
2023-04-29 06:33,1159264,434443,502921,221900,1159264
2023-04-29 06:34,1159285,434461,502922,221902,1159285
2023-04-29 06:35,1159306,434480,502922,221904,1159306
2023-04-29 06:36,1159328,434502,502922,221904,1159328
2023-04-29 06:37,1159350,434523,502922,221905,1159350
2023-04-29 06:38,1159372,434545,502922,221905,1159372
2023-04-29 06:39,1159393,434565,502922,221906,1159393
2023-04-29 06:40,1159414,434583,502922,221909,1159414
2023-04-29 06:41,1159435,434603,502922,221910,1159435
2023-04-29 06:42,1159457,434623,502923,221911,1159457
2023-04-29 06:43,1159479,434645,502923,221911,1159479
2023-04-29 06:44,1159501,434666,502924,221911,1159501
2023-04-29 06:45,1159521,434684,502924,221913,1159521
2023-04-29 06:46,1159544,434707,502924,221913,1159544
2023-04-29 06:47,1159565,434726,502924,221915,1159565
2023-04-29 06:48,1159586,434747,502924,221915,1159586
2023-04-29 06:49,1159608,434769,502924,221915,1159608
2023-04-29 06:50,1159629,434790,502924,221915,1159629
2023-04-29 06:51,1159651,434810,502924,221917,1159651
2023-04-29 06:52,1159673,434832,502924,221917,1159673
2023-04-29 06:53,1159694,434851,502924,221919,1159694
2023-04-29 06:54,1159715,434867,502926,221922,1159715
2023-04-29 06:55,1159736,434887,502926,221923,1159736
2023-04-29 06:56,1159759,434908,502927,221924,1159759
2023-04-29 06:57,1159780,434929,502927,221924,1159780
2023-04-29 06:58,1159802,434949,502928,221925,1159802
2023-04-29 06:59,1159823,434969,502928,221926,1159823
2023-04-29 07:00,1159837,434983,502926,221928,1159837
2023-04-29 07:01,1159848,434993,502926,221929,1159848
2023-04-29 07:02,1159860,435002,502927,221931,1159860
2023-04-29 07:03,1159872,435013,502927,221932,1159872
2023-04-29 07:04,1159883,435023,502927,221933,1159883
2023-04-29 07:05,1159894,435032,502927,221935,1159894
2023-04-29 07:06,1159906,435044,502926,221936,1159906
2023-04-29 07:07,1159918,435053,502926,221939,1159918
2023-04-29 07:08,1159929,435059,502931,221939,1159929
2023-04-29 07:09,1159940,435069,502931,221940,1159940
2023-04-29 07:10,1159952,435080,502931,221941,1159952
2023-04-29 07:11,1159963,435091,502931,221941,1159963
2023-04-29 07:13,1159974,435100,502931,221943,1159974
2023-04-29 07:14,1159986,435109,502931,221946,1159986
2023-04-29 07:15,1159996,435117,502933,221946,1159996
2023-04-29 07:16,1160008,435128,502933,221947,1160008
2023-04-29 07:17,1160020,435139,502933,221948,1160020
2023-04-29 07:18,1160031,435148,502933,221950,1160031
2023-04-29 07:19,1160043,435159,502934,221950,1160043
2023-04-29 07:20,1160054,435167,502934,221953,1160054
2023-04-29 07:21,1160065,435177,502934,221954,1160065
2023-04-29 07:22,1160077,435188,502934,221955,1160077
2023-04-29 07:23,1160088,435196,502935,221957,1160088
2023-04-29 07:24,1160100,435207,502935,221958,1160100
2023-04-29 07:25,1160111,435217,502936,221958,1160111
2023-04-29 07:26,1160123,435229,502936,221958,1160123
2023-04-29 07:27,1160135,435240,502937,221958,1160135
2023-04-29 07:28,1160146,435249,502937,221960,1160146
2023-04-29 07:29,1160158,435258,502939,221961,1160158
2023-04-29 07:30,1160168,435268,502939,221961,1160168
2023-04-29 07:31,1160180,435278,502940,221962,1160180
2023-04-29 07:32,1160191,435286,502940,221965,1160191
2023-04-29 07:33,1160202,435293,502942,221967,1160202
2023-04-29 07:34,1160214,435306,502942,221966,1160214
2023-04-29 07:35,1160226,435317,502942,221967,1160226
2023-04-29 07:36,1160237,435328,502942,221967,1160237
2023-04-29 07:37,1160248,435334,502943,221971,1160248
2023-04-29 07:38,1160259,435344,502943,221972,1160259
2023-04-29 07:39,1160270,435353,502944,221973,1160270
2023-04-29 07:40,1160282,435364,502944,221974,1160282
2023-04-29 07:41,1160294,435370,502947,221977,1160294
2023-04-29 07:42,1160305,435380,502948,221977,1160305
2023-04-29 07:43,1160316,435389,502948,221979,1160316
2023-04-29 07:44,1160327,435396,502949,221982,1160327
2023-04-29 07:45,1160338,435406,502949,221983,1160338
2023-04-29 07:46,1160350,435416,502951,221983,1160350
2023-04-29 07:47,1160362,435426,502952,221984,1160362
2023-04-29 07:48,1160374,435437,502952,221985,1160374
2023-04-29 07:49,1160385,435447,502953,221985,1160385
2023-04-29 07:50,1160396,435457,502953,221986,1160396
2023-04-29 07:51,1160407,435462,502956,221989,1160407
2023-04-29 07:52,1160418,435472,502956,221990,1160418
2023-04-29 07:53,1160430,435483,502956,221991,1160430
2023-04-29 07:54,1160441,435493,502956,221992,1160441
2023-04-29 07:55,1160452,435502,502957,221993,1160452
2023-04-29 07:56,1160464,435510,502957,221997,1160464
2023-04-29 07:57,1160475,435517,502958,222000,1160475
2023-04-29 07:58,1160488,435529,502958,222001,1160488
2023-04-29 08:00,1160499,435538,502959,222002,1160499
2023-04-29 08:01,1160521,435560,502959,222002,1160521
2023-04-29 08:02,1160545,435583,502959,222003,1160545
2023-04-29 08:03,1160567,435603,502959,222005,1160567
2023-04-29 08:04,1160591,435627,502959,222005,1160591
2023-04-29 08:05,1160614,435650,502959,222005,1160614
2023-04-29 08:06,1160635,435667,502962,222006,1160635
2023-04-29 08:07,1160658,435686,502962,222010,1160658
2023-04-29 08:08,1160680,435705,502963,222012,1160680
2023-04-29 08:09,1160703,435728,502963,222012,1160703
2023-04-29 08:10,1160725,435750,502963,222012,1160725
2023-04-29 08:11,1160748,435770,502963,222015,1160748
2023-04-29 08:12,1160770,435790,502964,222016,1160770
2023-04-29 08:13,1160792,435809,502964,222019,1160792
2023-04-29 08:14,1160815,435828,502968,222019,1160815
2023-04-29 08:15,1160839,435850,502968,222021,1160839
2023-04-29 08:16,1160860,435869,502969,222022,1160860
2023-04-29 08:17,1160883,435892,502969,222022,1160883
2023-04-29 08:18,1160905,435911,502971,222023,1160905
2023-04-29 08:19,1160927,435933,502971,222023,1160927
2023-04-29 08:20,1160951,435952,502974,222025,1160951
2023-04-29 08:21,1160973,435972,502974,222027,1160973
2023-04-29 08:22,1160995,435991,502976,222028,1160995
2023-04-29 08:23,1161017,436012,502976,222029,1161017
2023-04-29 08:24,1161041,436032,502978,222031,1161041
2023-04-29 08:25,1161064,436052,502978,222034,1161064
2023-04-29 08:26,1161087,436074,502979,222034,1161087
2023-04-29 08:27,1161109,436094,502979,222036,1161109
2023-04-29 08:28,1161132,436113,502983,222036,1161132
2023-04-29 08:29,1161155,436134,502983,222038,1161155
2023-04-29 08:30,1161178,436153,502986,222039,1161178
2023-04-29 08:31,1161199,436169,502986,222044,1161199
2023-04-29 08:32,1161222,436186,502990,222046,1161222
2023-04-29 08:33,1161246,436207,502990,222049,1161246
2023-04-29 08:34,1161267,436225,502992,222050,1161267
2023-04-29 08:35,1161291,436248,502992,222051,1161291
2023-04-29 08:36,1161313,436263,502994,222056,1161313
2023-04-29 08:37,1161335,436280,502994,222061,1161335
2023-04-29 08:38,1161358,436302,502995,222061,1161358
2023-04-29 08:39,1161381,436320,502995,222066,1161381
2023-04-29 08:40,1161402,436335,502998,222069,1161402
2023-04-29 08:41,1161425,436358,502998,222069,1161425
2023-04-29 08:42,1161447,436372,503003,222072,1161447
2023-04-29 08:43,1161472,436395,503003,222074,1161472
2023-04-29 08:44,1161494,436412,503007,222075,1161494
2023-04-29 08:45,1161518,436434,503007,222077,1161518
2023-04-29 08:46,1161541,436452,503012,222077,1161541
2023-04-29 08:48,1161564,436473,503012,222079,1161564
2023-04-29 08:49,1161587,436495,503012,222080,1161587
2023-04-29 08:50,1161609,436517,503012,222080,1161609
2023-04-29 08:51,1161632,436540,503012,222080,1161632
2023-04-29 08:52,1161655,436559,503012,222084,1161655
2023-04-29 08:53,1161677,436575,503016,222086,1161677
2023-04-29 08:54,1161700,436594,503016,222090,1161700
2023-04-29 08:55,1161722,436612,503016,222094,1161722
2023-04-29 08:56,1161745,436633,503016,222096,1161745
2023-04-29 08:57,1161767,436653,503018,222096,1161767
2023-04-29 08:58,1161789,436675,503018,222096,1161789
2023-04-29 08:59,1161812,436695,503021,222096,1161812
2023-04-29 09:00,1161835,436717,503021,222097,1161835
2023-04-29 09:01,1161860,436738,503023,222099,1161860
2023-04-29 09:02,1161883,436760,503023,222100,1161883
2023-04-29 09:03,1161908,436777,503026,222105,1161908
2023-04-29 09:04,1161932,436799,503026,222107,1161932
2023-04-29 09:05,1161957,436822,503027,222108,1161957
2023-04-29 09:06,1161982,436845,503027,222110,1161982
2023-04-29 09:07,1162007,436866,503030,222111,1162007
2023-04-29 09:08,1162032,436891,503030,222111,1162032
2023-04-29 09:09,1162056,436908,503035,222113,1162056
2023-04-29 09:10,1162080,436928,503035,222117,1162080
2023-04-29 09:11,1162104,436948,503037,222119,1162104
2023-04-29 09:12,1162130,436973,503037,222120,1162130
2023-04-29 09:13,1162153,436989,503041,222123,1162153
2023-04-29 09:14,1162179,437010,503041,222128,1162179
2023-04-29 09:15,1162203,437029,503043,222131,1162203
2023-04-29 09:16,1162228,437051,503043,222134,1162228
2023-04-29 09:17,1162252,437068,503047,222137,1162252
2023-04-29 09:18,1162277,437088,503047,222142,1162277
2023-04-29 09:19,1162303,437110,503048,222145,1162303
2023-04-29 09:20,1162327,437134,503048,222145,1162327
2023-04-29 09:21,1162352,437153,503050,222149,1162352
2023-04-29 09:22,1162376,437173,503051,222152,1162376
2023-04-29 09:23,1162400,437197,503051,222152,1162400
2023-04-29 09:24,1162426,437217,503057,222152,1162426
2023-04-29 09:25,1162450,437238,503057,222155,1162450
2023-04-29 09:26,1162478,437265,503059,222154,1162478
2023-04-29 09:27,1162501,437286,503059,222156,1162501
2023-04-29 09:28,1162527,437309,503060,222158,1162527
2023-04-29 09:29,1162552,437332,503060,222160,1162552
2023-04-29 09:30,1162575,437348,503067,222160,1162575
2023-04-29 09:31,1162600,437372,503067,222161,1162600
2023-04-29 09:32,1162626,437394,503069,222163,1162626
2023-04-29 09:33,1162650,437414,503069,222167,1162650
2023-04-29 09:34,1162675,437435,503070,222170,1162675
2023-04-29 09:36,1162698,437456,503071,222171,1162698
2023-04-29 09:37,1162724,437479,503072,222173,1162724
2023-04-29 09:38,1162749,437502,503072,222175,1162749
2023-04-29 09:39,1162773,437522,503075,222176,1162773
2023-04-29 09:40,1162798,437543,503075,222180,1162798
2023-04-29 09:41,1162824,437564,503079,222181,1162824
2023-04-29 09:42,1162849,437588,503079,222182,1162849
2023-04-29 09:43,1162872,437605,503081,222186,1162872
2023-04-29 09:44,1162897,437629,503082,222186,1162897
2023-04-29 09:45,1162922,437653,503082,222187,1162922
2023-04-29 09:46,1162946,437670,503088,222188,1162946
2023-04-29 09:47,1162970,437692,503088,222190,1162970
2023-04-29 09:48,1162995,437712,503090,222193,1162995
2023-04-29 09:49,1163019,437732,503090,222197,1163019
2023-04-29 09:50,1163044,437750,503093,222201,1163044
2023-04-29 09:51,1163070,437776,503093,222201,1163070
2023-04-29 09:52,1163094,437798,503097,222199,1163094
2023-04-29 09:53,1163118,437820,503097,222201,1163118
2023-04-29 09:54,1163144,437843,503099,222202,1163144
2023-04-29 09:55,1163167,437864,503099,222204,1163167
2023-04-29 09:56,1163193,437886,503099,222208,1163193
2023-04-29 09:57,1163218,437909,503099,222210,1163218
2023-04-29 09:58,1163241,437928,503099,222214,1163241
2023-04-29 09:59,1163266,437952,503100,222214,1163266
2023-04-29 10:00,1163293,437974,503102,222217,1163293
2023-04-29 10:01,1163320,437999,503102,222219,1163320
2023-04-29 10:02,1163346,438019,503108,222219,1163346
2023-04-29 10:03,1163374,438044,503108,222222,1163374
2023-04-29 10:04,1163403,438063,503114,222226,1163403
2023-04-29 10:05,1163430,438085,503117,222228,1163430
2023-04-29 10:06,1163457,438111,503117,222229,1163457
2023-04-29 10:07,1163484,438133,503118,222233,1163484
2023-04-29 10:08,1163513,438158,503118,222237,1163513
2023-04-29 10:09,1163540,438181,503120,222239,1163540
2023-04-29 10:10,1163567,438208,503120,222239,1163567
2023-04-29 10:11,1163594,438227,503124,222243,1163594
2023-04-29 10:12,1163622,438255,503124,222243,1163622
2023-04-29 10:13,1163649,438276,503127,222246,1163649
2023-04-29 10:14,1163675,438299,503127,222249,1163675
2023-04-29 10:15,1163703,438322,503127,222254,1163703
2023-04-29 10:16,1163733,438350,503127,222256,1163733
2023-04-29 10:17,1163761,438376,503128,222257,1163761
2023-04-29 10:18,1163786,438400,503128,222258,1163786
2023-04-29 10:19,1163816,438426,503132,222258,1163816
2023-04-29 10:20,1163843,438451,503132,222260,1163843
2023-04-29 10:21,1163870,438471,503136,222263,1163870
2023-04-29 10:22,1163898,438495,503136,222267,1163898
2023-04-29 10:24,1163925,438519,503137,222269,1163925
2023-04-29 10:25,1163953,438546,503137,222270,1163953
2023-04-29 10:26,1163980,438568,503139,222273,1163980
2023-04-29 10:27,1164007,438593,503139,222275,1164007
2023-04-29 10:28,1164035,438616,503141,222278,1164035
2023-04-29 10:29,1164062,438638,503141,222283,1164062
2023-04-29 10:30,1164090,438659,503144,222287,1164090
2023-04-29 10:31,1164117,438683,503144,222290,1164117
2023-04-29 10:32,1164144,438705,503147,222292,1164144
2023-04-29 10:33,1164171,438730,503147,222294,1164171
2023-04-29 10:34,1164198,438756,503147,222295,1164198
2023-04-29 10:35,1164225,438779,503147,222299,1164225
2023-04-29 10:36,1164252,438801,503151,222300,1164252
2023-04-29 10:37,1164280,438827,503153,222300,1164280
2023-04-29 10:38,1164308,438854,503153,222301,1164308
2023-04-29 10:39,1164335,438875,503157,222303,1164335
2023-04-29 10:40,1164363,438900,503157,222306,1164363
2023-04-29 10:41,1164391,438922,503161,222308,1164391
2023-04-29 10:42,1164418,438947,503161,222310,1164418
2023-04-29 10:43,1164445,438971,503162,222312,1164445
2023-04-29 10:44,1164473,438996,503162,222315,1164473
2023-04-29 10:45,1164501,439019,503166,222316,1164501
2023-04-29 10:46,1164528,439045,503166,222317,1164528
2023-04-29 10:47,1164557,439070,503170,222317,1164557
2023-04-29 10:48,1164585,439096,503170,222319,1164585
2023-04-29 10:49,1164612,439113,503176,222323,1164612
2023-04-29 10:50,1164639,439136,503176,222327,1164639
2023-04-29 10:51,1164667,439159,503179,222329,1164667
2023-04-29 10:52,1164694,439180,503181,222333,1164694
2023-04-29 10:53,1164721,439198,503185,222338,1164721
2023-04-29 10:54,1164750,439223,503185,222342,1164750
2023-04-29 10:55,1164778,439249,503186,222343,1164778
2023-04-29 10:56,1164805,439276,503186,222343,1164805
2023-04-29 10:57,1164831,439299,503187,222345,1164831
2023-04-29 10:58,1164858,439324,503187,222347,1164858
2023-04-29 10:59,1164887,439345,503188,222354,1164887
2023-04-29 11:00,1164907,439364,503188,222355,1164907
2023-04-29 11:01,1164923,439373,503192,222358,1164923
2023-04-29 11:02,1164939,439388,503192,222359,1164939
2023-04-29 11:03,1164956,439394,503196,222366,1164956
2023-04-29 11:04,1164972,439408,503196,222368,1164972
2023-04-29 11:05,1164989,439423,503197,222369,1164989
2023-04-29 11:06,1165006,439437,503197,222372,1165006
2023-04-29 11:07,1165023,439451,503199,222373,1165023
2023-04-29 11:08,1165039,439463,503199,222377,1165039
2023-04-29 11:09,1165057,439476,503202,222379,1165057
2023-04-29 11:11,1165075,439493,503202,222380,1165075
2023-04-29 11:12,1165091,439501,503206,222384,1165091
2023-04-29 11:13,1165108,439516,503206,222386,1165108
2023-04-29 11:14,1165125,439526,503213,222386,1165125
2023-04-29 11:15,1165141,439539,503213,222389,1165141
2023-04-29 11:16,1165158,439548,503216,222394,1165158
2023-04-29 11:17,1165174,439563,503216,222395,1165174
2023-04-29 11:18,1165190,439570,503222,222398,1165190
2023-04-29 11:19,1165207,439584,503222,222401,1165207
2023-04-29 11:20,1165224,439596,503222,222406,1165224
2023-04-29 11:21,1165240,439607,503222,222411,1165240
2023-04-29 11:22,1165256,439618,503224,222414,1165256
2023-04-29 11:23,1165273,439632,503224,222417,1165273
2023-04-29 11:24,1165290,439646,503225,222419,1165290
2023-04-29 11:25,1165307,439661,503225,222421,1165307
2023-04-29 11:26,1165323,439674,503225,222424,1165323
2023-04-29 11:27,1165339,439687,503225,222427,1165339
2023-04-29 11:28,1165356,439697,503229,222430,1165356
2023-04-29 11:29,1165371,439710,503230,222431,1165371
2023-04-29 11:30,1165389,439725,503230,222434,1165389
2023-04-29 11:31,1165404,439735,503232,222437,1165404
2023-04-29 11:32,1165421,439746,503232,222443,1165421
2023-04-29 11:33,1165437,439753,503236,222448,1165437
2023-04-29 11:34,1165453,439769,503236,222448,1165453
2023-04-29 11:35,1165469,439773,503240,222456,1165469
2023-04-29 11:36,1165486,439786,503240,222460,1165486
2023-04-29 11:37,1165502,439796,503243,222463,1165502
2023-04-29 11:38,1165520,439810,503243,222467,1165520
2023-04-29 11:39,1165537,439821,503247,222469,1165537
2023-04-29 11:40,1165553,439828,503247,222478,1165553
2023-04-29 11:41,1165569,439838,503251,222480,1165569
2023-04-29 11:42,1165585,439849,503251,222485,1165585
2023-04-29 11:43,1165604,439860,503253,222491,1165604
2023-04-29 11:44,1165620,439874,503253,222493,1165620
2023-04-29 11:45,1165637,439886,503257,222494,1165637
2023-04-29 11:46,1165655,439902,503257,222496,1165655
2023-04-29 11:47,1165671,439912,503258,222501,1165671
2023-04-29 11:48,1165687,439925,503258,222504,1165687
2023-04-29 11:49,1165704,439933,503260,222511,1165704
2023-04-29 11:50,1165720,439944,503260,222516,1165720
2023-04-29 11:51,1165737,439955,503265,222517,1165737
2023-04-29 11:52,1165752,439967,503265,222520,1165752
2023-04-29 11:53,1165769,439976,503269,222524,1165769
2023-04-29 11:54,1165786,439992,503269,222525,1165786
2023-04-29 11:55,1165803,440000,503272,222531,1165803
2023-04-29 11:56,1165820,440013,503272,222535,1165820
2023-04-29 11:57,1165837,440028,503274,222535,1165837
2023-04-29 11:59,1165853,440040,503274,222539,1165853
2023-04-29 12:00,1165869,440052,503276,222541,1165869
2023-04-29 12:01,1165889,440069,503276,222544,1165889
2023-04-29 12:02,1165909,440081,503279,222549,1165909
2023-04-29 12:03,1165931,440100,503279,222552,1165931
2023-04-29 12:04,1165951,440115,503281,222555,1165951
2023-04-29 12:05,1165972,440135,503281,222556,1165972
2023-04-29 12:06,1165993,440151,503283,222559,1165993
2023-04-29 12:07,1166014,440166,503283,222565,1166014
2023-04-29 12:08,1166034,440183,503284,222567,1166034
2023-04-29 12:09,1166054,440200,503284,222570,1166054
2023-04-29 12:10,1166075,440212,503290,222573,1166075
2023-04-29 12:11,1166096,440228,503290,222578,1166096
2023-04-29 12:12,1166116,440244,503293,222579,1166116
2023-04-29 12:13,1166138,440263,503293,222582,1166138
2023-04-29 12:14,1166157,440274,503295,222588,1166157
2023-04-29 12:15,1166179,440295,503295,222589,1166179
2023-04-29 12:16,1166199,440307,503297,222595,1166199
2023-04-29 12:17,1166221,440327,503297,222597,1166221
2023-04-29 12:18,1166241,440340,503300,222601,1166241
2023-04-29 12:19,1166263,440355,503301,222607,1166263
2023-04-29 12:20,1166283,440372,503301,222610,1166283
2023-04-29 12:21,1166303,440387,503306,222610,1166303
2023-04-29 12:22,1166326,440407,503306,222613,1166326
2023-04-29 12:23,1166347,440420,503311,222616,1166347
2023-04-29 12:24,1166367,440440,503311,222616,1166367
2023-04-29 12:25,1166387,440454,503313,222620,1166387
2023-04-29 12:26,1166408,440475,503313,222620,1166408
2023-04-29 12:27,1166429,440492,503316,222621,1166429
2023-04-29 12:28,1166449,440506,503316,222627,1166449
2023-04-29 12:29,1166471,440520,503320,222631,1166471
2023-04-29 12:30,1166491,440540,503320,222631,1166491
2023-04-29 12:31,1166511,440555,503324,222632,1166511
2023-04-29 12:32,1166532,440573,503324,222635,1166532
2023-04-29 12:33,1166552,440584,503326,222642,1166552
2023-04-29 12:34,1166572,440604,503326,222642,1166572
2023-04-29 12:35,1166594,440617,503331,222646,1166594
2023-04-29 12:36,1166614,440635,503331,222648,1166614
2023-04-29 12:37,1166635,440650,503332,222653,1166635
2023-04-29 12:38,1166655,440667,503332,222656,1166655
2023-04-29 12:39,1166676,440678,503337,222661,1166676
2023-04-29 12:40,1166697,440693,503337,222667,1166697
2023-04-29 12:41,1166717,440709,503339,222669,1166717
2023-04-29 12:42,1166739,440728,503339,222672,1166739
2023-04-29 12:43,1166759,440747,503340,222672,1166759
2023-04-29 12:44,1166780,440765,503340,222675,1166780
2023-04-29 12:46,1166801,440781,503342,222678,1166801
2023-04-29 12:47,1166822,440800,503342,222680,1166822
2023-04-29 12:48,1166843,440821,503342,222680,1166843
2023-04-29 12:49,1166863,440838,503342,222683,1166863
2023-04-29 12:50,1166884,440855,503344,222685,1166884
2023-04-29 12:51,1166905,440876,503344,222685,1166905
2023-04-29 12:52,1166925,440896,503344,222685,1166925
2023-04-29 12:53,1166946,440912,503344,222690,1166946
2023-04-29 12:54,1166966,440932,503344,222690,1166966
2023-04-29 12:55,1166987,440949,503344,222694,1166987
2023-04-29 12:56,1167007,440966,503344,222697,1167007
2023-04-29 12:57,1167028,440983,503344,222701,1167028
2023-04-29 12:58,1167049,441002,503344,222703,1167049
2023-04-29 12:59,1167068,441009,503353,222706,1167068
2023-04-29 13:00,1167092,441030,503353,222709,1167092
2023-04-29 13:01,1167121,441051,503359,222711,1167121
2023-04-29 13:02,1167148,441075,503359,222714,1167148
2023-04-29 13:03,1167176,441095,503364,222717,1167176
2023-04-29 13:04,1167207,441125,503364,222718,1167207
2023-04-29 13:05,1167233,441147,503367,222719,1167233
2023-04-29 13:06,1167264,441177,503367,222720,1167264
2023-04-29 13:07,1167292,441203,503369,222720,1167292
2023-04-29 13:08,1167319,441226,503369,222724,1167319
2023-04-29 13:09,1167349,441250,503372,222727,1167349
2023-04-29 13:10,1167379,441276,503372,222731,1167379
2023-04-29 13:11,1167409,441298,503376,222735,1167409
2023-04-29 13:12,1167437,441324,503376,222737,1167437
2023-04-29 13:13,1167466,441347,503379,222740,1167466
2023-04-29 13:14,1167494,441371,503379,222744,1167494
2023-04-29 13:15,1167524,441396,503382,222746,1167524
2023-04-29 13:16,1167553,441423,503382,222748,1167553
2023-04-29 13:17,1167580,441446,503384,222750,1167580
2023-04-29 13:18,1167612,441472,503387,222753,1167612
2023-04-29 13:19,1167641,441499,503387,222755,1167641
2023-04-29 13:20,1167669,441522,503390,222757,1167669
2023-04-29 13:21,1167697,441546,503390,222761,1167697
2023-04-29 13:22,1167726,441563,503398,222765,1167726
2023-04-29 13:23,1167754,441587,503398,222769,1167754
2023-04-29 13:24,1167783,441610,503403,222770,1167783
2023-04-29 13:25,1167812,441637,503403,222772,1167812
2023-04-29 13:26,1167840,441656,503408,222776,1167840
2023-04-29 13:27,1167868,441682,503408,222778,1167868
2023-04-29 13:28,1167896,441702,503411,222783,1167896
2023-04-29 13:29,1167926,441732,503411,222783,1167926
2023-04-29 13:30,1167953,441753,503416,222784,1167953
2023-04-29 13:31,1167983,441780,503417,222786,1167983
2023-04-29 13:33,1168010,441803,503417,222790,1168010
2023-04-29 13:34,1168039,441832,503417,222790,1168039
2023-04-29 13:35,1168068,441859,503417,222792,1168068
2023-04-29 13:36,1168096,441885,503417,222794,1168096
2023-04-29 13:37,1168124,441911,503417,222796,1168124
2023-04-29 13:38,1168154,441937,503417,222800,1168154
2023-04-29 13:39,1168181,441961,503417,222803,1168181
2023-04-29 13:40,1168212,441990,503417,222805,1168212
2023-04-29 13:41,1168240,442005,503428,222807,1168240
2023-04-29 13:42,1168269,442032,503428,222809,1168269
2023-04-29 13:43,1168298,442056,503431,222811,1168298
2023-04-29 13:44,1168327,442083,503431,222813,1168327
2023-04-29 13:45,1168354,442106,503432,222816,1168354
2023-04-29 13:46,1168383,442130,503432,222821,1168383
2023-04-29 13:47,1168411,442156,503434,222821,1168411
2023-04-29 13:48,1168440,442183,503434,222823,1168440
2023-04-29 13:49,1168469,442210,503436,222823,1168469
2023-04-29 13:50,1168496,442234,503436,222826,1168496
2023-04-29 13:51,1168527,442262,503438,222827,1168527
2023-04-29 13:52,1168553,442287,503438,222828,1168553
2023-04-29 13:53,1168583,442312,503441,222830,1168583
2023-04-29 13:54,1168611,442338,503441,222832,1168611
2023-04-29 13:55,1168638,442361,503442,222835,1168638
2023-04-29 13:56,1168667,442386,503442,222839,1168667
2023-04-29 13:57,1168698,442412,503446,222840,1168698
2023-04-29 13:58,1168724,442432,503446,222846,1168724
2023-04-29 13:59,1168753,442459,503447,222847,1168753
2023-04-29 14:00,1168780,442486,503447,222847,1168780
2023-04-29 14:01,1168808,442509,503450,222849,1168808
2023-04-29 14:02,1168835,442532,503452,222851,1168835
2023-04-29 14:03,1168860,442550,503452,222858,1168860
2023-04-29 14:04,1168888,442572,503458,222858,1168888
2023-04-29 14:05,1168914,442597,503458,222859,1168914
2023-04-29 14:06,1168941,442619,503459,222863,1168941
2023-04-29 14:07,1168966,442638,503459,222869,1168966
2023-04-29 14:08,1168992,442658,503461,222873,1168992
2023-04-29 14:09,1169020,442682,503461,222877,1169020
2023-04-29 14:10,1169047,442706,503462,222879,1169047
2023-04-29 14:11,1169073,442728,503462,222883,1169073
2023-04-29 14:12,1169100,442746,503464,222890,1169100
2023-04-29 14:13,1169125,442771,503464,222890,1169125
2023-04-29 14:14,1169153,442792,503469,222892,1169153
2023-04-29 14:15,1169178,442811,503469,222898,1169178
2023-04-29 14:16,1169205,442833,503472,222900,1169205
2023-04-29 14:17,1169231,442856,503472,222903,1169231
2023-04-29 14:19,1169259,442878,503477,222904,1169259
2023-04-29 14:20,1169285,442900,503477,222908,1169285
2023-04-29 14:21,1169313,442922,503480,222911,1169313
2023-04-29 14:22,1169338,442944,503480,222914,1169338
2023-04-29 14:23,1169366,442963,503486,222917,1169366
2023-04-29 14:24,1169392,442987,503486,222919,1169392
2023-04-29 14:25,1169418,443003,503493,222922,1169418
2023-04-29 14:26,1169444,443028,503493,222923,1169444
2023-04-29 14:27,1169472,443050,503496,222926,1169472
2023-04-29 14:28,1169498,443075,503496,222927,1169498
2023-04-29 14:29,1169524,443096,503498,222930,1169524
2023-04-29 14:30,1169550,443120,503498,222932,1169550
2023-04-29 14:31,1169578,443144,503500,222934,1169578
2023-04-29 14:32,1169606,443170,503500,222936,1169606
2023-04-29 14:33,1169632,443193,503502,222937,1169632
2023-04-29 14:34,1169658,443217,503502,222939,1169658
2023-04-29 14:35,1169685,443242,503503,222940,1169685
2023-04-29 14:36,1169710,443264,503503,222943,1169710
2023-04-29 14:37,1169738,443288,503506,222944,1169738
2023-04-29 14:38,1169765,443313,503506,222946,1169765
2023-04-29 14:39,1169791,443330,503511,222950,1169791
2023-04-29 14:40,1169819,443352,503515,222952,1169819
2023-04-29 14:41,1169845,443377,503515,222953,1169845
2023-04-29 14:42,1169870,443391,503525,222954,1169870
2023-04-29 14:43,1169898,443414,503525,222959,1169898
2023-04-29 14:44,1169924,443437,503527,222960,1169924
2023-04-29 14:45,1169952,443462,503527,222963,1169952
2023-04-29 14:46,1169977,443482,503530,222965,1169977
2023-04-29 14:47,1170004,443504,503530,222970,1170004
2023-04-29 14:48,1170031,443527,503532,222972,1170031
2023-04-29 14:49,1170058,443554,503532,222972,1170058
2023-04-29 14:50,1170085,443580,503532,222973,1170085
2023-04-29 14:51,1170111,443601,503532,222978,1170111
2023-04-29 14:52,1170136,443623,503532,222981,1170136
2023-04-29 14:53,1170163,443650,503532,222981,1170163
2023-04-29 14:54,1170191,443674,503532,222985,1170191
2023-04-29 14:55,1170216,443698,503532,222986,1170216
2023-04-29 14:56,1170243,443724,503532,222987,1170243
2023-04-29 14:57,1170269,443747,503532,222990,1170269
2023-04-29 14:58,1170297,443762,503541,222994,1170297
2023-04-29 14:59,1170323,443783,503541,222999,1170323
2023-04-29 15:00,1170352,443809,503541,223002,1170352
2023-04-29 15:01,1170380,443835,503541,223004,1170380
2023-04-29 15:02,1170407,443857,503541,223009,1170407
2023-04-29 15:03,1170437,443887,503541,223009,1170437
2023-04-29 15:04,1170465,443913,503541,223011,1170465
2023-04-29 15:05,1170493,443937,503541,223015,1170493
2023-04-29 15:07,1170522,443961,503541,223020,1170522
2023-04-29 15:08,1170550,443986,503541,223023,1170550
2023-04-29 15:09,1170580,443996,503557,223027,1170580
2023-04-29 15:10,1170608,444021,503557,223030,1170608
2023-04-29 15:11,1170635,444045,503557,223033,1170635
2023-04-29 15:12,1170663,444072,503557,223034,1170663
2023-04-29 15:13,1170692,444099,503557,223036,1170692
2023-04-29 15:14,1170721,444126,503557,223038,1170721
2023-04-29 15:15,1170749,444152,503557,223040,1170749
2023-04-29 15:16,1170779,444180,503557,223042,1170779
2023-04-29 15:17,1170808,444208,503557,223043,1170808
2023-04-29 15:18,1170834,444233,503557,223044,1170834
2023-04-29 15:19,1170864,444247,503570,223047,1170864
2023-04-29 15:20,1170893,444270,503570,223053,1170893
2023-04-29 15:21,1170920,444293,503570,223057,1170920
2023-04-29 15:22,1170948,444317,503570,223061,1170948
2023-04-29 15:23,1170977,444342,503570,223065,1170977
2023-04-29 15:24,1171005,444368,503570,223067,1171005
2023-04-29 15:25,1171032,444394,503570,223068,1171032
2023-04-29 15:26,1171060,444414,503574,223072,1171060
2023-04-29 15:27,1171089,444441,503574,223074,1171089
2023-04-29 15:28,1171119,444465,503578,223076,1171119
2023-04-29 15:29,1171146,444489,503578,223079,1171146
2023-04-29 15:30,1171174,444516,503579,223079,1171174
2023-04-29 15:31,1171202,444537,503579,223086,1171202
2023-04-29 15:32,1171231,444561,503582,223088,1171231
2023-04-29 15:33,1171262,444591,503582,223089,1171262
2023-04-29 15:34,1171291,444616,503584,223091,1171291
2023-04-29 15:35,1171318,444641,503584,223093,1171318
2023-04-29 15:36,1171348,444664,503588,223096,1171348
2023-04-29 15:37,1171377,444691,503588,223098,1171377
2023-04-29 15:38,1171405,444713,503594,223098,1171405
2023-04-29 15:39,1171433,444737,503597,223099,1171433
2023-04-29 15:40,1171461,444765,503597,223099,1171461
2023-04-29 15:41,1171490,444785,503602,223103,1171490
2023-04-29 15:42,1171519,444812,503602,223105,1171519
2023-04-29 15:43,1171547,444833,503606,223108,1171547
2023-04-29 15:44,1171575,444856,503606,223113,1171575
2023-04-29 15:45,1171605,444884,503608,223113,1171605
2023-04-29 15:46,1171633,444910,503608,223115,1171633
2023-04-29 15:47,1171662,444936,503609,223117,1171662
2023-04-29 15:48,1171689,444962,503609,223118,1171689
2023-04-29 15:49,1171718,444983,503612,223123,1171718
2023-04-29 15:50,1171747,445009,503613,223125,1171747
2023-04-29 15:51,1171776,445034,503614,223128,1171776
2023-04-29 15:52,1171804,445056,503617,223131,1171804
2023-04-29 15:54,1171833,445080,503617,223136,1171833
2023-04-29 15:55,1171860,445098,503624,223138,1171860
2023-04-29 15:56,1171888,445121,503626,223141,1171888
2023-04-29 15:57,1171917,445147,503626,223144,1171917
2023-04-29 15:58,1171944,445171,503629,223144,1171944
2023-04-29 15:59,1171973,445200,503629,223144,1171973
2023-04-29 16:00,1172000,445223,503631,223146,1172000
2023-04-29 16:01,1172006,445226,503631,223149,1172006
2023-04-29 16:02,1172012,445229,503631,223152,1172012
2023-04-29 16:03,1172019,445234,503631,223154,1172019
2023-04-29 16:04,1172025,445227,503643,223155,1172025
2023-04-29 16:05,1172032,445233,503643,223156,1172032
2023-04-29 16:06,1172038,445236,503643,223159,1172038
2023-04-29 16:07,1172045,445241,503643,223161,1172045
2023-04-29 16:08,1172051,445237,503648,223166,1172051
2023-04-29 16:09,1172058,445244,503648,223166,1172058
2023-04-29 16:10,1172064,445240,503652,223172,1172064
2023-04-29 16:11,1172070,445246,503652,223172,1172070
2023-04-29 16:12,1172076,445249,503654,223173,1172076
2023-04-29 16:13,1172083,445253,503654,223176,1172083
2023-04-29 16:14,1172090,445255,503656,223179,1172090
2023-04-29 16:15,1172096,445259,503656,223181,1172096
2023-04-29 16:16,1172102,445259,503662,223181,1172102
2023-04-29 16:17,1172109,445259,503665,223185,1172109
2023-04-29 16:18,1172115,445263,503665,223187,1172115
2023-04-29 16:19,1172122,445264,503670,223188,1172122
2023-04-29 16:20,1172129,445269,503670,223190,1172129
2023-04-29 16:21,1172135,445273,503670,223192,1172135
2023-04-29 16:22,1172141,445270,503676,223195,1172141
2023-04-29 16:23,1172148,445275,503677,223196,1172148
2023-04-29 16:24,1172154,445277,503677,223200,1172154
2023-04-29 16:25,1172161,445276,503683,223202,1172161
2023-04-29 16:26,1172167,445279,503684,223204,1172167
2023-04-29 16:27,1172173,445283,503684,223206,1172173
2023-04-29 16:28,1172180,445286,503687,223207,1172180
2023-04-29 16:29,1172186,445290,503687,223209,1172186
2023-04-29 16:30,1172194,445290,503692,223212,1172194
2023-04-29 16:31,1172200,445291,503693,223216,1172200
2023-04-29 16:32,1172206,445296,503693,223217,1172206
2023-04-29 16:33,1172212,445296,503696,223220,1172212
2023-04-29 16:34,1172219,445302,503696,223221,1172219
2023-04-29 16:35,1172226,445306,503699,223221,1172226
2023-04-29 16:36,1172232,445309,503699,223224,1172232
2023-04-29 16:37,1172239,445312,503700,223227,1172239
2023-04-29 16:38,1172246,445317,503700,223229,1172246
2023-04-29 16:39,1172252,445319,503704,223229,1172252
2023-04-29 16:40,1172258,445320,503704,223234,1172258
2023-04-29 16:42,1172265,445320,503710,223235,1172265
2023-04-29 16:43,1172271,445325,503710,223236,1172271
2023-04-29 16:44,1172278,445325,503715,223238,1172278
2023-04-29 16:45,1172285,445329,503715,223241,1172285
2023-04-29 16:46,1172292,445329,503720,223243,1172292
2023-04-29 16:47,1172299,445330,503722,223247,1172299
2023-04-29 16:48,1172306,445336,503722,223248,1172306
2023-04-29 16:49,1172312,445337,503727,223248,1172312
2023-04-29 16:50,1172319,445342,503727,223250,1172319
2023-04-29 16:51,1172327,445349,503727,223251,1172327
2023-04-29 16:52,1172333,445352,503727,223254,1172333
2023-04-29 16:53,1172340,445355,503729,223256,1172340
2023-04-29 16:54,1172346,445359,503729,223258,1172346
2023-04-29 16:55,1172353,445363,503729,223261,1172353
2023-04-29 16:56,1172359,445363,503729,223267,1172359
2023-04-29 16:57,1172365,445361,503733,223271,1172365
2023-04-29 16:58,1172372,445365,503733,223274,1172372
2023-04-29 16:59,1172378,445365,503738,223275,1172378
2023-04-29 17:00,1172396,445379,503738,223279,1172396
2023-04-29 17:01,1172429,445404,503742,223283,1172429
2023-04-29 17:02,1172463,445432,503747,223284,1172463
2023-04-29 17:03,1172497,445465,503747,223285,1172497
2023-04-29 17:04,1172533,445492,503753,223288,1172533
2023-04-29 17:05,1172568,445525,503753,223290,1172568
2023-04-29 17:06,1172603,445554,503755,223294,1172603
2023-04-29 17:07,1172636,445585,503755,223296,1172636
2023-04-29 17:08,1172669,445613,503759,223297,1172669
2023-04-29 17:09,1172703,445643,503759,223301,1172703
2023-04-29 17:10,1172738,445671,503763,223304,1172738
2023-04-29 17:11,1172775,445702,503764,223309,1172775
2023-04-29 17:12,1172809,445730,503764,223315,1172809
2023-04-29 17:13,1172843,445758,503766,223319,1172843
2023-04-29 17:14,1172878,445786,503770,223322,1172878
2023-04-29 17:15,1172913,445818,503770,223325,1172913
2023-04-29 17:16,1172947,445841,503776,223330,1172947
2023-04-29 17:17,1172983,445877,503776,223330,1172983
2023-04-29 17:18,1173017,445904,503779,223334,1173017
2023-04-29 17:19,1173050,445937,503779,223334,1173050
2023-04-29 17:20,1173085,445963,503781,223341,1173085
2023-04-29 17:21,1173120,445998,503781,223341,1173120
2023-04-29 17:22,1173158,446028,503783,223347,1173158
2023-04-29 17:23,1173190,446056,503783,223351,1173190
2023-04-29 17:24,1173227,446087,503784,223356,1173227
2023-04-29 17:25,1173260,446118,503784,223358,1173260
2023-04-29 17:26,1173294,446142,503788,223364,1173294
2023-04-29 17:27,1173329,446174,503788,223367,1173329
2023-04-29 17:28,1173363,446200,503792,223371,1173363
2023-04-29 17:30,1173400,446232,503792,223376,1173400
2023-04-29 17:31,1173435,446259,503797,223379,1173435
2023-04-29 17:32,1173468,446291,503797,223380,1173468
2023-04-29 17:33,1173502,446321,503799,223382,1173502
2023-04-29 17:34,1173535,446350,503799,223386,1173535
2023-04-29 17:35,1173570,446380,503802,223388,1173570
2023-04-29 17:36,1173607,446412,503802,223393,1173607
2023-04-29 17:37,1173641,446437,503805,223399,1173641
2023-04-29 17:38,1173674,446469,503805,223400,1173674
2023-04-29 17:39,1173710,446501,503807,223402,1173710
2023-04-29 17:40,1173746,446536,503807,223403,1173746
2023-04-29 17:41,1173781,446565,503811,223405,1173781
2023-04-29 17:42,1173815,446595,503811,223409,1173815
2023-04-29 17:43,1173850,446624,503815,223411,1173850
2023-04-29 17:44,1173882,446655,503815,223412,1173882
2023-04-29 17:45,1173917,446683,503821,223413,1173917
2023-04-29 17:46,1173952,446716,503821,223415,1173952
2023-04-29 17:47,1173989,446749,503822,223418,1173989
2023-04-29 17:48,1174024,446783,503822,223419,1174024
2023-04-29 17:49,1174056,446808,503827,223421,1174056
2023-04-29 17:50,1174091,446840,503827,223424,1174091
2023-04-29 17:51,1174125,446868,503828,223429,1174125
2023-04-29 17:52,1174162,446901,503829,223432,1174162
2023-04-29 17:53,1174196,446931,503829,223436,1174196
2023-04-29 17:54,1174231,446957,503835,223439,1174231
2023-04-29 17:55,1174265,446989,503835,223441,1174265
2023-04-29 17:56,1174300,447018,503836,223446,1174300
2023-04-29 17:57,1174334,447049,503836,223449,1174334
2023-04-29 17:58,1174372,447085,503837,223450,1174372
2023-04-29 17:59,1174406,447115,503837,223454,1174406
2023-04-29 18:00,1174432,447131,503841,223460,1174432
2023-04-29 18:01,1174452,447150,503841,223461,1174452
2023-04-29 18:02,1174473,447165,503846,223462,1174473
2023-04-29 18:03,1174492,447183,503846,223463,1174492
2023-04-29 18:04,1174513,447200,503850,223463,1174513
2023-04-29 18:05,1174534,447219,503850,223465,1174534
2023-04-29 18:06,1174557,447232,503854,223471,1174557
2023-04-29 18:07,1174579,447249,503854,223476,1174579
2023-04-29 18:08,1174601,447262,503860,223479,1174601
2023-04-29 18:09,1174622,447282,503860,223480,1174622
2023-04-29 18:10,1174642,447297,503861,223484,1174642
2023-04-29 18:11,1174663,447311,503861,223491,1174663
2023-04-29 18:12,1174685,447327,503864,223494,1174685
2023-04-29 18:13,1174706,447346,503864,223496,1174706
2023-04-29 18:14,1174727,447360,503867,223500,1174727
2023-04-29 18:15,1174748,447375,503868,223505,1174748
2023-04-29 18:17,1174769,447393,503868,223508,1174769
2023-04-29 18:18,1174791,447403,503871,223517,1174791
2023-04-29 18:19,1174810,447417,503871,223522,1174810
2023-04-29 18:20,1174831,447430,503874,223527,1174831
2023-04-29 18:21,1174851,447449,503874,223528,1174851
2023-04-29 18:22,1174874,447462,503878,223534,1174874
2023-04-29 18:23,1174894,447478,503878,223538,1174894
2023-04-29 18:24,1174914,447490,503881,223543,1174914
2023-04-29 18:25,1174934,447508,503881,223545,1174934
2023-04-29 18:26,1174954,447524,503882,223548,1174954
2023-04-29 18:27,1174976,447544,503882,223550,1174976
2023-04-29 18:28,1174996,447558,503883,223555,1174996
2023-04-29 18:29,1175019,447576,503883,223560,1175019
2023-04-29 18:30,1175039,447593,503885,223561,1175039
2023-04-29 18:31,1175060,447608,503887,223565,1175060
2023-04-29 18:32,1175081,447627,503887,223567,1175081
2023-04-29 18:33,1175102,447641,503891,223570,1175102
2023-04-29 18:34,1175123,447657,503891,223575,1175123
2023-04-29 18:35,1175145,447668,503900,223577,1175145
2023-04-29 18:36,1175164,447676,503905,223583,1175164
2023-04-29 18:37,1175185,447693,503905,223587,1175185
2023-04-29 18:38,1175205,447705,503912,223588,1175205
2023-04-29 18:39,1175227,447724,503912,223591,1175227
2023-04-29 18:40,1175249,447739,503916,223594,1175249
2023-04-29 18:41,1175269,447754,503916,223599,1175269
2023-04-29 18:42,1175291,447769,503920,223602,1175291
2023-04-29 18:43,1175313,447789,503920,223604,1175313
2023-04-29 18:44,1175333,447802,503924,223607,1175333
2023-04-29 18:45,1175354,447823,503924,223607,1175354
2023-04-29 18:46,1175375,447835,503930,223610,1175375
2023-04-29 18:47,1175397,447852,503930,223615,1175397
2023-04-29 18:48,1175417,447861,503938,223618,1175417
2023-04-29 18:49,1175438,447874,503941,223623,1175438
2023-04-29 18:50,1175459,447893,503941,223625,1175459
2023-04-29 18:51,1175479,447906,503947,223626,1175479
2023-04-29 18:52,1175499,447921,503947,223631,1175499
2023-04-29 18:53,1175519,447931,503952,223636,1175519
2023-04-29 18:54,1175541,447947,503956,223638,1175541
2023-04-29 18:55,1175561,447966,503956,223639,1175561
2023-04-29 18:56,1175582,447982,503959,223641,1175582
2023-04-29 18:57,1175603,447998,503959,223646,1175603
2023-04-29 18:58,1175624,448010,503962,223652,1175624
2023-04-29 18:59,1175646,448031,503962,223653,1175646
2023-04-29 19:00,1175663,448048,503962,223653,1175663
2023-04-29 19:01,1175680,448061,503962,223657,1175680
2023-04-29 19:02,1175698,448075,503962,223661,1175698
2023-04-29 19:03,1175716,448090,503962,223664,1175716
2023-04-29 19:05,1175733,448082,503983,223668,1175733
2023-04-29 19:06,1175751,448098,503982,223671,1175751
2023-04-29 19:07,1175768,448112,503982,223674,1175768
2023-04-29 19:08,1175789,448126,503986,223677,1175789
2023-04-29 19:09,1175806,448142,503986,223678,1175806
2023-04-29 19:10,1175823,448157,503987,223679,1175823
2023-04-29 19:11,1175840,448174,503987,223679,1175840
2023-04-29 19:12,1175858,448184,503992,223682,1175858
2023-04-29 19:13,1175876,448198,503992,223686,1175876
2023-04-29 19:14,1175893,448210,503994,223689,1175893
2023-04-29 19:15,1175910,448221,503994,223695,1175910
2023-04-29 19:16,1175927,448227,504003,223697,1175927
2023-04-29 19:17,1175946,448245,504003,223698,1175946
2023-04-29 19:18,1175963,448256,504007,223700,1175963
2023-04-29 19:19,1175982,448272,504007,223703,1175982
2023-04-29 19:20,1175998,448282,504012,223704,1175998
2023-04-29 19:21,1176016,448298,504012,223706,1176016
2023-04-29 19:22,1176034,448306,504019,223709,1176034
2023-04-29 19:23,1176052,448320,504019,223713,1176052
2023-04-29 19:24,1176072,448333,504022,223717,1176072
2023-04-29 19:25,1176088,448347,504022,223719,1176088
2023-04-29 19:26,1176107,448361,504024,223722,1176107
2023-04-29 19:27,1176126,448376,504024,223726,1176126
2023-04-29 19:28,1176143,448388,504028,223727,1176143
2023-04-29 19:29,1176161,448403,504028,223730,1176161
2023-04-29 19:30,1176179,448407,504040,223732,1176179
2023-04-29 19:31,1176198,448424,504040,223734,1176198
2023-04-29 19:32,1176215,448430,504049,223736,1176215
2023-04-29 19:33,1176234,448445,504049,223740,1176234
2023-04-29 19:34,1176252,448450,504060,223742,1176252
2023-04-29 19:35,1176270,448462,504062,223746,1176270
2023-04-29 19:36,1176288,448466,504074,223748,1176288
2023-04-29 19:37,1176307,448481,504074,223752,1176307
2023-04-29 19:38,1176325,448489,504083,223753,1176325
2023-04-29 19:39,1176343,448504,504085,223754,1176343
2023-04-29 19:40,1176361,448518,504085,223758,1176361
2023-04-29 19:41,1176380,448529,504090,223761,1176380
2023-04-29 19:42,1176398,448542,504090,223766,1176398
2023-04-29 19:43,1176416,448552,504097,223767,1176416
2023-04-29 19:44,1176433,448566,504097,223770,1176433
2023-04-29 19:45,1176451,448573,504105,223773,1176451
2023-04-29 19:46,1176469,448587,504105,223777,1176469
2023-04-29 19:47,1176487,448593,504114,223780,1176487
2023-04-29 19:48,1176508,448607,504114,223787,1176508
2023-04-29 19:49,1176525,448616,504119,223790,1176525
2023-04-29 19:50,1176544,448632,504119,223793,1176544
2023-04-29 19:51,1176561,448634,504127,223800,1176561
2023-04-29 19:53,1176578,448648,504127,223803,1176578
2023-04-29 19:54,1176597,448653,504139,223805,1176597
2023-04-29 19:55,1176613,448663,504142,223808,1176613
2023-04-29 19:56,1176632,448678,504142,223812,1176632
2023-04-29 19:57,1176649,448684,504149,223816,1176649
2023-04-29 19:58,1176666,448699,504149,223818,1176666
2023-04-29 19:59,1176685,448711,504155,223819,1176685
2023-04-29 20:00,1176704,448727,504155,223822,1176704
2023-04-29 20:01,1176736,448748,504166,223822,1176736
2023-04-29 20:02,1176764,448774,504166,223824,1176764
2023-04-29 20:03,1176795,448794,504174,223827,1176795
2023-04-29 20:04,1176826,448824,504174,223828,1176826
2023-04-29 20:05,1176858,448848,504179,223831,1176858
2023-04-29 20:06,1176888,448879,504179,223830,1176888
2023-04-29 20:07,1176919,448901,504184,223834,1176919
2023-04-29 20:08,1176950,448932,504184,223834,1176950
2023-04-29 20:09,1176984,448961,504189,223834,1176984
2023-04-29 20:10,1177015,448991,504189,223835,1177015
2023-04-29 20:11,1177044,449012,504193,223839,1177044
2023-04-29 20:12,1177076,449042,504193,223841,1177076
2023-04-29 20:13,1177107,449068,504197,223842,1177107
2023-04-29 20:14,1177138,449098,504197,223843,1177138
2023-04-29 20:15,1177170,449122,504205,223843,1177170
2023-04-29 20:16,1177200,449149,504205,223846,1177200
2023-04-29 20:17,1177235,449176,504212,223847,1177235
2023-04-29 20:18,1177263,449204,504212,223847,1177263
2023-04-29 20:19,1177297,449229,504218,223850,1177297
2023-04-29 20:20,1177327,449258,504218,223851,1177327
2023-04-29 20:21,1177358,449284,504220,223854,1177358
2023-04-29 20:22,1177389,449311,504220,223858,1177389
2023-04-29 20:23,1177419,449335,504222,223862,1177419
2023-04-29 20:24,1177449,449363,504222,223864,1177449
2023-04-29 20:25,1177481,449389,504225,223867,1177481
2023-04-29 20:26,1177513,449418,504225,223870,1177513
2023-04-29 20:27,1177543,449439,504231,223873,1177543
2023-04-29 20:28,1177575,449461,504236,223878,1177575
2023-04-29 20:29,1177606,449490,504236,223880,1177606
2023-04-29 20:30,1177637,449510,504245,223882,1177637
2023-04-29 20:31,1177667,449539,504246,223882,1177667
2023-04-29 20:32,1177698,449564,504246,223888,1177698
2023-04-29 20:33,1177729,449589,504252,223888,1177729
2023-04-29 20:34,1177760,449618,504252,223890,1177760
2023-04-29 20:35,1177791,449638,504260,223893,1177791
2023-04-29 20:36,1177821,449667,504260,223894,1177821
2023-04-29 20:37,1177853,449689,504267,223897,1177853
2023-04-29 20:38,1177884,449718,504267,223899,1177884
2023-04-29 20:40,1177915,449744,504273,223898,1177915
2023-04-29 20:41,1177944,449771,504273,223900,1177944
2023-04-29 20:42,1177976,449802,504274,223900,1177976
2023-04-29 20:43,1178008,449831,504274,223903,1178008
2023-04-29 20:44,1178038,449859,504277,223902,1178038
2023-04-29 20:45,1178069,449887,504277,223905,1178069
2023-04-29 20:46,1178099,449915,504278,223906,1178099
2023-04-29 20:47,1178132,449945,504278,223909,1178132
2023-04-29 20:48,1178161,449967,504282,223912,1178161
2023-04-29 20:49,1178194,449999,504282,223913,1178194
2023-04-29 20:50,1178223,450020,504287,223916,1178223
2023-04-29 20:51,1178255,450047,504287,223921,1178255
2023-04-29 20:52,1178286,450070,504292,223924,1178286
2023-04-29 20:53,1178321,450102,504292,223927,1178321
2023-04-29 20:54,1178350,450120,504301,223929,1178350
2023-04-29 20:55,1178382,450151,504301,223930,1178382
2023-04-29 20:56,1178414,450177,504304,223933,1178414
2023-04-29 20:57,1178446,450205,504304,223937,1178446
2023-04-29 20:58,1178477,450229,504308,223940,1178477
2023-04-29 20:59,1178510,450258,504308,223944,1178510
2023-04-29 21:00,1178534,450275,504312,223947,1178534
2023-04-29 21:01,1178549,450287,504312,223950,1178549
2023-04-29 21:02,1178563,450295,504315,223953,1178563
2023-04-29 21:03,1178576,450307,504315,223954,1178576
2023-04-29 21:04,1178591,450315,504321,223955,1178591
2023-04-29 21:05,1178605,450328,504321,223956,1178605
2023-04-29 21:06,1178620,450326,504333,223961,1178620
2023-04-29 21:07,1178634,450339,504333,223962,1178634
2023-04-29 21:08,1178649,450340,504338,223971,1178649
2023-04-29 21:09,1178664,450350,504338,223976,1178664
2023-04-29 21:10,1178682,450357,504344,223981,1178682
2023-04-29 21:11,1178696,450369,504344,223983,1178696
2023-04-29 21:12,1178711,450375,504348,223988,1178711
2023-04-29 21:13,1178725,450385,504348,223992,1178725
2023-04-29 21:14,1178740,450394,504352,223994,1178740
2023-04-29 21:15,1178753,450405,504352,223996,1178753
2023-04-29 21:16,1178768,450409,504361,223998,1178768
2023-04-29 21:17,1178783,450423,504361,223999,1178783
2023-04-29 21:18,1178798,450432,504365,224001,1178798
2023-04-29 21:19,1178814,450446,504365,224003,1178814
2023-04-29 21:20,1178828,450454,504369,224005,1178828
2023-04-29 21:21,1178841,450465,504369,224007,1178841
2023-04-29 21:22,1178856,450471,504376,224009,1178856
2023-04-29 21:23,1178872,450483,504378,224011,1178872
2023-04-29 21:24,1178887,450493,504378,224016,1178887
2023-04-29 21:25,1178901,450498,504385,224018,1178901
2023-04-29 21:26,1178917,450511,504385,224021,1178917
2023-04-29 21:28,1178932,450517,504388,224027,1178932
2023-04-29 21:29,1178946,450529,504388,224029,1178946
2023-04-29 21:30,1178960,450538,504392,224030,1178960
2023-04-29 21:31,1178975,450548,504394,224033,1178975
2023-04-29 21:32,1178989,450557,504394,224038,1178989
2023-04-29 21:33,1179004,450569,504396,224039,1179004
2023-04-29 21:34,1179017,450581,504396,224040,1179017
2023-04-29 21:35,1179031,450587,504400,224044,1179031
2023-04-29 21:36,1179046,450597,504400,224049,1179046
2023-04-29 21:37,1179060,450605,504404,224051,1179060
2023-04-29 21:38,1179075,450615,504404,224056,1179075
2023-04-29 21:39,1179090,450623,504408,224059,1179090
2023-04-29 21:40,1179103,450634,504408,224061,1179103
2023-04-29 21:41,1179118,450640,504415,224063,1179118
2023-04-29 21:42,1179132,450653,504415,224064,1179132
2023-04-29 21:43,1179148,450663,504417,224068,1179148
2023-04-29 21:44,1179161,450669,504417,224075,1179161
2023-04-29 21:45,1179176,450668,504432,224076,1179176
2023-04-29 21:46,1179189,450678,504432,224079,1179189
2023-04-29 21:47,1179203,450691,504432,224080,1179203
2023-04-29 21:48,1179218,450701,504432,224085,1179218
2023-04-29 21:49,1179232,450712,504434,224086,1179232
2023-04-29 21:50,1179246,450722,504434,224090,1179246
2023-04-29 21:51,1179259,450727,504440,224092,1179259
2023-04-29 21:52,1179274,450740,504440,224094,1179274
2023-04-29 21:53,1179289,450746,504444,224099,1179289
2023-04-29 21:54,1179304,450761,504444,224099,1179304
2023-04-29 21:55,1179319,450768,504450,224101,1179319
2023-04-29 21:56,1179332,450777,504450,224105,1179332
2023-04-29 21:57,1179346,450786,504453,224107,1179346
2023-04-29 21:58,1179359,450796,504453,224110,1179359
2023-04-29 21:59,1179373,450803,504457,224113,1179373
2023-04-29 22:00,1179392,450820,504457,224115,1179392
2023-04-29 22:01,1179411,450836,504459,224116,1179411
2023-04-29 22:02,1179432,450855,504459,224118,1179432
2023-04-29 22:03,1179451,450869,504462,224120,1179451
2023-04-29 22:04,1179471,450886,504462,224123,1179471
2023-04-29 22:05,1179491,450895,504470,224126,1179491
2023-04-29 22:06,1179509,450910,504470,224129,1179509
2023-04-29 22:07,1179529,450919,504477,224133,1179529
2023-04-29 22:08,1179550,450937,504477,224136,1179550
2023-04-29 22:09,1179569,450951,504480,224138,1179569
2023-04-29 22:10,1179588,450966,504480,224142,1179588
2023-04-29 22:11,1179608,450983,504482,224143,1179608
2023-04-29 22:12,1179628,451002,504482,224144,1179628
2023-04-29 22:14,1179647,451009,504489,224149,1179647
2023-04-29 22:15,1179667,451028,504490,224149,1179667
2023-04-29 22:16,1179687,451046,504490,224151,1179687
2023-04-29 22:17,1179706,451055,504498,224153,1179706
2023-04-29 22:18,1179726,451070,504498,224158,1179726
2023-04-29 22:19,1179746,451086,504501,224159,1179746
2023-04-29 22:20,1179766,451103,504501,224162,1179766
2023-04-29 22:21,1179787,451112,504508,224167,1179787
2023-04-29 22:22,1179808,451130,504508,224170,1179808
2023-04-29 22:23,1179826,451138,504511,224177,1179826
2023-04-29 22:24,1179847,451155,504511,224181,1179847
2023-04-29 22:25,1179866,451168,504514,224184,1179866
2023-04-29 22:26,1179885,451184,504514,224187,1179885
2023-04-29 22:27,1179906,451196,504522,224188,1179906
2023-04-29 22:28,1179925,451214,504522,224189,1179925
2023-04-29 22:29,1179945,451229,504524,224192,1179945
2023-04-29 22:30,1179965,451246,504526,224193,1179965
2023-04-29 22:31,1179984,451262,504526,224196,1179984
2023-04-29 22:32,1180005,451274,504531,224200,1180005
2023-04-29 22:33,1180023,451289,504532,224202,1180023
2023-04-29 22:34,1180042,451306,504532,224204,1180042
2023-04-29 22:35,1180063,451320,504536,224207,1180063
2023-04-29 22:36,1180082,451335,504536,224211,1180082
2023-04-29 22:37,1180101,451347,504539,224215,1180101
2023-04-29 22:38,1180122,451363,504539,224220,1180122
2023-04-29 22:39,1180141,451377,504543,224221,1180141
2023-04-29 22:40,1180161,451393,504543,224225,1180161
2023-04-29 22:41,1180180,451402,504550,224228,1180180
2023-04-29 22:42,1180200,451418,504550,224232,1180200
2023-04-29 22:43,1180220,451434,504553,224233,1180220
2023-04-29 22:44,1180241,451450,504556,224235,1180241
2023-04-29 22:45,1180261,451467,504556,224238,1180261
2023-04-29 22:46,1180282,451484,504558,224240,1180282
2023-04-29 22:47,1180302,451501,504558,224243,1180302
2023-04-29 22:48,1180322,451520,504558,224244,1180322
2023-04-29 22:49,1180344,451539,504558,224247,1180344
2023-04-29 22:50,1180366,451560,504558,224248,1180366
2023-04-29 22:51,1180385,451567,504569,224249,1180385
2023-04-29 22:52,1180405,451585,504570,224250,1180405
2023-04-29 22:53,1180426,451604,504570,224252,1180426
2023-04-29 22:54,1180444,451617,504573,224254,1180444
2023-04-29 22:55,1180464,451633,504573,224258,1180464
2023-04-29 22:56,1180483,451645,504580,224258,1180483
2023-04-29 22:57,1180504,451663,504580,224261,1180504
2023-04-29 22:58,1180524,451677,504583,224264,1180524
2023-04-29 22:59,1180543,451693,504584,224266,1180543
2023-04-29 23:00,1180564,451708,504584,224272,1180564
2023-04-29 23:02,1180586,451716,504591,224279,1180586
2023-04-29 23:03,1180607,451735,504591,224281,1180607
2023-04-29 23:04,1180629,451749,504597,224283,1180629
2023-04-29 23:05,1180650,451770,504597,224283,1180650
2023-04-29 23:06,1180672,451791,504598,224283,1180672
2023-04-29 23:07,1180694,451810,504598,224286,1180694
2023-04-29 23:08,1180716,451832,504598,224286,1180716
2023-04-29 23:09,1180739,451851,504598,224290,1180739
2023-04-29 23:10,1180760,451865,504603,224292,1180760
2023-04-29 23:11,1180781,451883,504603,224295,1180781
2023-04-29 23:12,1180802,451895,504609,224298,1180802
2023-04-29 23:13,1180824,451914,504609,224301,1180824
2023-04-29 23:14,1180847,451936,504611,224300,1180847
2023-04-29 23:15,1180869,451954,504611,224304,1180869
2023-04-29 23:16,1180891,451968,504614,224309,1180891
2023-04-29 23:17,1180913,451988,504614,224311,1180913
2023-04-29 23:18,1180936,452004,504619,224313,1180936
2023-04-29 23:19,1180957,452025,504619,224313,1180957
2023-04-29 23:20,1180980,452041,504622,224317,1180980
2023-04-29 23:21,1181001,452059,504622,224320,1181001
2023-04-29 23:22,1181021,452071,504626,224324,1181021
2023-04-29 23:23,1181044,452093,504626,224325,1181044
2023-04-29 23:24,1181065,452109,504629,224327,1181065
2023-04-29 23:25,1181087,452129,504629,224329,1181087
2023-04-29 23:26,1181110,452144,504632,224334,1181110
2023-04-29 23:27,1181130,452161,504632,224337,1181130
2023-04-29 23:28,1181152,452179,504636,224337,1181152
2023-04-29 23:29,1181173,452195,504636,224342,1181173
2023-04-29 23:30,1181196,452214,504639,224343,1181196
2023-04-29 23:31,1181216,452234,504639,224343,1181216
2023-04-29 23:32,1181238,452250,504641,224347,1181238
2023-04-29 23:33,1181260,452269,504641,224350,1181260
2023-04-29 23:34,1181281,452285,504643,224353,1181281
2023-04-29 23:35,1181302,452303,504643,224356,1181302
2023-04-29 23:36,1181324,452317,504647,224360,1181324
2023-04-29 23:37,1181346,452334,504647,224365,1181346
2023-04-29 23:38,1181367,452345,504653,224369,1181367
2023-04-29 23:39,1181390,452367,504653,224370,1181390
2023-04-29 23:40,1181411,452383,504653,224375,1181411
2023-04-29 23:41,1181432,452401,504653,224378,1181432
2023-04-29 23:42,1181453,452415,504658,224380,1181453
2023-04-29 23:43,1181474,452433,504658,224383,1181474
2023-04-29 23:44,1181496,452451,504662,224383,1181496
2023-04-29 23:45,1181518,452472,504662,224384,1181518
2023-04-29 23:46,1181540,452488,504663,224389,1181540
2023-04-29 23:47,1181561,452510,504663,224388,1181561
2023-04-29 23:48,1181583,452525,504668,224390,1181583
2023-04-29 23:50,1181606,452544,504668,224394,1181606
2023-04-29 23:51,1181627,452560,504673,224394,1181627
2023-04-29 23:52,1181649,452581,504673,224395,1181649
2023-04-29 23:53,1181670,452594,504677,224399,1181670
2023-04-29 23:54,1181693,452617,504677,224399,1181693
2023-04-29 23:55,1181715,452632,504681,224402,1181715
2023-04-29 23:56,1181736,452651,504681,224404,1181736
2023-04-29 23:57,1181757,452665,504684,224408,1181757
2023-04-29 23:58,1181779,452683,504685,224411,1181779
2023-04-29 23:59,1181803,452706,504685,224412,1181803
2023-04-30 00:00,1181824,452723,504688,224413,1181824
2023-04-30 00:01,1181854,452750,504688,224416,1181854
2023-04-30 00:02,1181882,452770,504695,224417,1181882
2023-04-30 00:03,1181912,452795,504695,224422,1181912
2023-04-30 00:04,1181939,452818,504697,224424,1181939
2023-04-30 00:05,1181968,452845,504697,224426,1181968
2023-04-30 00:06,1181996,452869,504699,224428,1181996
2023-04-30 00:07,1182024,452896,504699,224429,1182024
2023-04-30 00:08,1182053,452920,504701,224432,1182053
2023-04-30 00:09,1182081,452947,504701,224433,1182081
2023-04-30 00:10,1182111,452969,504708,224434,1182111
2023-04-30 00:11,1182138,452994,504708,224436,1182138
2023-04-30 00:12,1182168,453016,504714,224438,1182168
2023-04-30 00:13,1182195,453037,504714,224444,1182195
2023-04-30 00:14,1182225,453064,504717,224444,1182225
2023-04-30 00:15,1182254,453094,504717,224443,1182254
2023-04-30 00:16,1182283,453115,504720,224448,1182283
2023-04-30 00:17,1182311,453142,504720,224449,1182311
2023-04-30 00:18,1182340,453161,504726,224453,1182340
2023-04-30 00:19,1182369,453189,504726,224454,1182369
2023-04-30 00:20,1182396,453209,504732,224455,1182396
2023-04-30 00:21,1182426,453234,504732,224460,1182426
2023-04-30 00:22,1182454,453259,504734,224461,1182454
2023-04-30 00:23,1182483,453286,504734,224463,1182483
2023-04-30 00:24,1182510,453307,504741,224462,1182510
2023-04-30 00:25,1182540,453333,504741,224466,1182540
2023-04-30 00:26,1182568,453354,504745,224469,1182568
2023-04-30 00:27,1182598,453381,504745,224472,1182598
2023-04-30 00:28,1182627,453408,504745,224474,1182627
2023-04-30 00:29,1182654,453435,504745,224474,1182654
2023-04-30 00:30,1182682,453460,504745,224477,1182682
2023-04-30 00:31,1182712,453488,504745,224479,1182712
2023-04-30 00:32,1182740,453513,504745,224482,1182740
2023-04-30 00:33,1182769,453540,504745,224484,1182769
2023-04-30 00:34,1182798,453564,504745,224489,1182798
2023-04-30 00:35,1182825,453590,504745,224490,1182825
2023-04-30 00:37,1182854,453616,504745,224493,1182854
2023-04-30 00:38,1182883,453640,504745,224498,1182883
2023-04-30 00:39,1182911,453654,504757,224500,1182911
2023-04-30 00:40,1182941,453679,504757,224505,1182941
2023-04-30 00:41,1182969,453706,504757,224506,1182969
2023-04-30 00:42,1183000,453735,504757,224508,1183000
2023-04-30 00:43,1183029,453762,504757,224510,1183029
2023-04-30 00:44,1183058,453791,504757,224510,1183058
2023-04-30 00:45,1183087,453818,504757,224512,1183087
2023-04-30 00:46,1183114,453844,504757,224513,1183114
2023-04-30 00:47,1183144,453869,504757,224518,1183144
2023-04-30 00:48,1183171,453896,504757,224518,1183171
2023-04-30 00:49,1183199,453911,504767,224521,1183199
2023-04-30 00:50,1183228,453936,504767,224525,1183228
2023-04-30 00:51,1183257,453963,504767,224527,1183257
2023-04-30 00:52,1183287,453991,504767,224529,1183287
2023-04-30 00:53,1183314,454018,504767,224529,1183314
2023-04-30 00:54,1183342,454044,504767,224531,1183342
2023-04-30 00:55,1183371,454073,504767,224531,1183371
2023-04-30 00:56,1183400,454101,504767,224532,1183400
2023-04-30 00:57,1183431,454130,504767,224534,1183431
2023-04-30 00:58,1183458,454156,504767,224535,1183458
2023-04-30 00:59,1183488,454168,504782,224538,1183488
2023-04-30 01:00,1183513,454187,504787,224539,1183513
2023-04-30 01:01,1183534,454205,504787,224542,1183534
2023-04-30 01:02,1183558,454226,504789,224543,1183558
2023-04-30 01:03,1183579,454245,504789,224545,1183579
2023-04-30 01:04,1183602,454266,504790,224546,1183602
2023-04-30 01:05,1183627,454287,504792,224548,1183627
2023-04-30 01:06,1183650,454309,504792,224549,1183650
2023-04-30 01:07,1183671,454325,504796,224550,1183671
2023-04-30 01:08,1183696,454347,504796,224553,1183696
2023-04-30 01:09,1183719,454366,504798,224555,1183719
2023-04-30 01:10,1183742,454385,504798,224559,1183742
2023-04-30 01:11,1183765,454405,504798,224562,1183765
2023-04-30 01:12,1183787,454425,504800,224562,1183787
2023-04-30 01:13,1183810,454447,504800,224563,1183810
2023-04-30 01:14,1183833,454466,504800,224567,1183833
2023-04-30 01:15,1183856,454488,504800,224568,1183856
2023-04-30 01:16,1183879,454507,504805,224567,1183879
2023-04-30 01:17,1183900,454522,504805,224573,1183900
2023-04-30 01:18,1183924,454543,504806,224575,1183924
2023-04-30 01:19,1183947,454565,504806,224576,1183947
2023-04-30 01:20,1183970,454587,504807,224576,1183970
2023-04-30 01:21,1183993,454610,504807,224576,1183993
2023-04-30 01:22,1184016,454631,504807,224578,1184016
2023-04-30 01:23,1184040,454654,504807,224579,1184040
2023-04-30 01:25,1184061,454672,504809,224580,1184061
2023-04-30 01:26,1184085,454693,504809,224583,1184085
2023-04-30 01:27,1184107,454711,504811,224585,1184107
2023-04-30 01:28,1184129,454733,504811,224585,1184129
2023-04-30 01:29,1184152,454750,504813,224589,1184152
2023-04-30 01:30,1184176,454773,504813,224590,1184176
2023-04-30 01:31,1184199,454792,504815,224592,1184199
2023-04-30 01:32,1184221,454814,504815,224592,1184221
2023-04-30 01:33,1184244,454830,504820,224594,1184244
2023-04-30 01:34,1184267,454851,504820,224596,1184267
2023-04-30 01:35,1184292,454874,504821,224597,1184292
2023-04-30 01:36,1184314,454895,504821,224598,1184314
2023-04-30 01:37,1184338,454917,504822,224599,1184338
2023-04-30 01:38,1184361,454939,504822,224600,1184361
2023-04-30 01:39,1184384,454956,504824,224604,1184384
2023-04-30 01:40,1184407,454979,504824,224604,1184407
2023-04-30 01:41,1184430,455000,504825,224605,1184430
2023-04-30 01:42,1184454,455021,504825,224608,1184454
2023-04-30 01:43,1184476,455037,504829,224610,1184476
2023-04-30 01:44,1184499,455057,504829,224613,1184499
2023-04-30 01:45,1184522,455080,504829,224613,1184522
2023-04-30 01:46,1184544,455102,504829,224613,1184544
2023-04-30 01:47,1184567,455122,504830,224615,1184567
2023-04-30 01:48,1184590,455144,504830,224616,1184590
2023-04-30 01:49,1184612,455162,504833,224617,1184612
2023-04-30 01:50,1184636,455185,504833,224618,1184636
2023-04-30 01:51,1184660,455203,504837,224620,1184660
2023-04-30 01:52,1184683,455225,504837,224621,1184683
2023-04-30 01:53,1184706,455246,504838,224622,1184706
2023-04-30 01:54,1184729,455268,504838,224623,1184729
2023-04-30 01:55,1184750,455286,504840,224624,1184750
2023-04-30 01:56,1184774,455305,504841,224628,1184774
2023-04-30 01:57,1184796,455326,504841,224629,1184796
2023-04-30 01:58,1184819,455343,504846,224630,1184819
2023-04-30 01:59,1184843,455367,504846,224630,1184843
2023-04-30 02:00,1184863,455385,504847,224631,1184863
2023-04-30 02:01,1184881,455402,504847,224632,1184881
2023-04-30 02:02,1184901,455417,504849,224635,1184901
2023-04-30 02:03,1184919,455431,504849,224639,1184919
2023-04-30 02:04,1184938,455446,504851,224641,1184938
2023-04-30 02:05,1184956,455463,504851,224642,1184956
2023-04-30 02:06,1184974,455480,504851,224643,1184974
2023-04-30 02:07,1184993,455497,504851,224645,1184993
2023-04-30 02:08,1185010,455512,504852,224646,1185010
2023-04-30 02:09,1185029,455530,504852,224647,1185029
2023-04-30 02:10,1185048,455546,504854,224648,1185048
2023-04-30 02:11,1185067,455565,504854,224648,1185067
2023-04-30 02:13,1185085,455578,504856,224651,1185085
2023-04-30 02:14,1185103,455595,504856,224652,1185103
2023-04-30 02:15,1185120,455610,504857,224653,1185120
2023-04-30 02:16,1185139,455628,504857,224654,1185139
2023-04-30 02:17,1185157,455645,504858,224654,1185157
2023-04-30 02:18,1185176,455664,504858,224654,1185176
2023-04-30 02:19,1185193,455680,504858,224655,1185193
2023-04-30 02:20,1185212,455695,504858,224659,1185212
2023-04-30 02:21,1185231,455712,504859,224660,1185231
2023-04-30 02:22,1185248,455726,504861,224661,1185248
2023-04-30 02:23,1185266,455743,504861,224662,1185266
2023-04-30 02:24,1185285,455761,504862,224662,1185285
2023-04-30 02:25,1185303,455778,504862,224663,1185303
2023-04-30 02:26,1185322,455796,504862,224664,1185322
2023-04-30 02:27,1185340,455812,504862,224666,1185340
2023-04-30 02:28,1185357,455827,504864,224666,1185357
2023-04-30 02:29,1185375,455843,504864,224668,1185375
2023-04-30 02:30,1185394,455861,504865,224668,1185394
2023-04-30 02:31,1185412,455879,504865,224668,1185412
2023-04-30 02:32,1185431,455897,504866,224668,1185431
2023-04-30 02:33,1185448,455914,504866,224668,1185448
2023-04-30 02:34,1185467,455930,504869,224668,1185467
2023-04-30 02:35,1185487,455948,504869,224670,1185487
2023-04-30 02:36,1185505,455962,504869,224674,1185505
2023-04-30 02:37,1185523,455979,504869,224675,1185523
2023-04-30 02:38,1185541,455995,504870,224676,1185541
2023-04-30 02:39,1185558,456009,504870,224679,1185558
2023-04-30 02:40,1185577,456025,504871,224681,1185577
2023-04-30 02:41,1185596,456042,504872,224682,1185596
2023-04-30 02:42,1185615,456060,504872,224683,1185615
2023-04-30 02:43,1185633,456075,504874,224684,1185633
2023-04-30 02:44,1185651,456092,504874,224685,1185651
2023-04-30 02:45,1185670,456110,504874,224686,1185670
2023-04-30 02:46,1185688,456128,504874,224686,1185688
2023-04-30 02:47,1185707,456145,504876,224686,1185707
2023-04-30 02:48,1185724,456161,504876,224687,1185724
2023-04-30 02:49,1185743,456175,504879,224689,1185743
2023-04-30 02:50,1185762,456193,504879,224690,1185762
2023-04-30 02:51,1185779,456207,504881,224691,1185779
2023-04-30 02:52,1185797,456225,504881,224691,1185797
2023-04-30 02:53,1185817,456244,504882,224691,1185817
2023-04-30 02:54,1185834,456261,504882,224691,1185834
2023-04-30 02:55,1185853,456278,504883,224692,1185853
2023-04-30 02:56,1185871,456295,504883,224693,1185871
2023-04-30 02:57,1185889,456310,504883,224696,1185889
2023-04-30 02:58,1185907,456328,504883,224696,1185907
2023-04-30 02:59,1185925,456345,504883,224697,1185925
2023-04-30 03:01,1185947,456366,504883,224698,1185947
2023-04-30 03:02,1185969,456385,504886,224698,1185969
2023-04-30 03:03,1185992,456408,504886,224698,1185992
2023-04-30 03:04,1186012,456423,504887,224702,1186012
2023-04-30 03:05,1186035,456445,504887,224703,1186035
2023-04-30 03:06,1186058,456466,504889,224703,1186058
2023-04-30 03:07,1186080,456488,504889,224703,1186080
2023-04-30 03:08,1186102,456509,504889,224704,1186102
2023-04-30 03:09,1186125,456531,504889,224705,1186125
2023-04-30 03:10,1186146,456550,504889,224707,1186146
2023-04-30 03:11,1186168,456570,504889,224709,1186168
2023-04-30 03:12,1186190,456591,504890,224709,1186190
2023-04-30 03:13,1186212,456613,504890,224709,1186212
2023-04-30 03:14,1186235,456636,504890,224709,1186235
2023-04-30 03:15,1186257,456658,504890,224709,1186257
2023-04-30 03:16,1186278,456677,504891,224710,1186278
2023-04-30 03:17,1186302,456701,504891,224710,1186302
2023-04-30 03:18,1186324,456723,504891,224710,1186324
2023-04-30 03:19,1186346,456744,504891,224711,1186346
2023-04-30 03:20,1186367,456763,504891,224713,1186367
2023-04-30 03:21,1186390,456785,504891,224714,1186390
2023-04-30 03:22,1186413,456808,504891,224714,1186413
2023-04-30 03:23,1186435,456830,504891,224714,1186435
2023-04-30 03:24,1186457,456851,504892,224714,1186457
2023-04-30 03:25,1186479,456873,504892,224714,1186479
2023-04-30 03:26,1186501,456894,504893,224714,1186501
2023-04-30 03:27,1186524,456917,504893,224714,1186524
2023-04-30 03:28,1186545,456936,504893,224716,1186545
2023-04-30 03:29,1186568,456958,504893,224717,1186568
2023-04-30 03:30,1186589,456977,504893,224719,1186589
2023-04-30 03:31,1186611,456999,504893,224719,1186611
2023-04-30 03:32,1186633,457021,504893,224719,1186633
2023-04-30 03:33,1186657,457044,504893,224720,1186657
2023-04-30 03:34,1186678,457065,504893,224720,1186678
2023-04-30 03:35,1186700,457087,504893,224720,1186700
2023-04-30 03:36,1186723,457108,504893,224722,1186723
2023-04-30 03:37,1186743,457128,504893,224722,1186743
2023-04-30 03:38,1186766,457151,504893,224722,1186766
2023-04-30 03:39,1186788,457173,504893,224722,1186788
2023-04-30 03:40,1186811,457194,504895,224722,1186811
2023-04-30 03:41,1186832,457214,504895,224723,1186832
2023-04-30 03:42,1186854,457236,504895,224723,1186854
2023-04-30 03:43,1186876,457257,504895,224724,1186876
2023-04-30 03:44,1186899,457279,504895,224725,1186899
2023-04-30 03:45,1186922,457301,504895,224726,1186922
2023-04-30 03:46,1186944,457322,504895,224727,1186944
2023-04-30 03:47,1186966,457344,504895,224727,1186966
2023-04-30 03:49,1186988,457366,504895,224727,1186988
2023-04-30 03:50,1187010,457388,504895,224727,1187010
2023-04-30 03:51,1187032,457401,504902,224729,1187032
2023-04-30 03:52,1187055,457424,504902,224729,1187055
2023-04-30 03:53,1187076,457443,504902,224731,1187076
2023-04-30 03:54,1187099,457466,504902,224731,1187099
2023-04-30 03:55,1187120,457487,504902,224731,1187120
2023-04-30 03:56,1187143,457509,504902,224732,1187143
2023-04-30 03:57,1187164,457529,504902,224733,1187164
2023-04-30 03:58,1187186,457551,504902,224733,1187186
2023-04-30 03:59,1187210,457575,504902,224733,1187210
2023-04-30 04:00,1187231,457596,504902,224733,1187231
2023-04-30 04:01,1187260,457622,504905,224733,1187260
2023-04-30 04:02,1187288,457650,504905,224733,1187288
2023-04-30 04:03,1187318,457680,504905,224733,1187318
2023-04-30 04:04,1187347,457709,504905,224733,1187347
2023-04-30 04:05,1187374,457735,504905,224734,1187374
2023-04-30 04:06,1187402,457763,504905,224734,1187402
2023-04-30 04:07,1187430,457790,504905,224735,1187430
2023-04-30 04:08,1187458,457816,504905,224737,1187458
2023-04-30 04:09,1187486,457844,504905,224737,1187486
2023-04-30 04:10,1187516,457874,504905,224737,1187516
2023-04-30 04:11,1187544,457898,504909,224737,1187544
2023-04-30 04:12,1187573,457926,504909,224738,1187573
2023-04-30 04:13,1187601,457954,504909,224738,1187601
2023-04-30 04:14,1187628,457981,504909,224738,1187628
2023-04-30 04:15,1187656,458009,504909,224738,1187656
2023-04-30 04:16,1187684,458037,504909,224738,1187684
2023-04-30 04:17,1187713,458064,504909,224740,1187713
2023-04-30 04:18,1187743,458092,504909,224742,1187743
2023-04-30 04:19,1187770,458118,504909,224743,1187770
2023-04-30 04:20,1187798,458146,504909,224743,1187798
2023-04-30 04:21,1187827,458175,504909,224743,1187827
2023-04-30 04:22,1187855,458202,504909,224744,1187855
2023-04-30 04:23,1187884,458230,504909,224745,1187884
2023-04-30 04:24,1187911,458257,504909,224745,1187911
2023-04-30 04:25,1187939,458283,504909,224747,1187939
2023-04-30 04:26,1187967,458311,504909,224747,1187967
2023-04-30 04:27,1187996,458341,504909,224746,1187996
2023-04-30 04:28,1188025,458370,504909,224746,1188025
2023-04-30 04:29,1188052,458397,504909,224746,1188052
2023-04-30 04:30,1188081,458426,504909,224746,1188081
2023-04-30 04:31,1188111,458451,504913,224747,1188111
2023-04-30 04:32,1188138,458478,504913,224747,1188138
2023-04-30 04:33,1188166,458504,504913,224749,1188166
2023-04-30 04:34,1188195,458533,504913,224749,1188195
2023-04-30 04:36,1188224,458562,504913,224749,1188224
2023-04-30 04:37,1188250,458587,504913,224750,1188250
2023-04-30 04:38,1188281,458618,504913,224750,1188281
2023-04-30 04:39,1188309,458646,504913,224750,1188309
2023-04-30 04:40,1188335,458672,504913,224750,1188335
2023-04-30 04:41,1188365,458702,504913,224750,1188365
2023-04-30 04:42,1188393,458728,504915,224750,1188393
2023-04-30 04:43,1188421,458756,504915,224750,1188421
2023-04-30 04:44,1188450,458785,504915,224750,1188450
2023-04-30 04:45,1188477,458812,504915,224750,1188477
2023-04-30 04:46,1188505,458840,504915,224750,1188505
2023-04-30 04:47,1188534,458869,504915,224750,1188534
2023-04-30 04:48,1188563,458898,504915,224750,1188563
2023-04-30 04:49,1188591,458926,504915,224750,1188591
2023-04-30 04:50,1188619,458954,504915,224750,1188619
2023-04-30 04:51,1188647,458982,504915,224750,1188647
2023-04-30 04:52,1188677,459011,504915,224751,1188677
2023-04-30 04:53,1188706,459039,504915,224752,1188706
2023-04-30 04:54,1188732,459065,504915,224752,1188732
2023-04-30 04:55,1188761,459093,504915,224753,1188761
2023-04-30 04:56,1188790,459122,504915,224753,1188790
2023-04-30 04:57,1188818,459150,504915,224753,1188818
2023-04-30 04:58,1188847,459178,504915,224754,1188847
2023-04-30 04:59,1188876,459207,504915,224754,1188876
2023-04-30 05:00,1188907,459238,504915,224754,1188907
2023-04-30 05:01,1188940,459271,504915,224754,1188940
2023-04-30 05:02,1188974,459304,504916,224754,1188974
2023-04-30 05:03,1189008,459338,504916,224754,1189008
2023-04-30 05:04,1189041,459370,504916,224755,1189041
2023-04-30 05:05,1189074,459403,504916,224755,1189074
2023-04-30 05:06,1189108,459437,504916,224755,1189108
2023-04-30 05:07,1189144,459472,504916,224756,1189144
2023-04-30 05:08,1189178,459506,504916,224756,1189178
2023-04-30 05:09,1189211,459539,504916,224756,1189211
2023-04-30 05:10,1189246,459574,504916,224756,1189246
2023-04-30 05:11,1189279,459607,504916,224756,1189279
2023-04-30 05:12,1189313,459636,504920,224757,1189313
2023-04-30 05:13,1189347,459670,504920,224757,1189347
2023-04-30 05:14,1189381,459702,504921,224758,1189381
2023-04-30 05:15,1189415,459736,504921,224758,1189415
2023-04-30 05:16,1189447,459765,504921,224761,1189447
2023-04-30 05:17,1189484,459802,504921,224761,1189484
2023-04-30 05:18,1189517,459835,504921,224761,1189517
2023-04-30 05:19,1189551,459869,504921,224761,1189551
2023-04-30 05:20,1189585,459901,504923,224761,1189585
2023-04-30 05:22,1189617,459933,504923,224761,1189617
2023-04-30 05:23,1189653,459969,504923,224761,1189653
2023-04-30 05:24,1189685,460000,504923,224762,1189685
2023-04-30 05:25,1189720,460035,504923,224762,1189720
2023-04-30 05:26,1189753,460068,504923,224762,1189753
2023-04-30 05:27,1189788,460102,504924,224762,1189788
2023-04-30 05:28,1189821,460135,504924,224762,1189821
2023-04-30 05:29,1189855,460167,504925,224763,1189855
2023-04-30 05:30,1189890,460201,504926,224763,1189890
2023-04-30 05:31,1189923,460234,504926,224763,1189923
2023-04-30 05:32,1189956,460267,504926,224763,1189956
2023-04-30 05:33,1189991,460302,504926,224763,1189991
2023-04-30 05:34,1190027,460338,504926,224763,1190027
2023-04-30 05:35,1190060,460371,504926,224763,1190060
2023-04-30 05:36,1190093,460404,504926,224763,1190093
2023-04-30 05:37,1190128,460439,504926,224763,1190128
2023-04-30 05:38,1190163,460474,504926,224763,1190163
2023-04-30 05:39,1190197,460506,504926,224765,1190197
2023-04-30 05:40,1190229,460538,504926,224765,1190229
2023-04-30 05:41,1190262,460571,504926,224765,1190262
2023-04-30 05:42,1190297,460605,504927,224765,1190297
2023-04-30 05:43,1190331,460639,504927,224765,1190331
2023-04-30 05:44,1190364,460671,504928,224765,1190364
2023-04-30 05:45,1190398,460705,504928,224765,1190398
2023-04-30 05:46,1190432,460739,504928,224765,1190432
2023-04-30 05:47,1190467,460773,504928,224766,1190467
2023-04-30 05:48,1190501,460803,504931,224767,1190501
2023-04-30 05:49,1190534,460836,504931,224767,1190534
2023-04-30 05:50,1190569,460867,504933,224769,1190569
2023-04-30 05:51,1190602,460900,504933,224769,1190602
2023-04-30 05:52,1190635,460932,504933,224770,1190635
2023-04-30 05:53,1190669,460965,504933,224771,1190669
2023-04-30 05:54,1190704,460998,504935,224771,1190704
2023-04-30 05:55,1190737,461031,504935,224771,1190737
2023-04-30 05:56,1190771,461063,504936,224772,1190771
2023-04-30 05:57,1190805,461097,504936,224772,1190805
2023-04-30 05:58,1190839,461131,504936,224772,1190839
2023-04-30 05:59,1190874,461166,504936,224772,1190874
2023-04-30 06:00,1190898,461189,504936,224773,1190898
2023-04-30 06:01,1190920,461211,504936,224773,1190920
2023-04-30 06:02,1190943,461232,504936,224775,1190943
2023-04-30 06:03,1190967,461256,504936,224775,1190967
2023-04-30 06:04,1190989,461278,504936,224775,1190989
2023-04-30 06:05,1191012,461299,504936,224777,1191012
2023-04-30 06:06,1191034,461319,504937,224778,1191034
2023-04-30 06:07,1191057,461341,504937,224779,1191057
2023-04-30 06:09,1191079,461361,504938,224780,1191079
2023-04-30 06:10,1191101,461382,504938,224781,1191101
2023-04-30 06:11,1191124,461403,504939,224782,1191124
2023-04-30 06:12,1191148,461427,504939,224782,1191148
2023-04-30 06:13,1191169,461448,504939,224782,1191169
2023-04-30 06:14,1191191,461470,504939,224782,1191191
2023-04-30 06:15,1191214,461493,504939,224782,1191214
2023-04-30 06:16,1191237,461514,504939,224784,1191237
2023-04-30 06:17,1191259,461536,504939,224784,1191259
2023-04-30 06:18,1191282,461559,504939,224784,1191282
2023-04-30 06:19,1191304,461580,504939,224785,1191304
2023-04-30 06:20,1191327,461603,504939,224785,1191327
2023-04-30 06:21,1191350,461626,504939,224785,1191350
2023-04-30 06:22,1191372,461648,504939,224785,1191372
2023-04-30 06:23,1191395,461669,504941,224785,1191395
2023-04-30 06:24,1191417,461690,504941,224786,1191417
2023-04-30 06:25,1191440,461713,504941,224786,1191440
2023-04-30 06:26,1191461,461732,504941,224788,1191461
2023-04-30 06:27,1191483,461754,504941,224788,1191483
2023-04-30 06:28,1191506,461776,504941,224789,1191506
2023-04-30 06:29,1191529,461799,504941,224789,1191529
2023-04-30 06:30,1191552,461822,504941,224789,1191552
2023-04-30 06:31,1191574,461844,504941,224789,1191574
2023-04-30 06:32,1191596,461864,504941,224791,1191596
2023-04-30 06:33,1191620,461882,504945,224793,1191620
2023-04-30 06:34,1191642,461903,504945,224794,1191642
2023-04-30 06:35,1191664,461923,504946,224795,1191664
2023-04-30 06:36,1191685,461944,504946,224795,1191685
2023-04-30 06:37,1191709,461968,504946,224795,1191709
2023-04-30 06:38,1191732,461990,504946,224796,1191732
2023-04-30 06:39,1191755,462012,504946,224797,1191755
2023-04-30 06:40,1191776,462032,504946,224798,1191776
2023-04-30 06:41,1191800,462053,504948,224799,1191800
2023-04-30 06:42,1191822,462074,504948,224800,1191822
2023-04-30 06:43,1191845,462097,504948,224800,1191845
2023-04-30 06:44,1191867,462119,504948,224800,1191867
2023-04-30 06:45,1191889,462140,504948,224801,1191889
2023-04-30 06:46,1191912,462162,504948,224802,1191912
2023-04-30 06:47,1191935,462180,504951,224804,1191935
2023-04-30 06:48,1191956,462199,504951,224806,1191956
2023-04-30 06:49,1191979,462220,504952,224807,1191979
2023-04-30 06:50,1192002,462242,504952,224808,1192002
2023-04-30 06:51,1192026,462264,504954,224808,1192026
2023-04-30 06:52,1192047,462285,504954,224808,1192047
2023-04-30 06:53,1192071,462306,504956,224809,1192071
2023-04-30 06:54,1192092,462327,504956,224809,1192092
2023-04-30 06:56,1192116,462348,504959,224809,1192116
2023-04-30 06:57,1192137,462367,504959,224811,1192137
2023-04-30 06:58,1192161,462389,504959,224813,1192161
2023-04-30 06:59,1192182,462410,504959,224813,1192182
2023-04-30 07:00,1192205,462433,504959,224813,1192205
2023-04-30 07:01,1192233,462461,504959,224813,1192233
2023-04-30 07:02,1192261,462488,504960,224813,1192261
2023-04-30 07:03,1192288,462513,504960,224815,1192288
2023-04-30 07:04,1192313,462537,504961,224815,1192313
2023-04-30 07:05,1192339,462563,504961,224815,1192339
2023-04-30 07:06,1192367,462590,504962,224815,1192367
2023-04-30 07:07,1192394,462617,504962,224815,1192394
2023-04-30 07:08,1192420,462643,504963,224814,1192420
2023-04-30 07:09,1192446,462668,504963,224815,1192446
2023-04-30 07:10,1192473,462693,504964,224816,1192473
2023-04-30 07:11,1192499,462718,504964,224817,1192499
2023-04-30 07:12,1192527,462746,504964,224817,1192527
2023-04-30 07:13,1192554,462772,504964,224818,1192554
2023-04-30 07:14,1192579,462796,504964,224819,1192579
2023-04-30 07:15,1192607,462823,504964,224820,1192607
2023-04-30 07:16,1192634,462850,504964,224820,1192634
2023-04-30 07:17,1192661,462875,504964,224822,1192661
2023-04-30 07:18,1192687,462896,504967,224824,1192687
2023-04-30 07:19,1192713,462922,504967,224824,1192713
2023-04-30 07:20,1192741,462948,504968,224825,1192741
2023-04-30 07:21,1192769,462976,504968,224825,1192769
2023-04-30 07:22,1192795,463000,504970,224825,1192795
2023-04-30 07:23,1192821,463027,504970,224824,1192821
2023-04-30 07:24,1192848,463053,504971,224824,1192848
2023-04-30 07:25,1192874,463078,504971,224825,1192874
2023-04-30 07:26,1192900,463099,504974,224827,1192900
2023-04-30 07:27,1192928,463127,504974,224827,1192928
2023-04-30 07:28,1192953,463150,504976,224827,1192953
2023-04-30 07:29,1192980,463174,504976,224830,1192980
2023-04-30 07:30,1193006,463196,504979,224831,1193006
2023-04-30 07:31,1193034,463222,504979,224833,1193034
2023-04-30 07:32,1193060,463245,504982,224833,1193060
2023-04-30 07:33,1193086,463267,504983,224836,1193086
2023-04-30 07:34,1193112,463288,504983,224841,1193112
2023-04-30 07:35,1193140,463316,504983,224841,1193140
2023-04-30 07:36,1193165,463340,504983,224842,1193165
2023-04-30 07:37,1193191,463364,504985,224842,1193191
2023-04-30 07:38,1193219,463391,504985,224843,1193219
2023-04-30 07:39,1193247,463418,504986,224843,1193247
2023-04-30 07:40,1193273,463443,504986,224844,1193273
2023-04-30 07:41,1193300,463468,504987,224845,1193300
2023-04-30 07:42,1193327,463496,504987,224844,1193327
2023-04-30 07:44,1193352,463518,504989,224845,1193352
2023-04-30 07:45,1193380,463545,504989,224846,1193380
2023-04-30 07:46,1193406,463571,504989,224846,1193406
2023-04-30 07:47,1193433,463597,504989,224847,1193433
2023-04-30 07:48,1193460,463624,504989,224847,1193460
2023-04-30 07:49,1193489,463652,504989,224848,1193489
2023-04-30 07:50,1193516,463679,504989,224848,1193516
2023-04-30 07:51,1193541,463704,504989,224848,1193541
2023-04-30 07:52,1193568,463731,504989,224848,1193568
2023-04-30 07:53,1193594,463756,504989,224849,1193594
2023-04-30 07:54,1193622,463776,504996,224850,1193622
2023-04-30 07:55,1193647,463796,504996,224855,1193647
2023-04-30 07:56,1193674,463822,504996,224856,1193674
2023-04-30 07:57,1193700,463847,504996,224857,1193700
2023-04-30 07:58,1193727,463874,504996,224857,1193727
2023-04-30 07:59,1193756,463901,504996,224859,1193756
2023-04-30 08:00,1193781,463926,504996,224859,1193781
2023-04-30 08:01,1193804,463948,504996,224860,1193804
2023-04-30 08:02,1193826,463969,504996,224861,1193826
2023-04-30 08:03,1193849,463991,504996,224862,1193849
2023-04-30 08:04,1193873,464004,505006,224863,1193873
2023-04-30 08:05,1193897,464026,505006,224865,1193897
2023-04-30 08:06,1193920,464048,505006,224866,1193920
2023-04-30 08:07,1193943,464071,505006,224866,1193943
2023-04-30 08:08,1193966,464093,505006,224867,1193966
2023-04-30 08:09,1193989,464115,505006,224868,1193989
2023-04-30 08:10,1194012,464138,505006,224868,1194012
2023-04-30 08:11,1194036,464163,505006,224867,1194036
2023-04-30 08:12,1194059,464173,505018,224868,1194059
2023-04-30 08:13,1194082,464196,505018,224868,1194082
2023-04-30 08:14,1194105,464215,505020,224870,1194105
2023-04-30 08:15,1194128,464236,505020,224872,1194128
2023-04-30 08:16,1194151,464257,505021,224873,1194151
2023-04-30 08:17,1194175,464278,505021,224876,1194175
2023-04-30 08:18,1194200,464298,505025,224877,1194200
2023-04-30 08:19,1194222,464318,505025,224879,1194222
2023-04-30 08:20,1194245,464340,505026,224879,1194245
2023-04-30 08:21,1194269,464363,505026,224880,1194269
2023-04-30 08:22,1194293,464386,505027,224880,1194293
2023-04-30 08:23,1194316,464408,505027,224881,1194316
2023-04-30 08:24,1194339,464429,505029,224881,1194339
2023-04-30 08:25,1194362,464452,505029,224881,1194362
2023-04-30 08:26,1194386,464471,505034,224881,1194386
2023-04-30 08:27,1194409,464492,505034,224883,1194409
2023-04-30 08:28,1194433,464510,505040,224883,1194433
2023-04-30 08:29,1194457,464534,505040,224883,1194457
2023-04-30 08:31,1194480,464553,505043,224884,1194480
2023-04-30 08:32,1194505,464578,505043,224884,1194505
2023-04-30 08:33,1194527,464594,505047,224886,1194527
2023-04-30 08:34,1194551,464617,505047,224887,1194551
2023-04-30 08:35,1194575,464633,505052,224890,1194575
2023-04-30 08:36,1194598,464654,505052,224892,1194598
2023-04-30 08:37,1194622,464673,505054,224895,1194622
2023-04-30 08:38,1194645,464694,505055,224896,1194645
2023-04-30 08:39,1194667,464715,505055,224897,1194667
2023-04-30 08:40,1194692,464736,505057,224899,1194692
2023-04-30 08:41,1194715,464757,505057,224901,1194715
2023-04-30 08:42,1194739,464780,505058,224901,1194739
2023-04-30 08:43,1194763,464803,505058,224902,1194763
2023-04-30 08:44,1194787,464825,505060,224902,1194787
2023-04-30 08:45,1194809,464846,505060,224903,1194809
2023-04-30 08:46,1194833,464867,505060,224906,1194833
2023-04-30 08:47,1194856,464887,505060,224909,1194856
2023-04-30 08:48,1194880,464906,505063,224911,1194880
2023-04-30 08:49,1194903,464928,505063,224912,1194903
2023-04-30 08:50,1194926,464948,505064,224914,1194926
2023-04-30 08:51,1194949,464969,505064,224916,1194949
2023-04-30 08:52,1194972,464989,505065,224918,1194972
2023-04-30 08:53,1194995,465013,505065,224917,1194995
2023-04-30 08:54,1195018,465032,505067,224919,1195018
2023-04-30 08:55,1195043,465055,505067,224921,1195043
2023-04-30 08:56,1195067,465074,505069,224924,1195067
2023-04-30 08:57,1195089,465095,505069,224925,1195089
2023-04-30 08:58,1195113,465117,505069,224927,1195113
2023-04-30 08:59,1195137,465140,505069,224928,1195137
2023-04-30 09:00,1195153,465154,505069,224930,1195153
2023-04-30 09:01,1195163,465163,505069,224931,1195163
2023-04-30 09:02,1195175,465174,505069,224932,1195175
2023-04-30 09:03,1195184,465182,505069,224933,1195184
2023-04-30 09:04,1195195,465191,505069,224935,1195195
2023-04-30 09:05,1195205,465185,505084,224936,1195205
2023-04-30 09:06,1195214,465192,505084,224938,1195214
2023-04-30 09:07,1195225,465197,505088,224940,1195225
2023-04-30 09:08,1195235,465206,505088,224941,1195235
2023-04-30 09:09,1195245,465217,505087,224941,1195245
2023-04-30 09:10,1195255,465225,505087,224943,1195255
2023-04-30 09:11,1195265,465224,505094,224947,1195265
2023-04-30 09:12,1195275,465234,505094,224947,1195275
2023-04-30 09:13,1195285,465237,505098,224950,1195285
2023-04-30 09:14,1195296,465246,505098,224952,1195296
2023-04-30 09:15,1195306,465247,505103,224956,1195306
2023-04-30 09:16,1195316,465257,505103,224956,1195316
2023-04-30 09:17,1195327,465264,505106,224957,1195327
2023-04-30 09:19,1195338,465274,505106,224958,1195338
2023-04-30 09:20,1195347,465281,505108,224958,1195347
2023-04-30 09:21,1195358,465291,505108,224959,1195358
2023-04-30 09:22,1195368,465295,505110,224963,1195368
2023-04-30 09:23,1195378,465302,505111,224965,1195378
2023-04-30 09:24,1195388,465312,505111,224965,1195388
2023-04-30 09:25,1195398,465318,505115,224965,1195398
2023-04-30 09:26,1195409,465328,505115,224966,1195409
2023-04-30 09:27,1195419,465332,505118,224969,1195419
2023-04-30 09:28,1195430,465341,505118,224971,1195430
2023-04-30 09:29,1195440,465343,505123,224974,1195440
2023-04-30 09:30,1195450,465350,505123,224977,1195450
2023-04-30 09:31,1195460,465352,505130,224978,1195460
2023-04-30 09:32,1195472,465358,505130,224984,1195472
2023-04-30 09:33,1195481,465363,505130,224988,1195481
2023-04-30 09:34,1195492,465373,505130,224989,1195492
2023-04-30 09:35,1195503,465383,505131,224989,1195503
2023-04-30 09:36,1195513,465389,505131,224993,1195513
2023-04-30 09:37,1195524,465397,505134,224993,1195524
2023-04-30 09:38,1195534,465407,505134,224993,1195534
2023-04-30 09:39,1195544,465411,505139,224994,1195544
2023-04-30 09:40,1195554,465418,505139,224997,1195554
2023-04-30 09:41,1195565,465423,505143,224999,1195565
2023-04-30 09:42,1195575,465431,505143,225001,1195575
2023-04-30 09:43,1195585,465438,505144,225003,1195585
2023-04-30 09:44,1195595,465444,505144,225007,1195595
2023-04-30 09:45,1195606,465452,505146,225008,1195606
2023-04-30 09:46,1195616,465460,505146,225010,1195616
2023-04-30 09:47,1195627,465466,505151,225010,1195627
2023-04-30 09:48,1195637,465475,505151,225011,1195637
2023-04-30 09:49,1195648,465482,505152,225014,1195648
2023-04-30 09:50,1195658,465489,505152,225017,1195658
2023-04-30 09:51,1195669,465497,505156,225016,1195669
2023-04-30 09:52,1195679,465506,505156,225017,1195679
2023-04-30 09:53,1195689,465514,505158,225017,1195689
2023-04-30 09:54,1195699,465522,505158,225019,1195699
2023-04-30 09:55,1195709,465526,505164,225019,1195709
2023-04-30 09:56,1195720,465537,505164,225019,1195720
2023-04-30 09:57,1195730,465545,505165,225020,1195730
2023-04-30 09:58,1195739,465551,505165,225023,1195739
2023-04-30 09:59,1195751,465553,505167,225031,1195751
2023-04-30 10:00,1195784,465584,505167,225033,1195784
2023-04-30 10:01,1195820,465615,505171,225034,1195820
2023-04-30 10:02,1195857,465650,505171,225036,1195857
2023-04-30 10:03,1195893,465681,505172,225040,1195893
2023-04-30 10:04,1195930,465715,505172,225043,1195930
2023-04-30 10:06,1195967,465746,505174,225047,1195967
2023-04-30 10:07,1196008,465786,505174,225048,1196008
2023-04-30 10:08,1196044,465816,505178,225050,1196044
2023-04-30 10:09,1196079,465847,505179,225053,1196079
2023-04-30 10:10,1196118,465884,505180,225054,1196118
2023-04-30 10:11,1196154,465918,505180,225056,1196154
2023-04-30 10:12,1196190,465944,505187,225059,1196190
2023-04-30 10:13,1196228,465982,505187,225059,1196228
2023-04-30 10:14,1196266,466020,505186,225060,1196266
2023-04-30 10:15,1196303,466055,505186,225062,1196303
2023-04-30 10:16,1196339,466087,505187,225065,1196339
2023-04-30 10:17,1196376,466121,505187,225068,1196376
2023-04-30 10:18,1196412,466149,505193,225070,1196412
2023-04-30 10:19,1196449,466183,505193,225073,1196449
2023-04-30 10:20,1196485,466214,505195,225076,1196485
2023-04-30 10:21,1196522,466249,505195,225078,1196522
2023-04-30 10:22,1196559,466282,505197,225080,1196559
2023-04-30 10:23,1196597,466320,505197,225080,1196597
2023-04-30 10:24,1196631,466346,505200,225085,1196631
2023-04-30 10:25,1196669,466384,505200,225085,1196669
2023-04-30 10:26,1196706,466418,505202,225086,1196706
2023-04-30 10:27,1196745,466456,505202,225087,1196745
2023-04-30 10:28,1196782,466491,505202,225089,1196782
2023-04-30 10:29,1196819,466526,505202,225091,1196819
2023-04-30 10:30,1196856,466556,505208,225092,1196856
2023-04-30 10:31,1196891,466588,505208,225095,1196891
2023-04-30 10:32,1196930,466622,505211,225097,1196930
2023-04-30 10:33,1196965,466655,505212,225098,1196965
2023-04-30 10:34,1197001,466689,505212,225100,1197001
2023-04-30 10:35,1197040,466724,505215,225101,1197040
2023-04-30 10:36,1197076,466759,505215,225102,1197076
2023-04-30 10:37,1197113,466795,505215,225103,1197113
2023-04-30 10:38,1197150,466832,505215,225103,1197150
2023-04-30 10:39,1197189,466866,505217,225106,1197189
2023-04-30 10:40,1197228,466902,505217,225109,1197228
2023-04-30 10:41,1197264,466934,505219,225111,1197264
2023-04-30 10:42,1197302,466970,505219,225113,1197302
2023-04-30 10:43,1197337,467001,505221,225115,1197337
2023-04-30 10:44,1197374,467037,505221,225116,1197374
2023-04-30 10:45,1197412,467073,505223,225116,1197412
2023-04-30 10:46,1197450,467109,505223,225118,1197450
2023-04-30 10:47,1197488,467141,505229,225118,1197488
2023-04-30 10:48,1197525,467176,505229,225120,1197525
2023-04-30 10:49,1197561,467210,505230,225121,1197561
2023-04-30 10:50,1197595,467243,505230,225122,1197595
2023-04-30 10:51,1197635,467276,505232,225127,1197635
2023-04-30 10:52,1197672,467307,505232,225133,1197672
2023-04-30 10:53,1197707,467336,505235,225136,1197707
2023-04-30 10:55,1197747,467373,505235,225139,1197747
2023-04-30 10:56,1197783,467403,505237,225143,1197783
2023-04-30 10:57,1197821,467440,505237,225144,1197821
2023-04-30 10:58,1197857,467472,505240,225145,1197857
2023-04-30 10:59,1197896,467510,505240,225146,1197896
2023-04-30 11:00,1197931,467541,505242,225148,1197931
2023-04-30 11:01,1197971,467578,505242,225151,1197971
2023-04-30 11:02,1198008,467611,505243,225154,1198008
2023-04-30 11:03,1198049,467648,505243,225158,1198049
2023-04-30 11:04,1198086,467674,505250,225162,1198086
2023-04-30 11:05,1198127,467710,505252,225165,1198127
2023-04-30 11:06,1198164,467744,505252,225168,1198164
2023-04-30 11:07,1198202,467780,505253,225169,1198202
2023-04-30 11:08,1198242,467818,505253,225171,1198242
2023-04-30 11:09,1198281,467848,505257,225176,1198281
2023-04-30 11:10,1198319,467882,505257,225180,1198319
2023-04-30 11:11,1198360,467919,505261,225180,1198360
2023-04-30 11:12,1198397,467952,505261,225184,1198397
2023-04-30 11:13,1198436,467985,505266,225185,1198436
2023-04-30 11:14,1198475,468023,505266,225186,1198475
2023-04-30 11:15,1198515,468058,505270,225187,1198515
2023-04-30 11:16,1198555,468096,505270,225189,1198555
2023-04-30 11:17,1198592,468126,505277,225189,1198592
2023-04-30 11:18,1198631,468164,505277,225190,1198631
2023-04-30 11:19,1198672,468199,505281,225192,1198672
2023-04-30 11:20,1198710,468233,505281,225196,1198710
2023-04-30 11:21,1198749,468266,505284,225199,1198749
2023-04-30 11:22,1198789,468305,505284,225200,1198789
2023-04-30 11:23,1198829,468334,505293,225202,1198829
2023-04-30 11:24,1198867,468368,505293,225206,1198867
2023-04-30 11:25,1198904,468399,505295,225210,1198904
2023-04-30 11:26,1198945,468437,505295,225213,1198945
2023-04-30 11:27,1198983,468470,505300,225213,1198983
2023-04-30 11:28,1199022,468507,505300,225215,1199022
2023-04-30 11:29,1199062,468543,505303,225216,1199062
2023-04-30 11:30,1199099,468576,505303,225220,1199099
2023-04-30 11:31,1199140,468615,505305,225220,1199140
2023-04-30 11:32,1199177,468650,505305,225222,1199177
2023-04-30 11:33,1199218,468684,505310,225224,1199218
2023-04-30 11:34,1199256,468717,505310,225229,1199256
2023-04-30 11:35,1199299,468758,505310,225231,1199299
2023-04-30 11:36,1199337,468795,505310,225232,1199337
2023-04-30 11:37,1199375,468830,505310,225235,1199375
2023-04-30 11:38,1199414,468854,505322,225238,1199414
2023-04-30 11:39,1199454,468893,505322,225239,1199454
2023-04-30 11:40,1199493,468924,505328,225241,1199493
2023-04-30 11:42,1199534,468962,505328,225244,1199534
2023-04-30 11:43,1199574,468999,505331,225244,1199574
2023-04-30 11:44,1199612,469037,505331,225244,1199612
2023-04-30 11:45,1199652,469070,505335,225247,1199652
2023-04-30 11:46,1199690,469105,505335,225250,1199690
2023-04-30 11:47,1199731,469143,505337,225251,1199731
2023-04-30 11:48,1199769,469180,505337,225252,1199769
2023-04-30 11:49,1199807,469214,505341,225252,1199807
2023-04-30 11:50,1199847,469250,505341,225256,1199847
2023-04-30 11:51,1199884,469280,505345,225259,1199884
2023-04-30 11:52,1199925,469320,505345,225260,1199925
2023-04-30 11:53,1199963,469353,505348,225262,1199963
2023-04-30 11:54,1200003,469390,505348,225265,1200003
2023-04-30 11:55,1200041,469421,505355,225265,1200041
2023-04-30 11:56,1200081,469458,505355,225268,1200081
2023-04-30 11:57,1200121,469493,505356,225272,1200121
2023-04-30 11:58,1200160,469530,505356,225274,1200160
2023-04-30 11:59,1200200,469570,505356,225274,1200200
2023-04-30 12:00,1200233,469602,505356,225275,1200233
2023-04-30 12:01,1200260,469626,505357,225277,1200260
2023-04-30 12:02,1200287,469651,505357,225279,1200287
2023-04-30 12:03,1200312,469674,505358,225280,1200312
2023-04-30 12:04,1200338,469695,505358,225285,1200338
2023-04-30 12:05,1200365,469718,505359,225288,1200365
2023-04-30 12:06,1200390,469740,505359,225291,1200390
2023-04-30 12:07,1200416,469765,505359,225292,1200416
2023-04-30 12:08,1200443,469787,505362,225294,1200443
2023-04-30 12:09,1200470,469811,505362,225297,1200470
2023-04-30 12:10,1200495,469833,505364,225298,1200495
2023-04-30 12:11,1200523,469859,505364,225300,1200523
2023-04-30 12:12,1200549,469878,505368,225303,1200549
2023-04-30 12:13,1200574,469899,505368,225307,1200574
2023-04-30 12:14,1200601,469915,505374,225312,1200601
2023-04-30 12:15,1200630,469941,505374,225315,1200630
2023-04-30 12:16,1200655,469962,505376,225317,1200655
2023-04-30 12:17,1200682,469985,505376,225321,1200682
2023-04-30 12:18,1200707,470001,505381,225325,1200707
2023-04-30 12:19,1200732,470023,505381,225328,1200732
2023-04-30 12:20,1200758,470041,505385,225332,1200758
2023-04-30 12:21,1200786,470067,505385,225334,1200786
2023-04-30 12:22,1200812,470087,505388,225337,1200812
2023-04-30 12:23,1200838,470111,505388,225339,1200838
2023-04-30 12:24,1200865,470135,505390,225340,1200865
2023-04-30 12:25,1200891,470158,505390,225343,1200891
2023-04-30 12:26,1200917,470176,505396,225345,1200917
2023-04-30 12:27,1200944,470197,505396,225351,1200944
2023-04-30 12:28,1200969,470217,505399,225353,1200969
2023-04-30 12:30,1200995,470241,505399,225355,1200995
2023-04-30 12:31,1201022,470263,505402,225357,1201022
2023-04-30 12:32,1201048,470288,505402,225358,1201048
2023-04-30 12:33,1201075,470308,505407,225360,1201075
2023-04-30 12:34,1201103,470332,505407,225364,1201103
2023-04-30 12:35,1201128,470348,505412,225368,1201128
2023-04-30 12:36,1201155,470367,505413,225375,1201155
2023-04-30 12:37,1201182,470389,505413,225380,1201182
2023-04-30 12:38,1201207,470410,505415,225382,1201207
2023-04-30 12:39,1201234,470433,505415,225386,1201234
2023-04-30 12:40,1201259,470450,505417,225392,1201259
2023-04-30 12:41,1201286,470471,505417,225398,1201286
2023-04-30 12:42,1201312,470497,505417,225398,1201312
2023-04-30 12:43,1201339,470519,505417,225403,1201339
2023-04-30 12:44,1201366,470545,505417,225404,1201366
2023-04-30 12:45,1201391,470570,505417,225404,1201391
2023-04-30 12:46,1201418,470591,505417,225410,1201418
2023-04-30 12:47,1201444,470612,505417,225415,1201444
2023-04-30 12:48,1201470,470638,505417,225415,1201470
2023-04-30 12:49,1201497,470664,505417,225416,1201497
2023-04-30 12:50,1201523,470664,505441,225418,1201523
2023-04-30 12:51,1201550,470689,505441,225420,1201550
2023-04-30 12:52,1201577,470714,505441,225422,1201577
2023-04-30 12:53,1201601,470733,505441,225427,1201601
2023-04-30 12:54,1201629,470759,505441,225429,1201629
2023-04-30 12:55,1201654,470783,505441,225430,1201654
2023-04-30 12:56,1201681,470808,505441,225432,1201681
2023-04-30 12:57,1201706,470828,505441,225437,1201706
2023-04-30 12:58,1201733,470854,505441,225438,1201733
2023-04-30 12:59,1201760,470877,505441,225442,1201760
2023-04-30 13:00,1201796,470891,505461,225444,1201796
2023-04-30 13:01,1201834,470925,505461,225448,1201834
2023-04-30 13:02,1201875,470964,505461,225450,1201875
2023-04-30 13:03,1201917,471004,505461,225452,1201917
2023-04-30 13:04,1201956,471040,505461,225455,1201956
2023-04-30 13:05,1201996,471079,505461,225456,1201996
2023-04-30 13:06,1202035,471115,505461,225459,1202035
2023-04-30 13:07,1202078,471156,505461,225461,1202078
2023-04-30 13:08,1202117,471194,505461,225462,1202117
2023-04-30 13:09,1202157,471233,505461,225463,1202157
2023-04-30 13:10,1202198,471255,505475,225468,1202198
2023-04-30 13:11,1202239,471295,505475,225469,1202239
2023-04-30 13:12,1202280,471327,505482,225471,1202280
2023-04-30 13:13,1202318,471363,505482,225473,1202318
2023-04-30 13:14,1202358,471399,505486,225473,1202358
2023-04-30 13:15,1202400,471438,505486,225476,1202400
2023-04-30 13:16,1202440,471473,505491,225476,1202440
2023-04-30 13:18,1202481,471512,505491,225478,1202481
2023-04-30 13:19,1202523,471552,505491,225480,1202523
2023-04-30 13:20,1202561,471583,505492,225486,1202561
2023-04-30 13:21,1202602,471624,505492,225486,1202602
2023-04-30 13:22,1202643,471660,505492,225491,1202643
2023-04-30 13:23,1202683,471698,505492,225493,1202683
2023-04-30 13:24,1202722,471730,505497,225495,1202722
2023-04-30 13:25,1202761,471769,505497,225495,1202761
2023-04-30 13:26,1202802,471802,505498,225502,1202802
2023-04-30 13:27,1202841,471838,505498,225505,1202841
2023-04-30 13:28,1202882,471872,505503,225507,1202882
2023-04-30 13:29,1202924,471908,505507,225509,1202924
2023-04-30 13:30,1202964,471947,505507,225510,1202964
2023-04-30 13:31,1203003,471982,505510,225511,1203003
2023-04-30 13:32,1203044,472020,505510,225514,1203044
2023-04-30 13:33,1203087,472053,505517,225517,1203087
2023-04-30 13:34,1203126,472091,505517,225518,1203126
2023-04-30 13:35,1203168,472132,505517,225519,1203168
2023-04-30 13:36,1203207,472166,505517,225524,1203207
2023-04-30 13:37,1203247,472199,505521,225527,1203247
2023-04-30 13:38,1203288,472232,505525,225531,1203288
2023-04-30 13:39,1203326,472270,505525,225531,1203326
2023-04-30 13:40,1203366,472305,505529,225532,1203366
2023-04-30 13:41,1203408,472341,505529,225538,1203408
2023-04-30 13:42,1203447,472372,505534,225541,1203447
2023-04-30 13:43,1203487,472408,505534,225545,1203487
2023-04-30 13:44,1203529,472449,505536,225544,1203529
2023-04-30 13:45,1203569,472485,505538,225546,1203569
2023-04-30 13:46,1203608,472523,505538,225547,1203608
2023-04-30 13:47,1203648,472555,505545,225548,1203648
2023-04-30 13:48,1203689,472594,505545,225550,1203689
2023-04-30 13:49,1203728,472626,505550,225552,1203728
2023-04-30 13:50,1203769,472666,505550,225553,1203769
2023-04-30 13:51,1203809,472696,505556,225557,1203809
2023-04-30 13:52,1203850,472733,505556,225561,1203850
2023-04-30 13:53,1203887,472764,505560,225563,1203887
2023-04-30 13:54,1203927,472799,505561,225567,1203927
2023-04-30 13:55,1203970,472842,505561,225567,1203970
2023-04-30 13:56,1204010,472875,505566,225569,1204010
2023-04-30 13:57,1204051,472913,505566,225572,1204051
2023-04-30 13:58,1204091,472950,505567,225574,1204091
2023-04-30 13:59,1204133,472989,505567,225577,1204133
2023-04-30 14:00,1204170,473010,505578,225582,1204170
2023-04-30 14:01,1204212,473051,505578,225583,1204212
2023-04-30 14:02,1204253,473087,505579,225587,1204253
2023-04-30 14:03,1204295,473122,505579,225594,1204295
2023-04-30 14:04,1204333,473154,505585,225594,1204333
2023-04-30 14:06,1204373,473190,505585,225598,1204373
2023-04-30 14:07,1204413,473228,505586,225599,1204413
2023-04-30 14:08,1204453,473266,505586,225601,1204453
2023-04-30 14:09,1204492,473297,505588,225607,1204492
2023-04-30 14:10,1204530,473334,505588,225608,1204530
2023-04-30 14:11,1204572,473373,505590,225609,1204572
2023-04-30 14:12,1204610,473408,505590,225612,1204610
2023-04-30 14:13,1204651,473448,505591,225612,1204651
2023-04-30 14:14,1204690,473486,505591,225613,1204690
2023-04-30 14:15,1204732,473521,505595,225616,1204732
2023-04-30 14:16,1204771,473559,505595,225617,1204771
2023-04-30 14:17,1204810,473593,505598,225619,1204810
2023-04-30 14:18,1204850,473630,505598,225622,1204850
2023-04-30 14:19,1204890,473667,505598,225625,1204890
2023-04-30 14:20,1204929,473704,505598,225627,1204929
2023-04-30 14:21,1204971,473740,505601,225630,1204971
2023-04-30 14:22,1205011,473780,505601,225630,1205011
2023-04-30 14:23,1205051,473811,505608,225632,1205051
2023-04-30 14:24,1205087,473844,505608,225635,1205087
2023-04-30 14:25,1205129,473882,505611,225636,1205129
2023-04-30 14:26,1205168,473918,505611,225639,1205168
2023-04-30 14:27,1205207,473948,505615,225644,1205207
2023-04-30 14:28,1205246,473985,505615,225646,1205246
2023-04-30 14:29,1205288,474021,505619,225648,1205288
2023-04-30 14:30,1205325,474056,505619,225650,1205325
2023-04-30 14:31,1205367,474094,505623,225650,1205367
2023-04-30 14:32,1205408,474132,505623,225653,1205408
2023-04-30 14:33,1205447,474168,505625,225654,1205447
2023-04-30 14:34,1205487,474204,505625,225658,1205487
2023-04-30 14:35,1205524,474237,505626,225661,1205524
2023-04-30 14:36,1205566,474279,505626,225661,1205566
2023-04-30 14:37,1205606,474311,505631,225664,1205606
2023-04-30 14:38,1205645,474346,505631,225668,1205645
2023-04-30 14:39,1205687,474385,505634,225668,1205687
2023-04-30 14:40,1205727,474420,505634,225673,1205727
2023-04-30 14:41,1205766,474452,505637,225677,1205766
2023-04-30 14:42,1205807,474491,505637,225679,1205807
2023-04-30 14:43,1205844,474523,505640,225681,1205844
2023-04-30 14:44,1205887,474562,505641,225684,1205887
2023-04-30 14:45,1205926,474598,505642,225686,1205926
2023-04-30 14:46,1205965,474636,505642,225687,1205965
2023-04-30 14:47,1206004,474672,505642,225690,1206004
2023-04-30 14:48,1206042,474704,505642,225696,1206042
2023-04-30 14:49,1206085,474742,505643,225700,1206085
2023-04-30 14:50,1206124,474778,505643,225703,1206124
2023-04-30 14:51,1206162,474813,505646,225703,1206162
2023-04-30 14:53,1206204,474853,505646,225705,1206204
2023-04-30 14:54,1206241,474882,505652,225707,1206241
2023-04-30 14:55,1206285,474924,505652,225709,1206285
2023-04-30 14:56,1206322,474956,505655,225711,1206322
2023-04-30 14:57,1206363,474994,505655,225714,1206363
2023-04-30 14:58,1206404,475032,505658,225714,1206404
2023-04-30 14:59,1206443,475071,505658,225714,1206443
2023-04-30 15:00,1206480,475106,505660,225714,1206480
2023-04-30 15:01,1206491,475113,505660,225718,1206491
2023-04-30 15:02,1206504,475126,505660,225718,1206504
2023-04-30 15:03,1206515,475133,505660,225722,1206515
2023-04-30 15:04,1206528,475138,505665,225725,1206528
2023-04-30 15:05,1206539,475149,505665,225725,1206539
2023-04-30 15:06,1206551,475153,505671,225727,1206551
2023-04-30 15:07,1206562,475161,505671,225730,1206562
2023-04-30 15:08,1206573,475167,505674,225732,1206573
2023-04-30 15:09,1206586,475176,505674,225736,1206586
2023-04-30 15:10,1206597,475183,505676,225738,1206597
2023-04-30 15:11,1206608,475193,505676,225739,1206608
2023-04-30 15:12,1206620,475200,505681,225739,1206620
2023-04-30 15:13,1206631,475210,505681,225740,1206631
2023-04-30 15:14,1206643,475215,505683,225745,1206643
2023-04-30 15:15,1206654,475224,505683,225747,1206654
2023-04-30 15:16,1206666,475224,505688,225754,1206666
2023-04-30 15:17,1206677,475232,505688,225757,1206677
2023-04-30 15:18,1206689,475240,505692,225757,1206689
2023-04-30 15:19,1206700,475249,505692,225759,1206700
2023-04-30 15:20,1206712,475247,505702,225763,1206712
2023-04-30 15:21,1206724,475257,505702,225765,1206724
2023-04-30 15:22,1206735,475264,505705,225766,1206735
2023-04-30 15:23,1206746,475274,505705,225767,1206746
2023-04-30 15:24,1206758,475286,505705,225767,1206758
2023-04-30 15:25,1206769,475291,505705,225773,1206769
2023-04-30 15:26,1206781,475303,505705,225773,1206781
2023-04-30 15:27,1206792,475315,505705,225772,1206792
2023-04-30 15:28,1206805,475311,505721,225773,1206805
2023-04-30 15:29,1206816,475321,505721,225774,1206816
2023-04-30 15:30,1206827,475330,505721,225776,1206827
2023-04-30 15:31,1206840,475337,505725,225778,1206840
2023-04-30 15:32,1206851,475345,505726,225780,1206851
2023-04-30 15:33,1206863,475355,505726,225782,1206863
2023-04-30 15:34,1206874,475362,505729,225783,1206874
2023-04-30 15:35,1206887,475363,505737,225787,1206887
2023-04-30 15:36,1206898,475371,505737,225790,1206898
2023-04-30 15:37,1206910,475375,505741,225794,1206910
2023-04-30 15:38,1206921,475380,505741,225800,1206921
2023-04-30 15:40,1206932,475380,505750,225802,1206932
2023-04-30 15:41,1206944,475393,505750,225801,1206944
2023-04-30 15:42,1206956,475401,505753,225802,1206956
2023-04-30 15:43,1206967,475411,505753,225803,1206967
2023-04-30 15:44,1206978,475412,505760,225806,1206978
2023-04-30 15:45,1206990,475423,505760,225807,1206990
2023-04-30 15:46,1207001,475434,505760,225807,1207001
2023-04-30 15:47,1207012,475445,505760,225807,1207012
2023-04-30 15:48,1207024,475457,505760,225807,1207024
2023-04-30 15:49,1207037,475467,505760,225810,1207037
2023-04-30 15:50,1207048,475456,505777,225815,1207048
2023-04-30 15:51,1207059,475466,505777,225816,1207059
2023-04-30 15:52,1207071,475475,505779,225817,1207071
2023-04-30 15:53,1207082,475485,505779,225818,1207082
2023-04-30 15:54,1207094,475497,505780,225817,1207094
2023-04-30 15:55,1207106,475507,505780,225819,1207106
2023-04-30 15:56,1207117,475515,505780,225822,1207117
2023-04-30 15:57,1207128,475523,505780,225825,1207128
2023-04-30 15:58,1207140,475523,505789,225828,1207140
2023-04-30 15:59,1207151,475534,505789,225828,1207151
2023-04-30 16:00,1207163,475539,505796,225828,1207163
2023-04-30 16:01,1207175,475548,505796,225831,1207175
2023-04-30 16:02,1207187,475551,505801,225835,1207187
2023-04-30 16:03,1207198,475561,505801,225836,1207198
2023-04-30 16:04,1207211,475564,505807,225840,1207211
2023-04-30 16:05,1207223,475572,505810,225841,1207223
2023-04-30 16:06,1207235,475581,505810,225844,1207235
2023-04-30 16:07,1207247,475589,505814,225844,1207247
2023-04-30 16:08,1207259,475595,505816,225848,1207259
2023-04-30 16:09,1207270,475603,505816,225851,1207270
2023-04-30 16:10,1207283,475611,505820,225852,1207283
2023-04-30 16:11,1207294,475619,505820,225855,1207294
2023-04-30 16:12,1207306,475623,505826,225857,1207306
2023-04-30 16:13,1207318,475631,505826,225861,1207318
2023-04-30 16:14,1207331,475634,505831,225866,1207331
2023-04-30 16:15,1207343,475645,505831,225867,1207343
2023-04-30 16:16,1207355,475650,505835,225870,1207355
2023-04-30 16:17,1207367,475658,505835,225874,1207367
2023-04-30 16:18,1207379,475661,505842,225876,1207379
2023-04-30 16:19,1207391,475670,505843,225878,1207391
2023-04-30 16:20,1207403,475679,505843,225881,1207403
2023-04-30 16:21,1207415,475679,505852,225884,1207415
2023-04-30 16:22,1207427,475684,505855,225888,1207427
2023-04-30 16:23,1207439,475694,505855,225890,1207439
2023-04-30 16:24,1207452,475703,505855,225894,1207452
2023-04-30 16:25,1207463,475712,505855,225896,1207463
2023-04-30 16:27,1207475,475722,505855,225898,1207475
2023-04-30 16:28,1207487,475730,505855,225902,1207487
2023-04-30 16:29,1207500,475741,505855,225904,1207500
2023-04-30 16:30,1207511,475746,505855,225910,1207511
2023-04-30 16:31,1207524,475758,505855,225911,1207524
2023-04-30 16:32,1207535,475765,505855,225915,1207535
2023-04-30 16:33,1207547,475771,505855,225921,1207547
2023-04-30 16:34,1207559,475779,505855,225925,1207559
2023-04-30 16:35,1207571,475762,505878,225931,1207571
2023-04-30 16:36,1207583,475773,505878,225932,1207583
2023-04-30 16:37,1207594,475779,505880,225935,1207594
2023-04-30 16:38,1207607,475792,505880,225935,1207607
2023-04-30 16:39,1207619,475799,505884,225936,1207619
2023-04-30 16:40,1207631,475808,505884,225939,1207631
2023-04-30 16:41,1207642,475815,505886,225941,1207642
2023-04-30 16:42,1207655,475824,505889,225942,1207655
2023-04-30 16:43,1207668,475830,505894,225944,1207668
2023-04-30 16:44,1207679,475839,505894,225946,1207679
2023-04-30 16:45,1207691,475842,505899,225950,1207691
2023-04-30 16:46,1207704,475851,505899,225954,1207704
2023-04-30 16:47,1207716,475850,505906,225960,1207716
2023-04-30 16:48,1207729,475863,505906,225960,1207729
2023-04-30 16:49,1207741,475869,505910,225962,1207741
2023-04-30 16:50,1207753,475880,505910,225963,1207753
2023-04-30 16:51,1207765,475884,505912,225969,1207765
2023-04-30 16:52,1207777,475894,505912,225971,1207777
2023-04-30 16:53,1207789,475901,505913,225975,1207789
2023-04-30 16:54,1207800,475906,505913,225981,1207800
2023-04-30 16:55,1207812,475913,505916,225983,1207812
2023-04-30 16:56,1207823,475918,505918,225987,1207823
2023-04-30 16:57,1207836,475928,505918,225990,1207836
2023-04-30 16:58,1207847,475935,505920,225992,1207847
2023-04-30 16:59,1207860,475946,505920,225994,1207860
2023-04-30 17:00,1207878,475963,505921,225994,1207878
2023-04-30 17:01,1207900,475981,505921,225998,1207900
2023-04-30 17:02,1207921,475995,505924,226002,1207921
2023-04-30 17:03,1207941,476014,505924,226003,1207941
2023-04-30 17:04,1207964,476034,505926,226004,1207964
2023-04-30 17:05,1207986,476054,505926,226006,1207986
2023-04-30 17:06,1208005,476073,505928,226004,1208005
2023-04-30 17:07,1208027,476093,505928,226006,1208027
2023-04-30 17:08,1208048,476110,505931,226007,1208048
2023-04-30 17:09,1208069,476131,505931,226007,1208069
2023-04-30 17:10,1208091,476149,505935,226007,1208091
2023-04-30 17:11,1208112,476167,505935,226010,1208112
2023-04-30 17:12,1208134,476183,505937,226014,1208134
2023-04-30 17:14,1208155,476200,505937,226018,1208155
2023-04-30 17:15,1208178,476216,505939,226023,1208178
2023-04-30 17:16,1208198,476234,505939,226025,1208198
2023-04-30 17:17,1208219,476251,505943,226025,1208219
2023-04-30 17:18,1208241,476268,505943,226030,1208241
2023-04-30 17:19,1208262,476286,505945,226031,1208262
2023-04-30 17:20,1208282,476302,505945,226035,1208282
2023-04-30 17:21,1208304,476318,505950,226036,1208304
2023-04-30 17:22,1208326,476338,505950,226038,1208326
2023-04-30 17:23,1208348,476351,505957,226040,1208348
2023-04-30 17:24,1208369,476370,505957,226042,1208369
2023-04-30 17:25,1208390,476383,505961,226046,1208390
2023-04-30 17:26,1208411,476401,505961,226049,1208411
2023-04-30 17:27,1208432,476415,505965,226052,1208432
2023-04-30 17:28,1208455,476433,505965,226057,1208455
2023-04-30 17:29,1208476,476449,505969,226058,1208476
2023-04-30 17:30,1208498,476466,505969,226063,1208498
2023-04-30 17:31,1208520,476479,505976,226065,1208520
2023-04-30 17:32,1208542,476500,505976,226066,1208542
2023-04-30 17:33,1208564,476517,505978,226069,1208564
2023-04-30 17:34,1208584,476536,505978,226070,1208584
2023-04-30 17:35,1208605,476547,505985,226073,1208605
2023-04-30 17:36,1208626,476566,505985,226075,1208626
2023-04-30 17:37,1208647,476577,505988,226082,1208647
2023-04-30 17:38,1208668,476594,505988,226086,1208668
2023-04-30 17:39,1208691,476612,505990,226089,1208691
2023-04-30 17:40,1208711,476632,505990,226089,1208711
2023-04-30 17:41,1208733,476648,505994,226091,1208733
2023-04-30 17:42,1208754,476664,505994,226096,1208754
2023-04-30 17:43,1208775,476678,505998,226099,1208775
2023-04-30 17:44,1208798,476695,505998,226105,1208798
2023-04-30 17:45,1208819,476709,506003,226107,1208819
2023-04-30 17:46,1208839,476726,506003,226110,1208839
2023-04-30 17:47,1208863,476743,506008,226112,1208863
2023-04-30 17:48,1208884,476761,506008,226115,1208884
2023-04-30 17:49,1208905,476778,506010,226117,1208905
2023-04-30 17:50,1208926,476795,506010,226121,1208926
2023-04-30 17:51,1208947,476809,506013,226125,1208947
2023-04-30 17:52,1208968,476824,506017,226127,1208968
2023-04-30 17:53,1208989,476841,506017,226131,1208989
2023-04-30 17:54,1209010,476854,506024,226132,1209010
2023-04-30 17:55,1209032,476874,506024,226134,1209032
2023-04-30 17:56,1209053,476890,506024,226139,1209053
2023-04-30 17:57,1209075,476906,506024,226145,1209075
2023-04-30 17:58,1209096,476925,506024,226147,1209096
2023-04-30 17:59,1209118,476945,506024,226149,1209118
2023-04-30 18:00,1209150,476972,506024,226154,1209150
2023-04-30 18:02,1209182,476999,506024,226159,1209182
2023-04-30 18:03,1209213,477029,506024,226160,1209213
2023-04-30 18:04,1209245,477055,506024,226166,1209245
2023-04-30 18:05,1209278,477067,506043,226168,1209278
2023-04-30 18:06,1209309,477098,506043,226168,1209309
2023-04-30 18:07,1209344,477130,506043,226171,1209344
2023-04-30 18:08,1209377,477158,506043,226176,1209377
2023-04-30 18:09,1209409,477186,506043,226180,1209409
2023-04-30 18:10,1209440,477215,506043,226182,1209440
2023-04-30 18:11,1209472,477244,506043,226185,1209472
2023-04-30 18:12,1209504,477275,506043,226186,1209504
2023-04-30 18:13,1209538,477309,506043,226186,1209538
2023-04-30 18:14,1209569,477317,506061,226191,1209569
2023-04-30 18:15,1209603,477349,506061,226193,1209603
2023-04-30 18:16,1209635,477372,506067,226196,1209635
2023-04-30 18:17,1209667,477403,506067,226197,1209667
2023-04-30 18:18,1209700,477430,506068,226202,1209700
2023-04-30 18:19,1209732,477460,506068,226204,1209732
2023-04-30 18:20,1209765,477490,506069,226206,1209765
2023-04-30 18:21,1209799,477520,506069,226210,1209799
2023-04-30 18:22,1209832,477548,506072,226212,1209832
2023-04-30 18:23,1209864,477576,506072,226216,1209864
2023-04-30 18:24,1209896,477602,506072,226222,1209896
2023-04-30 18:25,1209928,477631,506072,226225,1209928
2023-04-30 18:26,1209960,477661,506072,226227,1209960
2023-04-30 18:27,1209991,477690,506072,226229,1209991
2023-04-30 18:28,1210024,477720,506072,226232,1210024
2023-04-30 18:29,1210056,477752,506072,226232,1210056
2023-04-30 18:30,1210090,477785,506072,226233,1210090
2023-04-30 18:31,1210120,477815,506072,226233,1210120
2023-04-30 18:32,1210152,477846,506072,226234,1210152
2023-04-30 18:33,1210186,477879,506072,226235,1210186
2023-04-30 18:34,1210219,477885,506096,226238,1210219
2023-04-30 18:35,1210252,477916,506096,226240,1210252
2023-04-30 18:36,1210285,477948,506096,226241,1210285
2023-04-30 18:37,1210316,477976,506096,226244,1210316
2023-04-30 18:38,1210348,478006,506096,226246,1210348
2023-04-30 18:39,1210381,478035,506096,226250,1210381
2023-04-30 18:40,1210414,478066,506096,226252,1210414
2023-04-30 18:41,1210448,478094,506096,226258,1210448
2023-04-30 18:42,1210479,478125,506096,226258,1210479
2023-04-30 18:43,1210511,478137,506113,226261,1210511
2023-04-30 18:44,1210544,478168,506113,226263,1210544
2023-04-30 18:45,1210576,478194,506119,226263,1210576
2023-04-30 18:46,1210609,478223,506119,226267,1210609
2023-04-30 18:47,1210642,478248,506124,226270,1210642
2023-04-30 18:48,1210673,478275,506124,226274,1210673
2023-04-30 18:50,1210706,478306,506126,226274,1210706
2023-04-30 18:51,1210738,478333,506130,226275,1210738
2023-04-30 18:52,1210769,478364,506130,226275,1210769
2023-04-30 18:53,1210804,478392,506133,226279,1210804
2023-04-30 18:54,1210837,478423,506133,226281,1210837
2023-04-30 18:55,1210867,478445,506136,226286,1210867
2023-04-30 18:56,1210900,478474,506135,226291,1210900
2023-04-30 18:57,1210933,478506,506135,226292,1210933
2023-04-30 18:58,1210963,478527,506139,226297,1210963
2023-04-30 18:59,1210998,478560,506139,226299,1210998
2023-04-30 19:00,1211028,478583,506143,226302,1211028
2023-04-30 19:01,1211048,478602,506143,226303,1211048
2023-04-30 19:02,1211068,478615,506147,226306,1211068
2023-04-30 19:03,1211089,478636,506147,226306,1211089
2023-04-30 19:04,1211108,478644,506155,226309,1211108
2023-04-30 19:05,1211129,478663,506155,226311,1211129
2023-04-30 19:06,1211150,478675,506160,226315,1211150
2023-04-30 19:07,1211170,478691,506160,226319,1211170
2023-04-30 19:08,1211191,478703,506164,226324,1211191
2023-04-30 19:09,1211212,478723,506164,226325,1211212
2023-04-30 19:10,1211234,478741,506166,226327,1211234
2023-04-30 19:11,1211255,478757,506166,226332,1211255
2023-04-30 19:12,1211274,478773,506167,226334,1211274
2023-04-30 19:13,1211295,478793,506167,226335,1211295
2023-04-30 19:14,1211315,478810,506169,226336,1211315
2023-04-30 19:15,1211337,478831,506169,226337,1211337
2023-04-30 19:16,1211357,478849,506168,226340,1211357
2023-04-30 19:17,1211378,478862,506173,226343,1211378
2023-04-30 19:18,1211399,478878,506173,226348,1211399
2023-04-30 19:19,1211419,478891,506177,226351,1211419
2023-04-30 19:20,1211439,478908,506177,226354,1211439
2023-04-30 19:21,1211459,478919,506180,226360,1211459
2023-04-30 19:22,1211479,478936,506180,226363,1211479
2023-04-30 19:23,1211502,478952,506183,226367,1211502
2023-04-30 19:24,1211521,478968,506183,226370,1211521
2023-04-30 19:25,1211543,478985,506183,226375,1211543
2023-04-30 19:26,1211564,479003,506186,226375,1211564
2023-04-30 19:27,1211585,479022,506186,226377,1211585
2023-04-30 19:28,1211605,479040,506187,226378,1211605
2023-04-30 19:29,1211627,479053,506192,226382,1211627
2023-04-30 19:30,1211647,479072,506192,226383,1211647
2023-04-30 19:31,1211668,479088,506196,226384,1211668
2023-04-30 19:32,1211689,479107,506196,226386,1211689
2023-04-30 19:33,1211709,479120,506199,226390,1211709
2023-04-30 19:34,1211730,479137,506199,226394,1211730
2023-04-30 19:35,1211752,479148,506206,226398,1211752
2023-04-30 19:37,1211771,479162,506208,226401,1211771
2023-04-30 19:38,1211793,479182,506208,226403,1211793
2023-04-30 19:39,1211813,479196,506212,226405,1211813
2023-04-30 19:40,1211834,479212,506216,226406,1211834
2023-04-30 19:41,1211854,479230,506216,226408,1211854
2023-04-30 19:42,1211875,479248,506216,226411,1211875
2023-04-30 19:43,1211895,479266,506216,226413,1211895
2023-04-30 19:44,1211916,479279,506221,226416,1211916
2023-04-30 19:45,1211937,479297,506221,226419,1211937
2023-04-30 19:46,1211956,479309,506224,226423,1211956
2023-04-30 19:47,1211977,479328,506224,226425,1211977
2023-04-30 19:48,1211998,479343,506225,226430,1211998
2023-04-30 19:49,1212018,479358,506225,226435,1212018
2023-04-30 19:50,1212039,479374,506229,226436,1212039
2023-04-30 19:51,1212062,479395,506230,226437,1212062
2023-04-30 19:52,1212082,479410,506231,226441,1212082
2023-04-30 19:53,1212102,479429,506231,226442,1212102
2023-04-30 19:54,1212123,479442,506235,226446,1212123
2023-04-30 19:55,1212142,479462,506235,226445,1212142
2023-04-30 19:56,1212163,479473,506240,226450,1212163
2023-04-30 19:57,1212184,479492,506240,226452,1212184
2023-04-30 19:58,1212204,479508,506244,226452,1212204
2023-04-30 19:59,1212225,479526,506244,226455,1212225
2023-04-30 20:00,1212251,479546,506249,226456,1212251
2023-04-30 20:01,1212284,479578,506250,226456,1212284
2023-04-30 20:02,1212314,479606,506250,226458,1212314
2023-04-30 20:03,1212346,479633,506254,226459,1212346
2023-04-30 20:04,1212380,479665,506254,226461,1212380
2023-04-30 20:05,1212412,479689,506259,226464,1212412
2023-04-30 20:06,1212442,479716,506259,226467,1212442
2023-04-30 20:07,1212473,479743,506262,226468,1212473
2023-04-30 20:08,1212507,479772,506266,226469,1212507
2023-04-30 20:09,1212537,479799,506266,226472,1212537
2023-04-30 20:10,1212570,479825,506271,226474,1212570
2023-04-30 20:11,1212602,479851,506271,226480,1212602
2023-04-30 20:12,1212634,479874,506276,226484,1212634
2023-04-30 20:13,1212666,479906,506276,226484,1212666
2023-04-30 20:14,1212696,479930,506280,226486,1212696
2023-04-30 20:15,1212727,479958,506280,226489,1212727
2023-04-30 20:16,1212761,479984,506287,226490,1212761
2023-04-30 20:17,1212791,480008,506287,226496,1212791
2023-04-30 20:18,1212824,480039,506289,226496,1212824
2023-04-30 20:19,1212856,480068,506289,226499,1212856
2023-04-30 20:20,1212890,480095,506292,226503,1212890
2023-04-30 20:21,1212921,480124,506292,226505,1212921
2023-04-30 20:22,1212953,480151,506293,226509,1212953
2023-04-30 20:23,1212983,480179,506293,226511,1212983
2023-04-30 20:25,1213016,480202,506300,226514,1213016
2023-04-30 20:26,1213047,480229,506300,226518,1213047
2023-04-30 20:27,1213079,480249,506308,226522,1213079
2023-04-30 20:28,1213110,480279,506308,226523,1213110
2023-04-30 20:29,1213142,480306,506311,226525,1213142
2023-04-30 20:30,1213175,480335,506315,226525,1213175
2023-04-30 20:31,1213207,480365,506315,226527,1213207
2023-04-30 20:32,1213240,480394,506316,226530,1213240
2023-04-30 20:33,1213270,480422,506316,226532,1213270
2023-04-30 20:34,1213302,480447,506319,226536,1213302
2023-04-30 20:35,1213333,480471,506319,226543,1213333
2023-04-30 20:36,1213365,480498,506322,226545,1213365
2023-04-30 20:37,1213399,480529,506322,226548,1213399
2023-04-30 20:38,1213429,480547,506333,226549,1213429
2023-04-30 20:39,1213462,480578,506334,226550,1213462
2023-04-30 20:40,1213494,480608,506334,226552,1213494
2023-04-30 20:41,1213527,480634,506338,226555,1213527
2023-04-30 20:42,1213559,480665,506338,226556,1213559
2023-04-30 20:43,1213590,480689,506341,226560,1213590
2023-04-30 20:44,1213623,480719,506341,226563,1213623
2023-04-30 20:45,1213655,480749,506341,226565,1213655
2023-04-30 20:46,1213688,480780,506341,226567,1213688
2023-04-30 20:47,1213718,480807,506342,226569,1213718
2023-04-30 20:48,1213750,480838,506342,226570,1213750
2023-04-30 20:49,1213782,480865,506347,226570,1213782
2023-04-30 20:50,1213814,480894,506347,226573,1213814
2023-04-30 20:51,1213846,480921,506350,226575,1213846
2023-04-30 20:52,1213878,480952,506350,226576,1213878
2023-04-30 20:53,1213911,480980,506354,226577,1213911
2023-04-30 20:54,1213943,481010,506354,226579,1213943
2023-04-30 20:55,1213972,481032,506356,226584,1213972
2023-04-30 20:56,1214007,481064,506356,226587,1214007
2023-04-30 20:57,1214038,481090,506360,226588,1214038
2023-04-30 20:58,1214071,481121,506362,226588,1214071
2023-04-30 20:59,1214105,481152,506362,226591,1214105
2023-04-30 21:00,1214125,481166,506364,226595,1214125
2023-04-30 21:01,1214144,481185,506364,226595,1214144
2023-04-30 21:02,1214162,481199,506366,226597,1214162
2023-04-30 21:03,1214178,481209,506372,226597,1214178
2023-04-30 21:04,1214195,481225,506372,226598,1214195
2023-04-30 21:05,1214212,481231,506378,226603,1214212
2023-04-30 21:06,1214229,481243,506378,226608,1214229
2023-04-30 21:07,1214247,481256,506383,226608,1214247
2023-04-30 21:08,1214264,481268,506383,226613,1214264
2023-04-30 21:09,1214280,481279,506388,226613,1214280
2023-04-30 21:10,1214297,481291,506388,226618,1214297
2023-04-30 21:11,1214314,481302,506394,226618,1214314
2023-04-30 21:13,1214330,481317,506394,226619,1214330
2023-04-30 21:14,1214347,481328,506398,226621,1214347
2023-04-30 21:15,1214364,481344,506398,226622,1214364
2023-04-30 21:16,1214381,481355,506402,226624,1214381
2023-04-30 21:17,1214399,481371,506402,226626,1214399
2023-04-30 21:18,1214416,481383,506405,226628,1214416
2023-04-30 21:19,1214433,481399,506405,226629,1214433
2023-04-30 21:20,1214450,481415,506406,226629,1214450
2023-04-30 21:21,1214467,481424,506409,226634,1214467
2023-04-30 21:22,1214483,481438,506409,226636,1214483
2023-04-30 21:23,1214500,481448,506413,226639,1214500
2023-04-30 21:24,1214518,481461,506413,226644,1214518
2023-04-30 21:25,1214534,481472,506416,226646,1214534
2023-04-30 21:26,1214551,481489,506416,226646,1214551
2023-04-30 21:27,1214568,481500,506421,226647,1214568
2023-04-30 21:28,1214585,481515,506421,226649,1214585
2023-04-30 21:29,1214602,481522,506427,226653,1214602
2023-04-30 21:30,1214619,481537,506427,226655,1214619
2023-04-30 21:31,1214635,481544,506432,226659,1214635
2023-04-30 21:32,1214654,481562,506432,226660,1214654
2023-04-30 21:33,1214671,481576,506432,226663,1214671
2023-04-30 21:34,1214687,481588,506432,226667,1214687
2023-04-30 21:35,1214705,481598,506438,226669,1214705
2023-04-30 21:36,1214722,481612,506438,226672,1214722
2023-04-30 21:37,1214739,481624,506441,226674,1214739
2023-04-30 21:38,1214757,481638,506441,226678,1214757
2023-04-30 21:39,1214773,481649,506442,226682,1214773
2023-04-30 21:40,1214789,481664,506442,226683,1214789
2023-04-30 21:41,1214806,481676,506446,226684,1214806
2023-04-30 21:42,1214824,481691,506446,226687,1214824
2023-04-30 21:43,1214840,481702,506448,226690,1214840
2023-04-30 21:44,1214857,481717,506448,226692,1214857
2023-04-30 21:45,1214874,481724,506456,226694,1214874
2023-04-30 21:46,1214890,481738,506456,226696,1214890
2023-04-30 21:47,1214907,481748,506459,226700,1214907
2023-04-30 21:48,1214926,481763,506459,226704,1214926
2023-04-30 21:49,1214943,481770,506465,226708,1214943
2023-04-30 21:50,1214959,481785,506465,226709,1214959
2023-04-30 21:51,1214977,481800,506465,226712,1214977
2023-04-30 21:52,1214994,481812,506469,226713,1214994
2023-04-30 21:53,1215010,481824,506469,226717,1215010
2023-04-30 21:54,1215029,481837,506474,226718,1215029
2023-04-30 21:55,1215046,481852,506474,226720,1215046
2023-04-30 21:56,1215063,481863,506480,226720,1215063
2023-04-30 21:57,1215081,481880,506480,226721,1215081
2023-04-30 21:58,1215099,481888,506486,226725,1215099
2023-04-30 22:00,1215116,481902,506486,226728,1215116
2023-04-30 22:01,1215128,481909,506490,226729,1215128
2023-04-30 22:02,1215139,481915,506490,226734,1215139
2023-04-30 22:03,1215150,481917,506496,226737,1215150
2023-04-30 22:04,1215161,481923,506496,226742,1215161
2023-04-30 22:05,1215171,481922,506503,226746,1215171
2023-04-30 22:06,1215181,481928,506503,226750,1215181
2023-04-30 22:07,1215191,481932,506507,226752,1215191
2023-04-30 22:08,1215205,481946,506507,226752,1215205
2023-04-30 22:09,1215215,481948,506510,226757,1215215
2023-04-30 22:10,1215225,481956,506510,226759,1215225
2023-04-30 22:11,1215236,481965,506511,226760,1215236
2023-04-30 22:12,1215246,481971,506511,226764,1215246
2023-04-30 22:13,1215256,481979,506512,226765,1215256
2023-04-30 22:14,1215267,481989,506512,226766,1215267
2023-04-30 22:15,1215277,481991,506517,226769,1215277
2023-04-30 22:16,1215287,481997,506517,226773,1215287
2023-04-30 22:17,1215298,482000,506522,226776,1215298
2023-04-30 22:18,1215309,482011,506522,226776,1215309
2023-04-30 22:19,1215320,482015,506527,226778,1215320
2023-04-30 22:20,1215330,482020,506527,226783,1215330
2023-04-30 22:21,1215341,482023,506532,226786,1215341
2023-04-30 22:22,1215352,482031,506535,226786,1215352
2023-04-30 22:23,1215362,482039,506535,226788,1215362
2023-04-30 22:24,1215372,482042,506540,226790,1215372
2023-04-30 22:25,1215382,482047,506541,226794,1215382
2023-04-30 22:26,1215393,482055,506541,226797,1215393
2023-04-30 22:27,1215403,482060,506544,226799,1215403
2023-04-30 22:28,1215413,482065,506547,226801,1215413
2023-04-30 22:29,1215424,482074,506547,226803,1215424
2023-04-30 22:30,1215434,482082,506547,226805,1215434
2023-04-30 22:31,1215445,482091,506547,226807,1215445
2023-04-30 22:32,1215455,482094,506551,226810,1215455
2023-04-30 22:33,1215465,482102,506551,226812,1215465
2023-04-30 22:34,1215476,482107,506555,226814,1215476
2023-04-30 22:35,1215488,482117,506555,226816,1215488
2023-04-30 22:36,1215498,482122,506559,226817,1215498
2023-04-30 22:37,1215508,482127,506559,226822,1215508
2023-04-30 22:38,1215518,482128,506565,226825,1215518
2023-04-30 22:39,1215529,482136,506565,226828,1215529
2023-04-30 22:40,1215540,482138,506569,226833,1215540
2023-04-30 22:41,1215551,482147,506569,226835,1215551
2023-04-30 22:42,1215561,482151,506572,226838,1215561
2023-04-30 22:43,1215571,482157,506572,226842,1215571
2023-04-30 22:44,1215583,482165,506574,226844,1215583
2023-04-30 22:45,1215593,482175,506574,226844,1215593
2023-04-30 22:46,1215603,482180,506576,226847,1215603
2023-04-30 22:48,1215614,482185,506576,226853,1215614
2023-04-30 22:49,1215625,482193,506578,226854,1215625
2023-04-30 22:50,1215635,482198,506578,226859,1215635
2023-04-30 22:51,1215646,482200,506584,226862,1215646
2023-04-30 22:52,1215656,482207,506584,226865,1215656
2023-04-30 22:53,1215667,482211,506586,226870,1215667
2023-04-30 22:54,1215676,482216,506586,226874,1215676
2023-04-30 22:55,1215687,482221,506590,226876,1215687
2023-04-30 22:56,1215698,482229,506590,226879,1215698
2023-04-30 22:57,1215708,482233,506596,226879,1215708
2023-04-30 22:58,1215718,482241,506596,226881,1215718
2023-04-30 22:59,1215729,482247,506596,226886,1215729
2023-04-30 23:00,1215741,482256,506596,226889,1215741
2023-04-30 23:01,1215764,482277,506596,226891,1215764
2023-04-30 23:02,1215787,482298,506596,226893,1215787
2023-04-30 23:03,1215811,482318,506596,226897,1215811
2023-04-30 23:04,1215834,482338,506596,226900,1215834
2023-04-30 23:05,1215856,482356,506596,226904,1215856
2023-04-30 23:06,1215881,482379,506596,226906,1215881
2023-04-30 23:07,1215904,482386,506609,226909,1215904
2023-04-30 23:08,1215927,482408,506609,226910,1215927
2023-04-30 23:09,1215950,482427,506611,226912,1215950
2023-04-30 23:10,1215974,482447,506611,226916,1215974
2023-04-30 23:11,1215998,482464,506615,226919,1215998
2023-04-30 23:12,1216020,482482,506617,226921,1216020
2023-04-30 23:13,1216044,482503,506617,226924,1216044
2023-04-30 23:14,1216066,482524,506618,226924,1216066
2023-04-30 23:15,1216090,482544,506618,226928,1216090
2023-04-30 23:16,1216113,482560,506622,226931,1216113
2023-04-30 23:17,1216136,482582,506622,226932,1216136
2023-04-30 23:18,1216159,482596,506628,226935,1216159
2023-04-30 23:19,1216182,482615,506628,226939,1216182
2023-04-30 23:20,1216204,482633,506630,226941,1216204
2023-04-30 23:21,1216228,482654,506630,226944,1216228
2023-04-30 23:22,1216251,482675,506631,226945,1216251
2023-04-30 23:23,1216273,482694,506631,226948,1216273
2023-04-30 23:24,1216298,482714,506634,226950,1216298
2023-04-30 23:25,1216320,482733,506634,226953,1216320
2023-04-30 23:26,1216343,482750,506639,226954,1216343
2023-04-30 23:27,1216367,482771,506639,226957,1216367
2023-04-30 23:28,1216390,482792,506639,226959,1216390
2023-04-30 23:29,1216413,482811,506639,226963,1216413
2023-04-30 23:30,1216435,482828,506641,226966,1216435
2023-04-30 23:31,1216458,482851,506641,226966,1216458
2023-04-30 23:32,1216482,482870,506643,226969,1216482
2023-04-30 23:33,1216505,482889,506645,226971,1216505
2023-04-30 23:35,1216530,482912,506645,226973,1216530
2023-04-30 23:36,1216553,482925,506652,226976,1216553
2023-04-30 23:37,1216575,482943,506652,226980,1216575
2023-04-30 23:38,1216598,482961,506656,226981,1216598
2023-04-30 23:39,1216621,482982,506656,226983,1216621
2023-04-30 23:40,1216643,482997,506657,226989,1216643
2023-04-30 23:41,1216667,483017,506657,226993,1216667
2023-04-30 23:42,1216691,483036,506659,226996,1216691
2023-04-30 23:43,1216713,483049,506661,227003,1216713
2023-04-30 23:44,1216736,483070,506661,227005,1216736
2023-04-30 23:45,1216760,483091,506662,227007,1216760
2023-04-30 23:46,1216782,483109,506662,227011,1216782
2023-04-30 23:47,1216806,483133,506662,227011,1216806
2023-04-30 23:48,1216829,483153,506662,227014,1216829
2023-04-30 23:49,1216852,483172,506662,227018,1216852
2023-04-30 23:50,1216874,483191,506662,227021,1216874
2023-04-30 23:51,1216897,483206,506662,227029,1216897
2023-04-30 23:52,1216920,483227,506662,227031,1216920
2023-04-30 23:53,1216944,483249,506662,227033,1216944
2023-04-30 23:54,1216966,483268,506662,227036,1216966
2023-04-30 23:55,1216990,483269,506681,227040,1216990
2023-04-30 23:56,1217014,483287,506681,227046,1217014
2023-04-30 23:57,1217036,483306,506683,227047,1217036
2023-04-30 23:58,1217059,483328,506683,227048,1217059
2023-04-30 23:59,1217082,483346,506685,227051,1217082
2023-05-01 00:00,1217111,483373,506685,227053,1217111
2023-05-01 00:01,1217145,483403,506687,227055,1217145
2023-05-01 00:02,1217180,483438,506687,227055,1217180
2023-05-01 00:03,1217214,483467,506688,227059,1217214
2023-05-01 00:04,1217248,483499,506688,227061,1217248
2023-05-01 00:05,1217281,483523,506695,227063,1217281
2023-05-01 00:06,1217316,483556,506695,227065,1217316
2023-05-01 00:07,1217352,483583,506701,227068,1217352
2023-05-01 00:08,1217386,483613,506701,227072,1217386
2023-05-01 00:09,1217420,483642,506704,227074,1217420
2023-05-01 00:10,1217453,483671,506704,227078,1217453
2023-05-01 00:11,1217489,483699,506708,227082,1217489
2023-05-01 00:12,1217521,483728,506708,227085,1217521
2023-05-01 00:13,1217555,483759,506708,227088,1217555
2023-05-01 00:14,1217591,483789,506708,227094,1217591
2023-05-01 00:15,1217628,483820,506714,227094,1217628
2023-05-01 00:16,1217661,483852,506714,227095,1217661
2023-05-01 00:17,1217697,483883,506717,227097,1217697
2023-05-01 00:18,1217732,483918,506717,227097,1217732
2023-05-01 00:19,1217765,483948,506718,227099,1217765
2023-05-01 00:20,1217800,483983,506718,227099,1217800
2023-05-01 00:21,1217833,484013,506718,227102,1217833
2023-05-01 00:22,1217869,484044,506718,227107,1217869
2023-05-01 00:24,1217902,484071,506722,227109,1217902
2023-05-01 00:25,1217937,484103,506722,227112,1217937
2023-05-01 00:26,1217970,484127,506730,227113,1217970
2023-05-01 00:27,1218005,484159,506730,227116,1218005
2023-05-01 00:28,1218039,484193,506730,227116,1218039
2023-05-01 00:29,1218076,484228,506730,227118,1218076
2023-05-01 00:30,1218111,484258,506734,227119,1218111
2023-05-01 00:31,1218144,484289,506734,227121,1218144
2023-05-01 00:32,1218178,484317,506736,227125,1218178
2023-05-01 00:33,1218212,484351,506736,227125,1218212
2023-05-01 00:34,1218247,484380,506740,227127,1218247
2023-05-01 00:35,1218281,484409,506740,227132,1218281
2023-05-01 00:36,1218314,484438,506742,227134,1218314
2023-05-01 00:37,1218350,484474,506742,227134,1218350
2023-05-01 00:38,1218384,484498,506746,227140,1218384
2023-05-01 00:39,1218420,484530,506748,227142,1218420
2023-05-01 00:40,1218455,484565,506748,227142,1218455
2023-05-01 00:41,1218488,484592,506752,227144,1218488
2023-05-01 00:42,1218523,484618,506756,227149,1218523
2023-05-01 00:43,1218557,484652,506756,227149,1218557
2023-05-01 00:44,1218591,484680,506759,227152,1218591
2023-05-01 00:45,1218625,484711,506759,227155,1218625
2023-05-01 00:46,1218659,484739,506761,227159,1218659
2023-05-01 00:47,1218694,484772,506761,227161,1218694
2023-05-01 00:48,1218727,484802,506764,227161,1218727
2023-05-01 00:49,1218763,484836,506764,227163,1218763
2023-05-01 00:50,1218798,484864,506768,227166,1218798
2023-05-01 00:51,1218832,484897,506768,227167,1218832
2023-05-01 00:52,1218868,484930,506770,227168,1218868
2023-05-01 00:53,1218901,484960,506770,227171,1218901
2023-05-01 00:54,1218936,484988,506772,227176,1218936
2023-05-01 00:55,1218971,485020,506772,227179,1218971
2023-05-01 00:56,1219005,485048,506775,227182,1219005
2023-05-01 00:57,1219041,485084,506775,227182,1219041
2023-05-01 00:58,1219075,485113,506776,227186,1219075
2023-05-01 00:59,1219109,485147,506776,227186,1219109
2023-05-01 01:00,1219136,485172,506776,227188,1219136
2023-05-01 01:01,1219161,485194,506776,227191,1219161
2023-05-01 01:02,1219186,485218,506776,227192,1219186
2023-05-01 01:03,1219211,485239,506780,227192,1219211
2023-05-01 01:04,1219237,485264,506780,227193,1219237
2023-05-01 01:05,1219263,485288,506781,227194,1219263
2023-05-01 01:06,1219287,485310,506781,227196,1219287
2023-05-01 01:07,1219313,485333,506781,227199,1219313
2023-05-01 01:08,1219337,485355,506781,227201,1219337
2023-05-01 01:09,1219362,485377,506782,227203,1219362
2023-05-01 01:11,1219387,485402,506782,227203,1219387
2023-05-01 01:12,1219413,485420,506788,227205,1219413
2023-05-01 01:13,1219438,485445,506788,227205,1219438
2023-05-01 01:14,1219463,485468,506789,227206,1219463
2023-05-01 01:15,1219488,485493,506789,227206,1219488
2023-05-01 01:16,1219514,485518,506789,227207,1219514
2023-05-01 01:17,1219539,485543,506789,227207,1219539
2023-05-01 01:18,1219564,485564,506790,227210,1219564
2023-05-01 01:19,1219588,485587,506790,227211,1219588
2023-05-01 01:20,1219615,485610,506794,227211,1219615
2023-05-01 01:21,1219641,485631,506794,227216,1219641
2023-05-01 01:22,1219665,485652,506795,227218,1219665
2023-05-01 01:23,1219689,485677,506794,227218,1219689
2023-05-01 01:24,1219716,485702,506794,227220,1219716
2023-05-01 01:25,1219739,485722,506796,227221,1219739
2023-05-01 01:26,1219766,485748,506796,227222,1219766
2023-05-01 01:27,1219790,485769,506798,227223,1219790
2023-05-01 01:28,1219816,485793,506798,227225,1219816
2023-05-01 01:29,1219842,485818,506799,227225,1219842
2023-05-01 01:30,1219866,485842,506799,227225,1219866
2023-05-01 01:31,1219891,485862,506801,227228,1219891
2023-05-01 01:32,1219917,485888,506801,227228,1219917
2023-05-01 01:33,1219941,485910,506801,227230,1219941
2023-05-01 01:34,1219967,485934,506801,227232,1219967
2023-05-01 01:35,1219991,485955,506802,227234,1219991
2023-05-01 01:36,1220017,485978,506802,227237,1220017
2023-05-01 01:37,1220042,485996,506804,227242,1220042
2023-05-01 01:38,1220068,486020,506804,227244,1220068
2023-05-01 01:39,1220093,486042,506805,227246,1220093
2023-05-01 01:40,1220119,486063,506805,227251,1220119
2023-05-01 01:41,1220145,486086,506807,227252,1220145
2023-05-01 01:42,1220170,486111,506807,227252,1220170
2023-05-01 01:43,1220198,486134,506813,227251,1220198
2023-05-01 01:44,1220222,486158,506813,227251,1220222
2023-05-01 01:45,1220247,486183,506814,227250,1220247
2023-05-01 01:46,1220272,486208,506814,227250,1220272
2023-05-01 01:47,1220298,486232,506816,227250,1220298
2023-05-01 01:48,1220323,486255,506816,227252,1220323
2023-05-01 01:49,1220348,486277,506817,227254,1220348
2023-05-01 01:50,1220374,486302,506817,227255,1220374
2023-05-01 01:51,1220398,486327,506816,227255,1220398
2023-05-01 01:52,1220424,486352,506816,227256,1220424
2023-05-01 01:53,1220448,486372,506820,227256,1220448
2023-05-01 01:54,1220473,486397,506820,227256,1220473
2023-05-01 01:55,1220500,486422,506822,227256,1220500
2023-05-01 01:56,1220523,486443,506822,227258,1220523
2023-05-01 01:58,1220549,486467,506824,227258,1220549
2023-05-01 01:59,1220574,486492,506824,227258,1220574
2023-05-01 02:00,1220600,486517,506825,227258,1220600
2023-05-01 02:01,1220641,486556,506826,227259,1220641
2023-05-01 02:02,1220679,486593,506826,227260,1220679
2023-05-01 02:03,1220719,486632,506827,227260,1220719
2023-05-01 02:04,1220757,486667,506827,227263,1220757
2023-05-01 02:05,1220796,486701,506829,227266,1220796
2023-05-01 02:06,1220838,486744,506829,227265,1220838
2023-05-01 02:07,1220877,486781,506829,227267,1220877
2023-05-01 02:08,1220915,486819,506829,227267,1220915
2023-05-01 02:09,1220954,486854,506831,227269,1220954
2023-05-01 02:10,1220996,486896,506831,227269,1220996
2023-05-01 02:11,1221036,486935,506831,227270,1221036
2023-05-01 02:12,1221074,486973,506831,227270,1221074
2023-05-01 02:13,1221114,487012,506831,227271,1221114
2023-05-01 02:14,1221154,487050,506831,227273,1221154
2023-05-01 02:15,1221194,487088,506833,227273,1221194
2023-05-01 02:16,1221234,487126,506833,227275,1221234
2023-05-01 02:17,1221273,487166,506832,227275,1221273
2023-05-01 02:18,1221312,487204,506832,227276,1221312
2023-05-01 02:19,1221355,487246,506832,227277,1221355
2023-05-01 02:20,1221394,487285,506832,227277,1221394
2023-05-01 02:21,1221432,487316,506835,227281,1221432
2023-05-01 02:22,1221472,487355,506835,227282,1221472
2023-05-01 02:23,1221512,487394,506836,227282,1221512
2023-05-01 02:24,1221549,487430,506836,227283,1221549
2023-05-01 02:25,1221589,487466,506838,227285,1221589
2023-05-01 02:26,1221628,487505,506838,227285,1221628
2023-05-01 02:27,1221671,487548,506838,227285,1221671
2023-05-01 02:28,1221707,487584,506838,227285,1221707
2023-05-01 02:29,1221747,487622,506838,227287,1221747
2023-05-01 02:30,1221788,487661,506838,227289,1221788
2023-05-01 02:31,1221827,487699,506838,227290,1221827
2023-05-01 02:32,1221866,487737,506838,227291,1221866
2023-05-01 02:33,1221905,487775,506838,227292,1221905
2023-05-01 02:34,1221947,487816,506838,227293,1221947
2023-05-01 02:35,1221986,487849,506844,227293,1221986
2023-05-01 02:36,1222024,487886,506844,227294,1222024
2023-05-01 02:37,1222065,487926,506844,227295,1222065
2023-05-01 02:38,1222106,487963,506846,227297,1222106
2023-05-01 02:39,1222144,487996,506850,227298,1222144
2023-05-01 02:40,1222185,488037,506850,227298,1222185
2023-05-01 02:41,1222223,488075,506850,227298,1222223
2023-05-01 02:42,1222263,488115,506850,227298,1222263
2023-05-01 02:43,1222302,488152,506852,227298,1222302
2023-05-01 02:44,1222343,488193,506852,227298,1222343
2023-05-01 02:46,1222381,488227,506855,227299,1222381
2023-05-01 02:47,1222423,488268,506855,227300,1222423
2023-05-01 02:48,1222461,488306,506855,227300,1222461
2023-05-01 02:49,1222501,488346,506855,227300,1222501
2023-05-01 02:50,1222543,488387,506856,227300,1222543
2023-05-01 02:51,1222584,488428,506856,227300,1222584
2023-05-01 02:52,1222622,488465,506857,227300,1222622
2023-05-01 02:53,1222661,488502,506857,227302,1222661
2023-05-01 02:54,1222700,488539,506859,227302,1222700
2023-05-01 02:55,1222742,488581,506859,227302,1222742
2023-05-01 02:56,1222781,488619,506859,227303,1222781
2023-05-01 02:57,1222818,488654,506859,227305,1222818
2023-05-01 02:58,1222858,488692,506860,227306,1222858
2023-05-01 02:59,1222898,488732,506860,227306,1222898
2023-05-01 03:00,1222930,488760,506862,227308,1222930
2023-05-01 03:01,1222943,488773,506862,227308,1222943
2023-05-01 03:02,1222956,488786,506862,227308,1222956
2023-05-01 03:03,1222967,488797,506862,227308,1222967
2023-05-01 03:04,1222980,488809,506863,227308,1222980
2023-05-01 03:05,1222991,488820,506863,227308,1222991
2023-05-01 03:06,1223004,488830,506866,227308,1223004
2023-05-01 03:07,1223016,488841,506866,227309,1223016
2023-05-01 03:08,1223028,488852,506867,227309,1223028
2023-05-01 03:09,1223041,488865,506867,227309,1223041
2023-05-01 03:10,1223052,488875,506868,227309,1223052
2023-05-01 03:11,1223065,488888,506868,227309,1223065
2023-05-01 03:12,1223077,488900,506868,227309,1223077
2023-05-01 03:13,1223089,488912,506868,227309,1223089
2023-05-01 03:14,1223101,488924,506868,227309,1223101
2023-05-01 03:15,1223113,488935,506868,227310,1223113
2023-05-01 03:16,1223126,488945,506870,227311,1223126
2023-05-01 03:17,1223138,488957,506870,227311,1223138
2023-05-01 03:18,1223150,488968,506871,227311,1223150
2023-05-01 03:19,1223162,488979,506871,227312,1223162
2023-05-01 03:20,1223174,488991,506871,227312,1223174
2023-05-01 03:21,1223187,489004,506871,227312,1223187
2023-05-01 03:22,1223199,489014,506872,227313,1223199
2023-05-01 03:23,1223211,489025,506872,227314,1223211
2023-05-01 03:24,1223223,489036,506872,227315,1223223
2023-05-01 03:25,1223235,489048,506872,227315,1223235
2023-05-01 03:26,1223248,489057,506876,227315,1223248
2023-05-01 03:27,1223260,489069,506876,227315,1223260
2023-05-01 03:28,1223272,489078,506879,227315,1223272
2023-05-01 03:29,1223285,489090,506879,227316,1223285
2023-05-01 03:30,1223297,489102,506879,227316,1223297
2023-05-01 03:31,1223309,489114,506879,227316,1223309
2023-05-01 03:33,1223322,489125,506880,227317,1223322
2023-05-01 03:34,1223334,489136,506880,227318,1223334
2023-05-01 03:35,1223346,489147,506881,227318,1223346
2023-05-01 03:36,1223359,489160,506881,227318,1223359
2023-05-01 03:37,1223372,489171,506881,227320,1223372
2023-05-01 03:38,1223384,489183,506881,227320,1223384
2023-05-01 03:39,1223396,489194,506881,227321,1223396
2023-05-01 03:40,1223408,489206,506881,227321,1223408
2023-05-01 03:41,1223420,489215,506883,227322,1223420
2023-05-01 03:42,1223433,489228,506883,227322,1223433
2023-05-01 03:43,1223445,489238,506885,227322,1223445
2023-05-01 03:44,1223457,489249,506885,227323,1223457
2023-05-01 03:45,1223470,489260,506886,227324,1223470
2023-05-01 03:46,1223481,489271,506886,227324,1223481
2023-05-01 03:47,1223493,489283,506886,227324,1223493
2023-05-01 03:48,1223505,489294,506886,227325,1223505
2023-05-01 03:49,1223518,489307,506886,227325,1223518
2023-05-01 03:50,1223530,489319,506886,227325,1223530
2023-05-01 03:51,1223542,489331,506886,227325,1223542
2023-05-01 03:52,1223555,489344,506886,227325,1223555
2023-05-01 03:53,1223567,489355,506887,227325,1223567
2023-05-01 03:54,1223579,489367,506887,227325,1223579
2023-05-01 03:55,1223591,489376,506889,227326,1223591
2023-05-01 03:56,1223605,489390,506889,227326,1223605
2023-05-01 03:57,1223617,489402,506889,227326,1223617
2023-05-01 03:58,1223629,489414,506889,227326,1223629
2023-05-01 03:59,1223641,489426,506889,227326,1223641
2023-05-01 04:00,1223652,489437,506889,227326,1223652
2023-05-01 04:01,1223663,489447,506889,227327,1223663
2023-05-01 04:02,1223673,489457,506889,227327,1223673
2023-05-01 04:03,1223683,489466,506889,227328,1223683
2023-05-01 04:04,1223692,489475,506889,227328,1223692
2023-05-01 04:05,1223702,489485,506889,227328,1223702
2023-05-01 04:06,1223712,489495,506889,227328,1223712
2023-05-01 04:07,1223722,489504,506889,227329,1223722
2023-05-01 04:08,1223733,489513,506890,227330,1223733
2023-05-01 04:09,1223742,489522,506890,227330,1223742
2023-05-01 04:10,1223752,489532,506890,227330,1223752
2023-05-01 04:11,1223762,489541,506891,227330,1223762
2023-05-01 04:12,1223772,489551,506891,227330,1223772
2023-05-01 04:13,1223782,489560,506892,227330,1223782
2023-05-01 04:14,1223792,489570,506892,227330,1223792
2023-05-01 04:15,1223802,489578,506893,227331,1223802
2023-05-01 04:16,1223812,489588,506893,227331,1223812
2023-05-01 04:17,1223822,489596,506893,227333,1223822
2023-05-01 04:18,1223832,489606,506893,227333,1223832
2023-05-01 04:20,1223842,489616,506893,227333,1223842
2023-05-01 04:21,1223852,489624,506893,227335,1223852
2023-05-01 04:22,1223862,489631,506895,227336,1223862
2023-05-01 04:23,1223872,489640,506895,227337,1223872
2023-05-01 04:24,1223882,489649,506895,227338,1223882
2023-05-01 04:25,1223892,489659,506895,227338,1223892
2023-05-01 04:26,1223903,489668,506895,227340,1223903
2023-05-01 04:27,1223913,489678,506895,227340,1223913
2023-05-01 04:28,1223923,489687,506896,227340,1223923
2023-05-01 04:29,1223933,489697,506896,227340,1223933
2023-05-01 04:30,1223942,489705,506897,227340,1223942
2023-05-01 04:31,1223952,489714,506897,227341,1223952
2023-05-01 04:32,1223963,489722,506897,227344,1223963
2023-05-01 04:33,1223973,489732,506897,227344,1223973
2023-05-01 04:34,1223983,489742,506897,227344,1223983
2023-05-01 04:35,1223992,489751,506897,227344,1223992
2023-05-01 04:36,1224002,489761,506897,227344,1224002
2023-05-01 04:37,1224012,489771,506897,227344,1224012
2023-05-01 04:38,1224022,489780,506898,227344,1224022
2023-05-01 04:39,1224032,489790,506898,227344,1224032
2023-05-01 04:40,1224042,489799,506899,227344,1224042
2023-05-01 04:41,1224052,489809,506899,227344,1224052
2023-05-01 04:42,1224062,489819,506899,227344,1224062
2023-05-01 04:43,1224072,489829,506899,227344,1224072
2023-05-01 04:44,1224082,489837,506900,227345,1224082
2023-05-01 04:45,1224093,489848,506900,227345,1224093
2023-05-01 04:46,1224103,489857,506900,227346,1224103
2023-05-01 04:47,1224113,489868,506900,227345,1224113
2023-05-01 04:48,1224123,489877,506900,227346,1224123
2023-05-01 04:49,1224133,489887,506900,227346,1224133
2023-05-01 04:50,1224143,489895,506902,227346,1224143
2023-05-01 04:51,1224153,489905,506902,227346,1224153
2023-05-01 04:52,1224163,489915,506902,227346,1224163
2023-05-01 04:53,1224172,489923,506902,227347,1224172
2023-05-01 04:54,1224183,489934,506902,227347,1224183
2023-05-01 04:55,1224192,489943,506902,227347,1224192
2023-05-01 04:56,1224202,489952,506903,227347,1224202
2023-05-01 04:57,1224213,489963,506903,227347,1224213
2023-05-01 04:58,1224223,489973,506903,227347,1224223
2023-05-01 04:59,1224232,489982,506903,227347,1224232
2023-05-01 05:00,1224250,489999,506903,227348,1224250
2023-05-01 05:01,1224272,490021,506903,227348,1224272
2023-05-01 05:02,1224292,490041,506903,227348,1224292
2023-05-01 05:03,1224312,490061,506903,227348,1224312
2023-05-01 05:04,1224332,490080,506903,227349,1224332
2023-05-01 05:05,1224354,490102,506903,227349,1224354
2023-05-01 05:07,1224374,490121,506903,227350,1224374
2023-05-01 05:08,1224394,490141,506903,227350,1224394
2023-05-01 05:09,1224414,490160,506904,227350,1224414
2023-05-01 05:10,1224434,490180,506904,227350,1224434
2023-05-01 05:11,1224456,490202,506904,227350,1224456
2023-05-01 05:12,1224476,490222,506904,227350,1224476
2023-05-01 05:13,1224496,490242,506904,227350,1224496
2023-05-01 05:14,1224516,490262,506904,227350,1224516
2023-05-01 05:15,1224536,490280,506904,227352,1224536
2023-05-01 05:16,1224558,490302,506904,227352,1224558
2023-05-01 05:17,1224578,490323,506904,227351,1224578
2023-05-01 05:18,1224598,490343,506904,227351,1224598
2023-05-01 05:19,1224619,490364,506904,227351,1224619
2023-05-01 05:20,1224639,490384,506904,227351,1224639
2023-05-01 05:21,1224660,490405,506904,227351,1224660
2023-05-01 05:22,1224679,490424,506904,227351,1224679
2023-05-01 05:23,1224701,490445,506905,227351,1224701
2023-05-01 05:24,1224720,490464,506905,227351,1224720
2023-05-01 05:25,1224740,490481,506906,227353,1224740
2023-05-01 05:26,1224761,490502,506906,227353,1224761
2023-05-01 05:27,1224784,490524,506906,227354,1224784
2023-05-01 05:28,1224803,490543,506906,227354,1224803
2023-05-01 05:29,1224823,490562,506907,227354,1224823
2023-05-01 05:30,1224844,490582,506907,227355,1224844
2023-05-01 05:31,1224865,490602,506907,227356,1224865
2023-05-01 05:32,1224885,490621,506907,227357,1224885
2023-05-01 05:33,1224905,490640,506907,227358,1224905
2023-05-01 05:34,1224926,490661,506907,227358,1224926
2023-05-01 05:35,1224947,490682,506907,227358,1224947
2023-05-01 05:36,1224967,490702,506907,227358,1224967
2023-05-01 05:37,1224987,490722,506907,227358,1224987
2023-05-01 05:38,1225008,490742,506907,227359,1225008
2023-05-01 05:39,1225028,490759,506909,227360,1225028
2023-05-01 05:40,1225049,490780,506909,227360,1225049
2023-05-01 05:41,1225068,490798,506909,227361,1225068
2023-05-01 05:42,1225088,490818,506909,227361,1225088
2023-05-01 05:43,1225110,490840,506909,227361,1225110
2023-05-01 05:44,1225130,490859,506909,227362,1225130
2023-05-01 05:45,1225151,490880,506909,227362,1225151
2023-05-01 05:46,1225171,490899,506909,227363,1225171
2023-05-01 05:47,1225191,490918,506910,227363,1225191
2023-05-01 05:48,1225212,490939,506910,227363,1225212
2023-05-01 05:49,1225231,490958,506910,227363,1225231
2023-05-01 05:50,1225252,490979,506910,227363,1225252
2023-05-01 05:51,1225272,490999,506910,227363,1225272
2023-05-01 05:52,1225294,491021,506910,227363,1225294
2023-05-01 05:54,1225314,491040,506910,227364,1225314
2023-05-01 05:55,1225334,491060,506910,227364,1225334
2023-05-01 05:56,1225354,491078,506912,227364,1225354
2023-05-01 05:57,1225375,491099,506912,227364,1225375
2023-05-01 05:58,1225396,491120,506912,227364,1225396
2023-05-01 05:59,1225415,491139,506912,227364,1225415
2023-05-01 06:00,1225437,491160,506913,227364,1225437
2023-05-01 06:01,1225479,491202,506913,227364,1225479
2023-05-01 06:02,1225519,491242,506913,227364,1225519
2023-05-01 06:03,1225561,491284,506913,227364,1225561
2023-05-01 06:04,1225599,491321,506914,227364,1225599
2023-05-01 06:05,1225642,491363,506914,227365,1225642
2023-05-01 06:06,1225681,491402,506914,227365,1225681
2023-05-01 06:07,1225724,491445,506914,227365,1225724
2023-05-01 06:08,1225763,491484,506914,227365,1225763
2023-05-01 06:09,1225803,491524,506914,227365,1225803
2023-05-01 06:10,1225847,491567,506915,227365,1225847
2023-05-01 06:11,1225886,491606,506915,227365,1225886
2023-05-01 06:12,1225928,491646,506916,227366,1225928
2023-05-01 06:13,1225968,491686,506916,227366,1225968
2023-05-01 06:14,1226008,491726,506916,227366,1226008
2023-05-01 06:15,1226049,491766,506916,227367,1226049
2023-05-01 06:16,1226090,491806,506917,227367,1226090
2023-05-01 06:17,1226131,491847,506917,227367,1226131
2023-05-01 06:18,1226172,491887,506918,227367,1226172
2023-05-01 06:19,1226213,491928,506918,227367,1226213
2023-05-01 06:20,1226255,491969,506918,227368,1226255
2023-05-01 06:21,1226295,492009,506918,227368,1226295
2023-05-01 06:22,1226335,492048,506919,227368,1226335
2023-05-01 06:23,1226377,492089,506919,227369,1226377
2023-05-01 06:24,1226418,492128,506921,227369,1226418
2023-05-01 06:25,1226457,492165,506921,227371,1226457
2023-05-01 06:26,1226497,492205,506921,227371,1226497
2023-05-01 06:27,1226539,492247,506921,227371,1226539
2023-05-01 06:28,1226579,492286,506921,227372,1226579
2023-05-01 06:29,1226622,492329,506921,227372,1226622
2023-05-01 06:30,1226660,492363,506921,227376,1226660
2023-05-01 06:31,1226702,492404,506921,227377,1226702
2023-05-01 06:32,1226744,492444,506922,227378,1226744
2023-05-01 06:33,1226784,492482,506922,227380,1226784
2023-05-01 06:34,1226827,492524,506922,227381,1226827
2023-05-01 06:35,1226865,492561,506922,227382,1226865
2023-05-01 06:36,1226907,492600,506923,227384,1226907
2023-05-01 06:37,1226948,492641,506923,227384,1226948
2023-05-01 06:38,1226990,492682,506924,227384,1226990
2023-05-01 06:39,1227029,492721,506924,227384,1227029
2023-05-01 06:40,1227072,492764,506924,227384,1227072
2023-05-01 06:42,1227110,492802,506924,227384,1227110
2023-05-01 06:43,1227153,492845,506924,227384,1227153
2023-05-01 06:44,1227192,492883,506924,227385,1227192
2023-05-01 06:45,1227234,492925,506924,227385,1227234
2023-05-01 06:46,1227273,492964,506924,227385,1227273
2023-05-01 06:47,1227313,493003,506924,227386,1227313
2023-05-01 06:48,1227357,493047,506924,227386,1227357
2023-05-01 06:49,1227397,493087,506924,227386,1227397
2023-05-01 06:50,1227439,493128,506924,227387,1227439
2023-05-01 06:51,1227479,493165,506926,227388,1227479
2023-05-01 06:52,1227519,493203,506926,227390,1227519
2023-05-01 06:53,1227559,493242,506926,227391,1227559
2023-05-01 06:54,1227602,493286,506926,227390,1227602
2023-05-01 06:55,1227644,493328,506926,227390,1227644
2023-05-01 06:56,1227683,493367,506926,227390,1227683
2023-05-01 06:57,1227723,493406,506927,227390,1227723
2023-05-01 06:58,1227763,493446,506927,227390,1227763
2023-05-01 06:59,1227806,493488,506927,227391,1227806
2023-05-01 07:00,1227839,493521,506927,227391,1227839
2023-05-01 07:01,1227860,493541,506928,227391,1227860
2023-05-01 07:02,1227880,493562,506928,227390,1227880
2023-05-01 07:03,1227900,493581,506928,227391,1227900
2023-05-01 07:04,1227921,493602,506928,227391,1227921
2023-05-01 07:05,1227940,493619,506928,227393,1227940
2023-05-01 07:06,1227960,493639,506928,227393,1227960
2023-05-01 07:07,1227981,493657,506930,227394,1227981
2023-05-01 07:08,1228002,493678,506930,227394,1228002
2023-05-01 07:09,1228021,493696,506930,227395,1228021
2023-05-01 07:10,1228041,493715,506930,227396,1228041
2023-05-01 07:11,1228063,493736,506930,227397,1228063
2023-05-01 07:12,1228081,493754,506930,227397,1228081
2023-05-01 07:13,1228102,493776,506929,227397,1228102
2023-05-01 07:14,1228123,493796,506929,227398,1228123
2023-05-01 07:15,1228143,493815,506929,227399,1228143
2023-05-01 07:16,1228164,493836,506929,227399,1228164
2023-05-01 07:17,1228184,493855,506930,227399,1228184
2023-05-01 07:18,1228204,493870,506930,227404,1228204
2023-05-01 07:19,1228225,493891,506930,227404,1228225
2023-05-01 07:20,1228245,493911,506930,227404,1228245
2023-05-01 07:21,1228266,493928,506932,227406,1228266
2023-05-01 07:22,1228286,493948,506932,227406,1228286
2023-05-01 07:23,1228306,493967,506932,227407,1228306
2023-05-01 07:24,1228327,493988,506932,227407,1228327
2023-05-01 07:25,1228348,494006,506935,227407,1228348
2023-05-01 07:26,1228367,494023,506935,227409,1228367
2023-05-01 07:27,1228388,494042,506937,227409,1228388
2023-05-01 07:28,1228408,494061,506937,227410,1228408
2023-05-01 07:30,1228428,494080,506937,227411,1228428
2023-05-01 07:31,1228448,494097,506937,227414,1228448
2023-05-01 07:32,1228469,494114,506941,227414,1228469
2023-05-01 07:33,1228489,494132,506941,227416,1228489
2023-05-01 07:34,1228509,494150,506941,227418,1228509
2023-05-01 07:35,1228529,494170,506941,227418,1228529
2023-05-01 07:36,1228549,494186,506945,227418,1228549
2023-05-01 07:37,1228570,494205,506945,227420,1228570
2023-05-01 07:38,1228591,494226,506945,227420,1228591
2023-05-01 07:39,1228611,494245,506945,227421,1228611
2023-05-01 07:40,1228631,494264,506945,227422,1228631
2023-05-01 07:41,1228653,494285,506945,227423,1228653
2023-05-01 07:42,1228672,494302,506947,227423,1228672
2023-05-01 07:43,1228693,494323,506947,227423,1228693
2023-05-01 07:44,1228713,494341,506949,227423,1228713
2023-05-01 07:45,1228732,494357,506949,227426,1228732
2023-05-01 07:46,1228753,494377,506950,227426,1228753
2023-05-01 07:47,1228773,494395,506950,227428,1228773
2023-05-01 07:48,1228794,494413,506951,227430,1228794
2023-05-01 07:49,1228814,494432,506951,227431,1228814
2023-05-01 07:50,1228835,494450,506953,227432,1228835
2023-05-01 07:51,1228856,494467,506953,227436,1228856
2023-05-01 07:52,1228876,494485,506954,227437,1228876
2023-05-01 07:53,1228896,494501,506954,227441,1228896
2023-05-01 07:54,1228917,494519,506957,227441,1228917
2023-05-01 07:55,1228936,494536,506957,227443,1228936
2023-05-01 07:56,1228957,494555,506959,227443,1228957
2023-05-01 07:57,1228977,494575,506959,227443,1228977
2023-05-01 07:58,1228998,494590,506965,227443,1228998
2023-05-01 07:59,1229017,494608,506965,227444,1229017
2023-05-01 08:00,1229034,494624,506966,227444,1229034
2023-05-01 08:01,1229050,494640,506966,227444,1229050
2023-05-01 08:02,1229065,494654,506966,227445,1229065
2023-05-01 08:03,1229080,494666,506966,227448,1229080
2023-05-01 08:04,1229094,494672,506969,227453,1229094
2023-05-01 08:05,1229109,494687,506969,227453,1229109
2023-05-01 08:06,1229124,494699,506970,227455,1229124
2023-05-01 08:07,1229138,494713,506970,227455,1229138
2023-05-01 08:08,1229154,494724,506970,227460,1229154
2023-05-01 08:09,1229169,494736,506970,227463,1229169
2023-05-01 08:10,1229185,494749,506971,227465,1229185
2023-05-01 08:11,1229200,494762,506971,227467,1229200
2023-05-01 08:12,1229214,494774,506972,227468,1229214
2023-05-01 08:13,1229229,494785,506975,227469,1229229
2023-05-01 08:14,1229245,494800,506975,227470,1229245
2023-05-01 08:15,1229259,494811,506976,227472,1229259
2023-05-01 08:17,1229274,494825,506976,227473,1229274
2023-05-01 08:18,1229289,494837,506977,227475,1229289
2023-05-01 08:19,1229304,494851,506977,227476,1229304
2023-05-01 08:20,1229319,494863,506978,227478,1229319
2023-05-01 08:21,1229334,494877,506978,227479,1229334
2023-05-01 08:22,1229349,494891,506978,227480,1229349
2023-05-01 08:23,1229364,494902,506978,227484,1229364
2023-05-01 08:24,1229379,494913,506978,227488,1229379
2023-05-01 08:25,1229394,494927,506978,227489,1229394
2023-05-01 08:26,1229409,494941,506978,227490,1229409
2023-05-01 08:27,1229424,494955,506978,227491,1229424
2023-05-01 08:28,1229440,494967,506981,227492,1229440
2023-05-01 08:29,1229454,494980,506981,227493,1229454
2023-05-01 08:30,1229470,494992,506983,227495,1229470
2023-05-01 08:31,1229485,495004,506983,227498,1229485
2023-05-01 08:32,1229500,495017,506985,227498,1229500
2023-05-01 08:33,1229514,495028,506985,227501,1229514
2023-05-01 08:34,1229530,495043,506985,227502,1229530
2023-05-01 08:35,1229544,495054,506985,227505,1229544
2023-05-01 08:36,1229559,495066,506987,227506,1229559
2023-05-01 08:37,1229573,495077,506987,227509,1229573
2023-05-01 08:38,1229590,495091,506988,227511,1229590
2023-05-01 08:39,1229605,495106,506988,227511,1229605
2023-05-01 08:40,1229619,495118,506990,227511,1229619
2023-05-01 08:41,1229635,495132,506991,227512,1229635
2023-05-01 08:42,1229649,495145,506991,227513,1229649
2023-05-01 08:43,1229664,495156,506994,227514,1229664
2023-05-01 08:44,1229680,495171,506994,227515,1229680
2023-05-01 08:45,1229695,495179,506998,227518,1229695
2023-05-01 08:46,1229710,495194,506998,227518,1229710
2023-05-01 08:47,1229724,495208,506998,227518,1229724
2023-05-01 08:48,1229739,495223,506998,227518,1229739
2023-05-01 08:49,1229755,495237,506999,227519,1229755
2023-05-01 08:50,1229769,495251,506999,227519,1229769
2023-05-01 08:51,1229785,495264,507001,227520,1229785
2023-05-01 08:52,1229800,495278,507001,227521,1229800
2023-05-01 08:53,1229815,495289,507002,227524,1229815
2023-05-01 08:54,1229830,495301,507003,227526,1229830
2023-05-01 08:55,1229845,495314,507003,227528,1229845
2023-05-01 08:56,1229859,495325,507003,227531,1229859
2023-05-01 08:57,1229875,495338,507003,227534,1229875
2023-05-01 08:58,1229890,495352,507003,227535,1229890
2023-05-01 08:59,1229905,495365,507003,227537,1229905
2023-05-01 09:00,1229947,495406,507003,227538,1229947
2023-05-01 09:01,1229989,495445,507003,227541,1229989
2023-05-01 09:02,1230033,495486,507005,227542,1230033
2023-05-01 09:03,1230076,495528,507005,227543,1230076
2023-05-01 09:05,1230120,495568,507007,227545,1230120
2023-05-01 09:06,1230166,495614,507007,227545,1230166
2023-05-01 09:07,1230210,495658,507007,227545,1230210
2023-05-01 09:08,1230253,495699,507007,227547,1230253
2023-05-01 09:09,1230296,495737,507009,227550,1230296
2023-05-01 09:10,1230339,495779,507009,227551,1230339
2023-05-01 09:11,1230383,495816,507013,227554,1230383
2023-05-01 09:12,1230431,495861,507013,227557,1230431
2023-05-01 09:13,1230473,495898,507015,227560,1230473
2023-05-01 09:14,1230515,495939,507015,227561,1230515
2023-05-01 09:15,1230560,495981,507017,227562,1230560
2023-05-01 09:16,1230604,496024,507017,227563,1230604
2023-05-01 09:17,1230649,496060,507022,227567,1230649
2023-05-01 09:18,1230694,496104,507022,227568,1230694
2023-05-01 09:19,1230737,496145,507023,227569,1230737
2023-05-01 09:20,1230781,496187,507023,227571,1230781
2023-05-01 09:21,1230825,496229,507024,227572,1230825
2023-05-01 09:22,1230869,496270,507026,227573,1230869
2023-05-01 09:23,1230913,496314,507026,227573,1230913
2023-05-01 09:24,1230959,496359,507026,227574,1230959
2023-05-01 09:25,1231003,496399,507027,227577,1231003
2023-05-01 09:26,1231048,496443,507027,227578,1231048
2023-05-01 09:27,1231093,496479,507034,227580,1231093
2023-05-01 09:28,1231137,496521,507034,227582,1231137
2023-05-01 09:29,1231178,496559,507035,227584,1231178
2023-05-01 09:30,1231224,496601,507035,227588,1231224
2023-05-01 09:31,1231268,496636,507040,227592,1231268
2023-05-01 09:32,1231309,496674,507040,227595,1231309
2023-05-01 09:33,1231354,496715,507043,227596,1231354
2023-05-01 09:34,1231400,496758,507043,227599,1231400
2023-05-01 09:35,1231444,496798,507044,227602,1231444
2023-05-01 09:36,1231486,496839,507044,227603,1231486
2023-05-01 09:37,1231529,496880,507045,227604,1231529
2023-05-01 09:38,1231575,496925,507045,227605,1231575
2023-05-01 09:39,1231619,496966,507047,227606,1231619
2023-05-01 09:40,1231663,497009,507047,227607,1231663
2023-05-01 09:41,1231707,497046,507050,227611,1231707
2023-05-01 09:42,1231750,497085,507050,227615,1231750
2023-05-01 09:43,1231795,497126,507053,227616,1231795
2023-05-01 09:44,1231840,497165,507053,227622,1231840
2023-05-01 09:45,1231883,497203,507055,227625,1231883
2023-05-01 09:46,1231926,497243,507055,227628,1231926
2023-05-01 09:47,1231972,497285,507058,227629,1231972
2023-05-01 09:48,1232016,497328,507058,227630,1232016
2023-05-01 09:49,1232058,497361,507061,227636,1232058
2023-05-01 09:50,1232102,497402,507062,227638,1232102
2023-05-01 09:52,1232146,497444,507062,227640,1232146
2023-05-01 09:53,1232189,497482,507063,227644,1232189
2023-05-01 09:54,1232233,497525,507063,227645,1232233
2023-05-01 09:55,1232279,497566,507064,227649,1232279
2023-05-01 09:56,1232323,497609,507064,227650,1232323
2023-05-01 09:57,1232368,497651,507066,227651,1232368
2023-05-01 09:58,1232411,497689,507066,227656,1232411
2023-05-01 09:59,1232453,497724,507069,227660,1232453
2023-05-01 10:00,1232498,497767,507069,227662,1232498
2023-05-01 10:01,1232543,497809,507069,227665,1232543
2023-05-01 10:02,1232585,497848,507069,227668,1232585
2023-05-01 10:03,1232628,497887,507072,227669,1232628
2023-05-01 10:04,1232672,497928,507072,227672,1232672
2023-05-01 10:05,1232715,497957,507077,227681,1232715
2023-05-01 10:06,1232756,497992,507077,227687,1232756
2023-05-01 10:07,1232802,498032,507080,227690,1232802
2023-05-01 10:08,1232844,498067,507080,227697,1232844
2023-05-01 10:09,1232890,498110,507081,227699,1232890
2023-05-01 10:10,1232932,498147,507081,227704,1232932
2023-05-01 10:11,1232975,498181,507086,227708,1232975
2023-05-01 10:12,1233018,498222,507086,227710,1233018
2023-05-01 10:13,1233060,498259,507089,227712,1233060
2023-05-01 10:14,1233106,498303,507091,227712,1233106
2023-05-01 10:15,1233151,498339,507095,227717,1233151
2023-05-01 10:16,1233192,498378,507096,227718,1233192
2023-05-01 10:17,1233236,498421,507096,227719,1233236
2023-05-01 10:18,1233279,498462,507097,227720,1233279
2023-05-01 10:19,1233323,498503,507097,227723,1233323
2023-05-01 10:20,1233369,498542,507099,227728,1233369
2023-05-01 10:21,1233409,498578,507099,227732,1233409
2023-05-01 10:22,1233457,498622,507099,227736,1233457
2023-05-01 10:23,1233499,498657,507099,227743,1233499
2023-05-01 10:24,1233543,498697,507101,227745,1233543
2023-05-01 10:25,1233586,498738,507101,227747,1233586
2023-05-01 10:26,1233627,498773,507106,227748,1233627
2023-05-01 10:27,1233672,498815,507106,227751,1233672
2023-05-01 10:28,1233714,498849,507109,227756,1233714
2023-05-01 10:29,1233757,498886,507109,227762,1233757
2023-05-01 10:30,1233802,498926,507112,227764,1233802
2023-05-01 10:31,1233844,498964,507112,227768,1233844
2023-05-01 10:32,1233886,498998,507115,227773,1233886
2023-05-01 10:33,1233931,499036,507115,227780,1233931
2023-05-01 10:34,1233975,499075,507118,227782,1233975
2023-05-01 10:35,1234018,499117,507118,227783,1234018
2023-05-01 10:36,1234060,499150,507121,227789,1234060
2023-05-01 10:37,1234105,499190,507121,227794,1234105
2023-05-01 10:38,1234147,499225,507126,227796,1234147
2023-05-01 10:40,1234190,499256,507126,227808,1234190
2023-05-01 10:41,1234232,499296,507127,227809,1234232
2023-05-01 10:42,1234277,499339,507127,227811,1234277
2023-05-01 10:43,1234319,499372,507132,227815,1234319
2023-05-01 10:44,1234361,499409,507135,227817,1234361
2023-05-01 10:45,1234404,499449,507135,227820,1234404
2023-05-01 10:46,1234450,499489,507138,227823,1234450
2023-05-01 10:47,1234493,499527,507138,227828,1234493
2023-05-01 10:48,1234534,499558,507142,227834,1234534
2023-05-01 10:49,1234577,499597,507142,227838,1234577
2023-05-01 10:50,1234620,499629,507147,227844,1234620
2023-05-01 10:51,1234663,499668,507147,227848,1234663
2023-05-01 10:52,1234706,499704,507151,227851,1234706
2023-05-01 10:53,1234750,499746,507151,227853,1234750
2023-05-01 10:54,1234795,499787,507153,227855,1234795
2023-05-01 10:55,1234838,499826,507153,227859,1234838
2023-05-01 10:56,1234881,499861,507156,227864,1234881
2023-05-01 10:57,1234926,499900,507156,227870,1234926
2023-05-01 10:58,1234969,499939,507158,227872,1234969
2023-05-01 10:59,1235011,499974,507161,227876,1235011
2023-05-01 11:00,1235042,500003,507161,227878,1235042
2023-05-01 11:01,1235053,500006,507165,227882,1235053
2023-05-01 11:02,1235065,500011,507165,227889,1235065
2023-05-01 11:03,1235076,500014,507169,227893,1235076
2023-05-01 11:04,1235087,500022,507169,227896,1235087
2023-05-01 11:05,1235097,500022,507172,227903,1235097
2023-05-01 11:06,1235108,500030,507172,227906,1235108
2023-05-01 11:07,1235118,500036,507174,227908,1235118
2023-05-01 11:08,1235130,500042,507174,227914,1235130
2023-05-01 11:09,1235141,500049,507175,227917,1235141
2023-05-01 11:10,1235152,500058,507175,227919,1235152
2023-05-01 11:11,1235164,500065,507177,227922,1235164
2023-05-01 11:12,1235175,500074,507177,227924,1235175
2023-05-01 11:13,1235186,500079,507178,227929,1235186
2023-05-01 11:14,1235196,500083,507182,227931,1235196
2023-05-01 11:15,1235209,500090,507182,227937,1235209
2023-05-01 11:16,1235220,500098,507184,227938,1235220
2023-05-01 11:17,1235232,500105,507184,227943,1235232
2023-05-01 11:18,1235244,500113,507186,227945,1235244
2023-05-01 11:19,1235256,500123,507186,227947,1235256
2023-05-01 11:20,1235266,500128,507189,227949,1235266
2023-05-01 11:21,1235278,500134,507189,227955,1235278
2023-05-01 11:22,1235289,500137,507193,227959,1235289
2023-05-01 11:23,1235299,500145,507193,227961,1235299
2023-05-01 11:24,1235310,500149,507198,227963,1235310
2023-05-01 11:25,1235321,500155,507198,227968,1235321
2023-05-01 11:27,1235332,500159,507200,227973,1235332
2023-05-01 11:28,1235342,500163,507200,227979,1235342
2023-05-01 11:29,1235353,500165,507202,227986,1235353
2023-05-01 11:30,1235363,500172,507202,227989,1235363
2023-05-01 11:31,1235374,500177,507205,227992,1235374
2023-05-01 11:32,1235385,500184,507205,227996,1235385
2023-05-01 11:33,1235396,500192,507207,227997,1235396
2023-05-01 11:34,1235408,500200,507207,228001,1235408
2023-05-01 11:35,1235418,500205,507209,228004,1235418
2023-05-01 11:36,1235429,500212,507209,228008,1235429
2023-05-01 11:37,1235440,500221,507212,228007,1235440
2023-05-01 11:38,1235451,500230,507212,228009,1235451
2023-05-01 11:39,1235462,500233,507215,228014,1235462
2023-05-01 11:40,1235472,500241,507215,228016,1235472
2023-05-01 11:41,1235483,500245,507217,228021,1235483
2023-05-01 11:42,1235493,500252,507217,228024,1235493
2023-05-01 11:43,1235504,500256,507219,228029,1235504
2023-05-01 11:44,1235516,500262,507219,228035,1235516
2023-05-01 11:45,1235527,500264,507224,228039,1235527
2023-05-01 11:46,1235537,500270,507224,228043,1235537
2023-05-01 11:47,1235548,500276,507224,228048,1235548
2023-05-01 11:48,1235559,500286,507224,228049,1235559
2023-05-01 11:49,1235569,500292,507224,228053,1235569
2023-05-01 11:50,1235580,500301,507224,228055,1235580
2023-05-01 11:51,1235591,500309,507224,228058,1235591
2023-05-01 11:52,1235603,500318,507224,228061,1235603
2023-05-01 11:53,1235613,500323,507224,228066,1235613
2023-05-01 11:54,1235624,500330,507224,228070,1235624
2023-05-01 11:55,1235635,500322,507241,228072,1235635
2023-05-01 11:56,1235647,500331,507241,228075,1235647
2023-05-01 11:57,1235658,500337,507242,228079,1235658
2023-05-01 11:58,1235669,500342,507242,228085,1235669
2023-05-01 11:59,1235679,500346,507243,228090,1235679
2023-05-01 12:00,1235705,500372,507243,228090,1235705
2023-05-01 12:01,1235737,500392,507246,228099,1235737
2023-05-01 12:02,1235771,500420,507246,228105,1235771
2023-05-01 12:03,1235804,500447,507250,228107,1235804
2023-05-01 12:04,1235838,500477,507250,228111,1235838
2023-05-01 12:05,1235872,500501,507255,228116,1235872
2023-05-01 12:06,1235905,500533,507255,228117,1235905
2023-05-01 12:07,1235938,500560,507258,228120,1235938
2023-05-01 12:08,1235973,500591,507258,228124,1235973
2023-05-01 12:09,1236006,500609,507265,228132,1236006
2023-05-01 12:10,1236039,500637,507267,228135,1236039
2023-05-01 12:11,1236072,500666,507267,228139,1236072
2023-05-01 12:12,1236107,500689,507271,228147,1236107
2023-05-01 12:14,1236142,500720,507271,228151,1236142
2023-05-01 12:15,1236175,500745,507274,228156,1236175
2023-05-01 12:16,1236209,500776,507274,228159,1236209
2023-05-01 12:17,1236243,500802,507279,228162,1236243
2023-05-01 12:18,1236277,500831,507279,228167,1236277
2023-05-01 12:19,1236308,500856,507282,228170,1236308
2023-05-01 12:20,1236342,500884,507282,228176,1236342
2023-05-01 12:21,1236376,500911,507283,228182,1236376
2023-05-01 12:22,1236410,500938,507283,228189,1236410
2023-05-01 12:23,1236442,500961,507287,228194,1236442
2023-05-01 12:24,1236476,500994,507287,228195,1236476
2023-05-01 12:25,1236512,501022,507292,228198,1236512
2023-05-01 12:26,1236543,501047,507294,228202,1236543
2023-05-01 12:27,1236578,501078,507294,228206,1236578
2023-05-01 12:28,1236611,501099,507301,228211,1236611
2023-05-01 12:30,1236644,501128,507301,228215,1236644
2023-05-01 12:31,1236700,501178,507302,228220,1236700
2023-05-01 12:32,1236735,501204,507308,228223,1236735
2023-05-01 12:33,1236767,501231,507308,228228,1236767
2023-05-01 12:34,1236802,501261,507311,228230,1236802
2023-05-01 12:35,1236835,501292,507311,228232,1236835
2023-05-01 12:36,1236868,501319,507315,228234,1236868
2023-05-01 12:37,1236902,501351,507315,228236,1236902
2023-05-01 12:38,1236933,501373,507318,228242,1236933
2023-05-01 12:39,1236967,501404,507318,228245,1236967
2023-05-01 12:40,1237003,501434,507319,228250,1237003
2023-05-01 12:41,1237035,501462,507319,228254,1237035
2023-05-01 12:42,1237069,501490,507322,228257,1237069
2023-05-01 12:43,1237101,501518,507322,228261,1237101
2023-05-01 12:44,1237136,501544,507325,228267,1237136
2023-05-01 12:45,1237167,501571,507325,228271,1237167
2023-05-01 12:46,1237204,501598,507328,228278,1237204
2023-05-01 12:47,1237236,501628,507328,228280,1237236
2023-05-01 12:48,1237270,501652,507331,228287,1237270
2023-05-01 12:49,1237302,501683,507331,228288,1237302
2023-05-01 12:50,1237337,501711,507336,228290,1237337
2023-05-01 12:51,1237370,501738,507336,228296,1237370
2023-05-01 12:52,1237403,501765,507339,228299,1237403
2023-05-01 12:53,1237437,501795,507340,228302,1237437
2023-05-01 12:54,1237468,501825,507340,228303,1237468
2023-05-01 12:55,1237503,501857,507340,228306,1237503
2023-05-01 12:56,1237536,501885,507341,228310,1237536
2023-05-01 12:57,1237569,501914,507341,228314,1237569
2023-05-01 12:58,1237601,501939,507345,228317,1237601
2023-05-01 12:59,1237636,501965,507345,228326,1237636
2023-05-01 13:00,1237661,501983,507350,228328,1237661
2023-05-01 13:01,1237678,501999,507350,228329,1237678
2023-05-01 13:02,1237696,502010,507351,228335,1237696
2023-05-01 13:03,1237714,502021,507351,228342,1237714
2023-05-01 13:04,1237732,502034,507353,228345,1237732
2023-05-01 13:05,1237749,502045,507354,228350,1237749
2023-05-01 13:06,1237768,502062,507354,228352,1237768
2023-05-01 13:07,1237785,502071,507357,228357,1237785
2023-05-01 13:08,1237803,502083,507357,228363,1237803
2023-05-01 13:09,1237821,502096,507358,228367,1237821
2023-05-01 13:10,1237838,502110,507359,228369,1237838
2023-05-01 13:11,1237856,502119,507365,228372,1237856
2023-05-01 13:12,1237874,502131,507368,228375,1237874
2023-05-01 13:13,1237892,502145,507368,228379,1237892
2023-05-01 13:14,1237911,502158,507369,228384,1237911
2023-05-01 13:16,1237928,502171,507369,228388,1237928
2023-05-01 13:17,1237945,502183,507370,228392,1237945
2023-05-01 13:18,1237963,502198,507370,228395,1237963
2023-05-01 13:19,1237981,502210,507375,228396,1237981
2023-05-01 13:20,1238000,502227,507375,228398,1238000
2023-05-01 13:21,1238018,502240,507377,228401,1238018
2023-05-01 13:22,1238036,502257,507377,228402,1238036
2023-05-01 13:23,1238055,502269,507382,228404,1238055
2023-05-01 13:24,1238072,502279,507382,228411,1238072
2023-05-01 13:25,1238091,502295,507383,228413,1238091
2023-05-01 13:26,1238109,502310,507383,228416,1238109
2023-05-01 13:27,1238127,502319,507386,228422,1238127
2023-05-01 13:28,1238145,502331,507386,228428,1238145
2023-05-01 13:29,1238162,502339,507389,228434,1238162
2023-05-01 13:30,1238180,502354,507389,228437,1238180
2023-05-01 13:31,1238198,502363,507392,228443,1238198
2023-05-01 13:32,1238216,502379,507392,228445,1238216
2023-05-01 13:33,1238234,502392,507393,228449,1238234
2023-05-01 13:34,1238251,502410,507393,228448,1238251
2023-05-01 13:35,1238270,502420,507399,228451,1238270
2023-05-01 13:36,1238286,502430,507399,228457,1238286
2023-05-01 13:37,1238304,502434,507409,228461,1238304
2023-05-01 13:38,1238324,502452,507409,228463,1238324
2023-05-01 13:39,1238342,502465,507413,228464,1238342
2023-05-01 13:40,1238359,502479,507413,228467,1238359
2023-05-01 13:41,1238377,502488,507419,228470,1238377
2023-05-01 13:42,1238395,502502,507419,228474,1238395
2023-05-01 13:43,1238412,502511,507421,228480,1238412
2023-05-01 13:44,1238430,502527,507421,228482,1238430
2023-05-01 13:45,1238447,502533,507429,228485,1238447
2023-05-01 13:46,1238465,502548,507429,228488,1238465
2023-05-01 13:47,1238483,502561,507431,228491,1238483
2023-05-01 13:48,1238501,502575,507431,228495,1238501
2023-05-01 13:49,1238519,502586,507435,228498,1238519
2023-05-01 13:50,1238537,502601,507435,228501,1238537
2023-05-01 13:51,1238554,502616,507437,228501,1238554
2023-05-01 13:52,1238573,502633,507437,228503,1238573
2023-05-01 13:53,1238593,502647,507439,228507,1238593
2023-05-01 13:54,1238610,502658,507439,228513,1238610
2023-05-01 13:55,1238628,502667,507444,228517,1238628
2023-05-01 13:56,1238648,502683,507444,228521,1238648
2023-05-01 13:57,1238666,502695,507446,228525,1238666
2023-05-01 13:58,1238684,502712,507446,228526,1238684
2023-05-01 13:59,1238701,502721,507450,228530,1238701
2023-05-01 14:00,1238742,502755,507452,228535,1238742
2023-05-01 14:01,1238787,502798,507452,228537,1238787
2023-05-01 14:03,1238833,502842,507452,228539,1238833
2023-05-01 14:04,1238879,502883,507455,228541,1238879
2023-05-01 14:05,1238923,502922,507455,228546,1238923
2023-05-01 14:06,1238970,502967,507456,228547,1238970
2023-05-01 14:07,1239013,503006,507456,228551,1239013
2023-05-01 14:08,1239056,503041,507460,228555,1239056
2023-05-01 14:09,1239102,503085,507460,228557,1239102
2023-05-01 14:10,1239149,503125,507462,228562,1239149
2023-05-01 14:11,1239194,503164,507462,228568,1239194
2023-05-01 14:12,1239238,503201,507467,228570,1239238
2023-05-01 14:13,1239283,503243,507467,228573,1239283
2023-05-01 14:14,1239326,503280,507469,228577,1239326
2023-05-01 14:15,1239373,503324,507469,228580,1239373
2023-05-01 14:16,1239419,503366,507470,228583,1239419
2023-05-01 14:17,1239463,503409,507470,228584,1239463
2023-05-01 14:18,1239511,503450,507474,228587,1239511
2023-05-01 14:19,1239554,503490,507475,228589,1239554
2023-05-01 14:20,1239600,503533,507475,228592,1239600
2023-05-01 14:21,1239646,503574,507477,228595,1239646
2023-05-01 14:22,1239689,503605,507477,228607,1239689
2023-05-01 14:23,1239736,503646,507481,228609,1239736
2023-05-01 14:24,1239784,503693,507481,228610,1239784
2023-05-01 14:25,1239828,503729,507486,228613,1239828
2023-05-01 14:26,1239871,503769,507486,228616,1239871
2023-05-01 14:27,1239915,503806,507489,228620,1239915
2023-05-01 14:28,1239961,503850,507489,228622,1239961
2023-05-01 14:29,1240005,503890,507490,228625,1240005
2023-05-01 14:30,1240053,503932,507490,228631,1240053
2023-05-01 14:31,1240098,503976,507490,228632,1240098
2023-05-01 14:32,1240143,504017,507490,228636,1240143
2023-05-01 14:33,1240187,504055,507495,228637,1240187
2023-05-01 14:34,1240232,504095,507495,228642,1240232
2023-05-01 14:35,1240278,504135,507497,228646,1240278
2023-05-01 14:36,1240323,504176,507497,228650,1240323
2023-05-01 14:37,1240367,504216,507498,228653,1240367
2023-05-01 14:38,1240414,504259,507499,228656,1240414
2023-05-01 14:39,1240457,504300,507499,228658,1240457
2023-05-01 14:40,1240503,504336,507505,228662,1240503
2023-05-01 14:41,1240547,504376,507508,228663,1240547
2023-05-01 14:42,1240592,504419,507508,228665,1240592
2023-05-01 14:43,1240640,504461,507509,228670,1240640
2023-05-01 14:44,1240685,504501,507509,228675,1240685
2023-05-01 14:45,1240727,504534,507514,228679,1240727
2023-05-01 14:46,1240772,504576,507514,228682,1240772
2023-05-01 14:47,1240818,504609,507524,228685,1240818
2023-05-01 14:48,1240864,504655,507524,228685,1240864
2023-05-01 14:49,1240907,504692,507527,228688,1240907
2023-05-01 14:51,1240955,504734,507529,228692,1240955
2023-05-01 14:52,1240998,504770,507534,228694,1240998
2023-05-01 14:53,1241043,504812,507534,228697,1241043
2023-05-01 14:54,1241088,504852,507534,228702,1241088
2023-05-01 14:55,1241133,504895,507534,228704,1241133
2023-05-01 14:56,1241177,504935,507535,228707,1241177
2023-05-01 14:57,1241222,504979,507535,228708,1241222
2023-05-01 14:58,1241269,505022,507536,228711,1241269
2023-05-01 14:59,1241316,505067,507536,228713,1241316
2023-05-01 15:00,1241359,505103,507542,228714,1241359
2023-05-01 15:01,1241387,505127,507542,228718,1241387
2023-05-01 15:02,1241418,505155,507542,228721,1241418
2023-05-01 15:03,1241446,505178,507542,228726,1241446
2023-05-01 15:04,1241479,505206,507542,228731,1241479
2023-05-01 15:05,1241508,505231,507542,228735,1241508
2023-05-01 15:06,1241536,505258,507542,228736,1241536
2023-05-01 15:07,1241566,505284,507542,228740,1241566
2023-05-01 15:08,1241596,505309,507542,228745,1241596
2023-05-01 15:09,1241624,505333,507542,228749,1241624
2023-05-01 15:10,1241655,505354,507551,228750,1241655
2023-05-01 15:11,1241684,505380,507551,228753,1241684
2023-05-01 15:12,1241713,505407,507551,228755,1241713
2023-05-01 15:13,1241742,505431,507554,228757,1241742
2023-05-01 15:14,1241770,505451,507554,228765,1241770
2023-05-01 15:15,1241799,505472,507557,228770,1241799
2023-05-01 15:16,1241828,505499,507557,228772,1241828
2023-05-01 15:17,1241860,505523,507558,228779,1241860
2023-05-01 15:18,1241889,505552,507558,228779,1241889
2023-05-01 15:19,1241919,505573,507563,228783,1241919
2023-05-01 15:20,1241947,505600,507564,228783,1241947
2023-05-01 15:21,1241975,505622,507566,228787,1241975
2023-05-01 15:22,1242005,505647,507566,228792,1242005
2023-05-01 15:23,1242037,505673,507570,228794,1242037
2023-05-01 15:24,1242065,505696,507570,228799,1242065
2023-05-01 15:25,1242097,505716,507577,228804,1242097
2023-05-01 15:26,1242126,505743,507577,228806,1242126
2023-05-01 15:27,1242155,505763,507581,228811,1242155
2023-05-01 15:28,1242183,505789,507581,228813,1242183
2023-05-01 15:29,1242213,505816,507583,228814,1242213
2023-05-01 15:30,1242243,505842,507583,228818,1242243
2023-05-01 15:31,1242272,505865,507584,228823,1242272
2023-05-01 15:32,1242302,505893,507584,228825,1242302
2023-05-01 15:33,1242331,505919,507587,228825,1242331
2023-05-01 15:34,1242360,505943,507587,228830,1242360
2023-05-01 15:35,1242390,505966,507593,228831,1242390
2023-05-01 15:36,1242420,505990,507593,228837,1242420
2023-05-01 15:37,1242449,506010,507599,228840,1242449
2023-05-01 15:39,1242478,506034,507599,228845,1242478
2023-05-01 15:40,1242506,506056,507601,228849,1242506
2023-05-01 15:41,1242536,506085,507601,228850,1242536
2023-05-01 15:42,1242567,506110,507602,228855,1242567
2023-05-01 15:43,1242595,506136,507602,228857,1242595
2023-05-01 15:44,1242625,506163,507603,228859,1242625
2023-05-01 15:45,1242654,506188,507605,228861,1242654
2023-05-01 15:46,1242682,506213,507605,228864,1242682
2023-05-01 15:47,1242713,506238,507606,228869,1242713
2023-05-01 15:48,1242742,506266,507606,228870,1242742
2023-05-01 15:49,1242770,506282,507612,228876,1242770
2023-05-01 15:50,1242799,506308,507612,228879,1242799
2023-05-01 15:51,1242828,506330,507613,228885,1242828
2023-05-01 15:52,1242859,506358,507613,228888,1242859
2023-05-01 15:53,1242888,506381,507616,228891,1242888
2023-05-01 15:54,1242916,506404,507616,228896,1242916
2023-05-01 15:55,1242945,506427,507617,228901,1242945
2023-05-01 15:56,1242974,506452,507617,228905,1242974
2023-05-01 15:57,1243003,506474,507622,228907,1243003
2023-05-01 15:58,1243033,506502,507622,228909,1243033
2023-05-01 15:59,1243065,506524,507626,228915,1243065
2023-05-01 16:00,1243088,506545,507626,228917,1243088
2023-05-01 16:01,1243109,506560,507628,228921,1243109
2023-05-01 16:02,1243128,506577,507628,228923,1243128
2023-05-01 16:03,1243148,506589,507632,228927,1243148
2023-05-01 16:04,1243167,506599,507632,228936,1243167
2023-05-01 16:05,1243187,506612,507636,228939,1243187
2023-05-01 16:06,1243206,506630,507636,228940,1243206
2023-05-01 16:07,1243226,506641,507638,228947,1243226
2023-05-01 16:08,1243247,506655,507638,228954,1243247
2023-05-01 16:09,1243267,506668,507639,228960,1243267
2023-05-01 16:10,1243287,506683,507639,228965,1243287
2023-05-01 16:11,1243307,506692,507642,228973,1243307
2023-05-01 16:12,1243326,506706,507642,228978,1243326
2023-05-01 16:13,1243345,506715,507646,228984,1243345
2023-05-01 16:14,1243365,506732,507646,228987,1243365
2023-05-01 16:15,1243385,506745,507649,228991,1243385
2023-05-01 16:16,1243404,506762,507649,228993,1243404
2023-05-01 16:17,1243424,506776,507651,228997,1243424
2023-05-01 16:18,1243444,506787,507656,229001,1243444
2023-05-01 16:19,1243463,506801,507657,229005,1243463
2023-05-01 16:20,1243483,506818,507657,229008,1243483
2023-05-01 16:21,1243502,506830,507659,229013,1243502
2023-05-01 16:22,1243522,506848,507659,229015,1243522
2023-05-01 16:23,1243542,506860,507665,229017,1243542
2023-05-01 16:24,1243562,506878,507665,229019,1243562
2023-05-01 16:26,1243580,506891,507666,229023,1243580
2023-05-01 16:27,1243602,506911,507666,229025,1243602
2023-05-01 16:28,1243620,506924,507669,229027,1243620
2023-05-01 16:29,1243641,506944,507669,229028,1243641
2023-05-01 16:30,1243660,506958,507672,229030,1243660
2023-05-01 16:31,1243681,506978,507672,229031,1243681
2023-05-01 16:32,1243701,506994,507675,229032,1243701
2023-05-01 16:33,1243720,507005,507679,229036,1243720
2023-05-01 16:34,1243739,507021,507679,229039,1243739
2023-05-01 16:35,1243759,507038,507680,229041,1243759
2023-05-01 16:36,1243778,507052,507680,229046,1243778
2023-05-01 16:37,1243797,507065,507682,229050,1243797
2023-05-01 16:38,1243817,507082,507682,229053,1243817
2023-05-01 16:39,1243837,507095,507685,229057,1243837
2023-05-01 16:40,1243856,507112,507685,229059,1243856
2023-05-01 16:41,1243876,507126,507687,229063,1243876
2023-05-01 16:42,1243895,507141,507687,229067,1243895
2023-05-01 16:43,1243915,507153,507689,229073,1243915
2023-05-01 16:44,1243935,507170,507689,229076,1243935
2023-05-01 16:45,1243954,507183,507692,229079,1243954
2023-05-01 16:46,1243973,507199,507692,229082,1243973
2023-05-01 16:47,1243993,507216,507694,229083,1243993
2023-05-01 16:48,1244012,507233,507694,229085,1244012
2023-05-01 16:49,1244033,507248,507697,229088,1244033
2023-05-01 16:50,1244052,507263,507697,229092,1244052
2023-05-01 16:51,1244072,507281,507698,229093,1244072
2023-05-01 16:52,1244091,507298,507698,229095,1244091
2023-05-01 16:53,1244112,507316,507698,229098,1244112
2023-05-01 16:54,1244131,507335,507698,229098,1244131
2023-05-01 16:55,1244150,507350,507701,229099,1244150
2023-05-01 16:56,1244171,507369,507701,229101,1244171
2023-05-01 16:57,1244190,507383,507702,229105,1244190
2023-05-01 16:58,1244210,507403,507702,229105,1244210
2023-05-01 16:59,1244230,507415,507707,229108,1244230
2023-05-01 17:00,1244265,507447,507709,229109,1244265
2023-05-01 17:01,1244307,507489,507709,229109,1244307
2023-05-01 17:02,1244347,507526,507712,229109,1244347
2023-05-01 17:03,1244391,507569,507712,229110,1244391
2023-05-01 17:04,1244432,507605,507715,229112,1244432
2023-05-01 17:05,1244475,507646,507715,229114,1244475
2023-05-01 17:06,1244516,507680,507717,229119,1244516
2023-05-01 17:07,1244558,507720,507719,229119,1244558
2023-05-01 17:08,1244601,507758,507719,229124,1244601
2023-05-01 17:09,1244642,507794,507723,229125,1244642
2023-05-01 17:10,1244684,507834,507723,229127,1244684
2023-05-01 17:11,1244726,507870,507726,229130,1244726
2023-05-01 17:13,1244769,507910,507726,229133,1244769
2023-05-01 17:14,1244810,507946,507728,229136,1244810
2023-05-01 17:15,1244853,507984,507728,229141,1244853
2023-05-01 17:16,1244894,508016,507733,229145,1244894
2023-05-01 17:17,1244934,508055,507733,229146,1244934
2023-05-01 17:18,1244977,508095,507735,229147,1244977
2023-05-01 17:19,1245018,508135,507735,229148,1245018
2023-05-01 17:20,1245062,508170,507743,229149,1245062
2023-05-01 17:21,1245103,508207,507743,229153,1245103
2023-05-01 17:22,1245145,508244,507747,229154,1245145
2023-05-01 17:23,1245187,508284,507747,229156,1245187
2023-05-01 17:24,1245227,508318,507749,229160,1245227
2023-05-01 17:25,1245268,508354,507749,229165,1245268
2023-05-01 17:26,1245312,508393,507751,229168,1245312
2023-05-01 17:27,1245355,508429,507751,229175,1245355
2023-05-01 17:28,1245396,508458,507759,229179,1245396
2023-05-01 17:29,1245439,508496,507759,229184,1245439
2023-05-01 17:30,1245480,508530,507763,229187,1245480
2023-05-01 17:31,1245520,508566,507763,229191,1245520
2023-05-01 17:32,1245564,508609,507763,229192,1245564
2023-05-01 17:33,1245603,508645,507763,229195,1245603
2023-05-01 17:34,1245647,508686,507765,229196,1245647
2023-05-01 17:35,1245689,508727,507765,229197,1245689
2023-05-01 17:36,1245729,508766,507766,229197,1245729
2023-05-01 17:37,1245771,508806,507766,229199,1245771
2023-05-01 17:38,1245816,508846,507769,229201,1245816
2023-05-01 17:39,1245856,508884,507769,229203,1245856
2023-05-01 17:40,1245899,508924,507771,229204,1245899
2023-05-01 17:41,1245942,508965,507771,229206,1245942
2023-05-01 17:42,1245984,509000,507773,229211,1245984
2023-05-01 17:43,1246026,509039,507773,229214,1246026
2023-05-01 17:44,1246066,509074,507775,229217,1246066
2023-05-01 17:45,1246107,509112,507775,229220,1246107
2023-05-01 17:46,1246149,509148,507779,229222,1246149
2023-05-01 17:47,1246192,509189,507779,229224,1246192
2023-05-01 17:48,1246235,509226,507782,229227,1246235
2023-05-01 17:49,1246276,509266,507782,229228,1246276
2023-05-01 17:50,1246316,509299,507786,229231,1246316
2023-05-01 17:51,1246358,509339,507786,229233,1246358
2023-05-01 17:52,1246401,509377,507787,229237,1246401
2023-05-01 17:53,1246442,509416,507787,229239,1246442
2023-05-01 17:54,1246484,509452,507791,229241,1246484
2023-05-01 17:55,1246526,509493,507791,229242,1246526
2023-05-01 17:56,1246566,509524,507797,229245,1246566
2023-05-01 17:57,1246609,509566,507797,229246,1246609
2023-05-01 17:58,1246650,509603,507798,229249,1246650
2023-05-01 17:59,1246691,509641,507798,229252,1246691
2023-05-01 18:01,1246722,509664,507801,229257,1246722
2023-05-01 18:02,1246748,509688,507801,229259,1246748
2023-05-01 18:03,1246774,509712,507801,229261,1246774
2023-05-01 18:04,1246802,509736,507801,229265,1246802
2023-05-01 18:05,1246829,509756,507806,229267,1246829
2023-05-01 18:06,1246855,509780,507806,229269,1246855
2023-05-01 18:07,1246883,509806,507808,229269,1246883
2023-05-01 18:08,1246910,509832,507808,229270,1246910
2023-05-01 18:09,1246935,509853,507810,229272,1246935
2023-05-01 18:10,1246962,509878,507810,229274,1246962
2023-05-01 18:11,1246989,509900,507813,229276,1246989
2023-05-01 18:12,1247017,509926,507813,229278,1247017
2023-05-01 18:13,1247042,509946,507816,229280,1247042
2023-05-01 18:14,1247069,509972,507816,229281,1247069
2023-05-01 18:15,1247094,509990,507818,229286,1247094
2023-05-01 18:16,1247122,510013,507818,229291,1247122
2023-05-01 18:17,1247147,510033,507823,229291,1247147
2023-05-01 18:18,1247175,510057,507823,229295,1247175
2023-05-01 18:19,1247201,510079,507823,229299,1247201
2023-05-01 18:20,1247228,510099,507823,229306,1247228
2023-05-01 18:21,1247256,510125,507824,229307,1247256
2023-05-01 18:22,1247281,510146,507824,229311,1247281
2023-05-01 18:23,1247308,510166,507828,229314,1247308
2023-05-01 18:24,1247334,510188,507828,229318,1247334
2023-05-01 18:25,1247361,510212,507830,229319,1247361
2023-05-01 18:26,1247386,510233,507830,229323,1247386
2023-05-01 18:27,1247413,510256,507830,229327,1247413
2023-05-01 18:28,1247441,510278,507830,229333,1247441
2023-05-01 18:29,1247468,510303,507831,229334,1247468
2023-05-01 18:30,1247492,510323,507831,229338,1247492
2023-05-01 18:31,1247521,510349,507832,229340,1247521
2023-05-01 18:32,1247548,510375,507832,229341,1247548
2023-05-01 18:33,1247574,510397,507833,229344,1247574
2023-05-01 18:34,1247600,510423,507834,229343,1247600
2023-05-01 18:35,1247626,510447,507834,229345,1247626
2023-05-01 18:36,1247653,510467,507839,229347,1247653
2023-05-01 18:37,1247680,510489,507842,229349,1247680
2023-05-01 18:38,1247706,510514,507842,229350,1247706
2023-05-01 18:39,1247734,510538,507842,229354,1247734
2023-05-01 18:40,1247762,510565,507842,229355,1247762
2023-05-01 18:41,1247787,510587,507843,229357,1247787
2023-05-01 18:42,1247815,510614,507843,229358,1247815
2023-05-01 18:43,1247842,510639,507842,229361,1247842
2023-05-01 18:44,1247869,510664,507844,229361,1247869
2023-05-01 18:45,1247894,510688,507844,229362,1247894
2023-05-01 18:46,1247920,510709,507848,229363,1247920
2023-05-01 18:47,1247949,510737,507849,229363,1247949
2023-05-01 18:49,1247974,510761,507849,229364,1247974
2023-05-01 18:50,1248001,510782,507853,229366,1248001
2023-05-01 18:51,1248028,510807,507853,229368,1248028
2023-05-01 18:52,1248053,510831,507854,229368,1248053
2023-05-01 18:53,1248080,510858,507854,229368,1248080
2023-05-01 18:54,1248108,510881,507857,229370,1248108
2023-05-01 18:55,1248132,510903,507857,229372,1248132
2023-05-01 18:56,1248161,510929,507858,229374,1248161
2023-05-01 18:57,1248187,510948,507858,229381,1248187
2023-05-01 18:58,1248213,510966,507862,229385,1248213
2023-05-01 18:59,1248240,510992,507862,229386,1248240
2023-05-01 19:00,1248266,511014,507866,229386,1248266
2023-05-01 19:01,1248291,511036,507866,229389,1248291
2023-05-01 19:02,1248315,511053,507871,229391,1248315
2023-05-01 19:03,1248340,511077,507871,229392,1248340
2023-05-01 19:04,1248366,511095,507877,229394,1248366
2023-05-01 19:05,1248390,511115,507877,229398,1248390
2023-05-01 19:06,1248414,511133,507880,229401,1248414
2023-05-01 19:07,1248439,511156,507880,229403,1248439
2023-05-01 19:08,1248465,511179,507882,229404,1248465
2023-05-01 19:09,1248490,511203,507882,229405,1248490
2023-05-01 19:10,1248515,511223,507886,229406,1248515
2023-05-01 19:11,1248540,511246,507886,229408,1248540
2023-05-01 19:12,1248564,511268,507886,229410,1248564
2023-05-01 19:13,1248589,511292,507886,229411,1248589
2023-05-01 19:14,1248613,511311,507886,229416,1248613
2023-05-01 19:15,1248638,511334,507886,229418,1248638
2023-05-01 19:16,1248663,511356,507886,229421,1248663
2023-05-01 19:17,1248689,511381,507886,229422,1248689
2023-05-01 19:18,1248713,511401,507886,229426,1248713
2023-05-01 19:19,1248737,511424,507886,229427,1248737
2023-05-01 19:20,1248762,511430,507903,229429,1248762
2023-05-01 19:21,1248788,511456,507903,229429,1248788
2023-05-01 19:22,1248812,511475,507908,229429,1248812
2023-05-01 19:23,1248837,511499,507908,229430,1248837
2023-05-01 19:24,1248861,511513,507915,229433,1248861
2023-05-01 19:25,1248887,511537,507916,229434,1248887
2023-05-01 19:26,1248911,511559,507916,229436,1248911
2023-05-01 19:27,1248936,511582,507918,229436,1248936
2023-05-01 19:28,1248962,511606,507918,229438,1248962
2023-05-01 19:29,1248986,511626,507920,229440,1248986
2023-05-01 19:30,1249011,511649,507920,229442,1249011
2023-05-01 19:31,1249036,511669,507923,229444,1249036
2023-05-01 19:32,1249060,511689,507923,229448,1249060
2023-05-01 19:33,1249085,511709,507926,229450,1249085
2023-05-01 19:34,1249110,511733,507926,229451,1249110
2023-05-01 19:36,1249134,511748,507931,229455,1249134
2023-05-01 19:37,1249159,511772,507931,229456,1249159
2023-05-01 19:38,1249184,511790,507935,229459,1249184
2023-05-01 19:39,1249209,511813,507935,229461,1249209
2023-05-01 19:40,1249235,511835,507938,229462,1249235
2023-05-01 19:41,1249260,511860,507938,229462,1249260
2023-05-01 19:42,1249285,511883,507940,229462,1249285
2023-05-01 19:43,1249310,511906,507940,229464,1249310
2023-05-01 19:44,1249334,511926,507942,229466,1249334
2023-05-01 19:45,1249359,511951,507942,229466,1249359
2023-05-01 19:46,1249384,511967,507948,229469,1249384
2023-05-01 19:47,1249409,511988,507948,229473,1249409
2023-05-01 19:48,1249434,512009,507951,229474,1249434
2023-05-01 19:49,1249460,512030,507955,229475,1249460
2023-05-01 19:50,1249484,512052,507955,229477,1249484
2023-05-01 19:51,1249509,512073,507959,229477,1249509
2023-05-01 19:52,1249533,512096,507959,229478,1249533
2023-05-01 19:53,1249558,512117,507962,229479,1249558
2023-05-01 19:54,1249584,512142,507962,229480,1249584
2023-05-01 19:55,1249609,512160,507965,229484,1249609
2023-05-01 19:56,1249633,512180,507968,229485,1249633
2023-05-01 19:57,1249656,512200,507969,229487,1249656
2023-05-01 19:58,1249682,512225,507969,229488,1249682
2023-05-01 19:59,1249707,512243,507975,229489,1249707
2023-05-01 20:00,1249730,512265,507975,229490,1249730
2023-05-01 20:01,1249752,512282,507980,229490,1249752
2023-05-01 20:02,1249773,512301,507980,229492,1249773
2023-05-01 20:03,1249794,512319,507982,229493,1249794
2023-05-01 20:04,1249817,512340,507982,229495,1249817
2023-05-01 20:05,1249837,512360,507982,229495,1249837
2023-05-01 20:06,1249859,512381,507982,229496,1249859
2023-05-01 20:07,1249881,512398,507984,229499,1249881
2023-05-01 20:08,1249902,512418,507984,229500,1249902
2023-05-01 20:09,1249924,512434,507989,229501,1249924
2023-05-01 20:10,1249946,512452,507989,229505,1249946
2023-05-01 20:11,1249967,512472,507990,229505,1249967
2023-05-01 20:12,1249989,512491,507990,229508,1249989
2023-05-01 20:13,1250009,512505,507994,229510,1250009
2023-05-01 20:14,1250032,512527,507994,229511,1250032
2023-05-01 20:15,1250052,512539,507998,229515,1250052
2023-05-01 20:16,1250074,512561,507998,229515,1250074
2023-05-01 20:17,1250095,512579,507998,229518,1250095
2023-05-01 20:18,1250116,512594,508001,229521,1250116
2023-05-01 20:19,1250139,512615,508001,229523,1250139
2023-05-01 20:20,1250159,512627,508006,229526,1250159
2023-05-01 20:21,1250181,512646,508008,229527,1250181
2023-05-01 20:22,1250202,512664,508008,229530,1250202
2023-05-01 20:24,1250224,512681,508010,229533,1250224
2023-05-01 20:25,1250244,512698,508010,229536,1250244
2023-05-01 20:26,1250266,512711,508016,229539,1250266
2023-05-01 20:27,1250287,512730,508016,229541,1250287
2023-05-01 20:28,1250309,512746,508018,229545,1250309
2023-05-01 20:29,1250329,512764,508018,229547,1250329
2023-05-01 20:30,1250351,512777,508023,229551,1250351
2023-05-01 20:31,1250372,512795,508023,229554,1250372
2023-05-01 20:32,1250393,512813,508024,229556,1250393
2023-05-01 20:33,1250416,512835,508024,229557,1250416
2023-05-01 20:34,1250436,512848,508028,229560,1250436
2023-05-01 20:35,1250458,512869,508028,229561,1250458
2023-05-01 20:36,1250479,512883,508032,229564,1250479
2023-05-01 20:37,1250500,512903,508032,229565,1250500
2023-05-01 20:38,1250522,512920,508035,229567,1250522
2023-05-01 20:39,1250543,512937,508035,229571,1250543
2023-05-01 20:40,1250565,512956,508037,229572,1250565
2023-05-01 20:41,1250586,512976,508037,229573,1250586
2023-05-01 20:42,1250607,512994,508037,229576,1250607
2023-05-01 20:43,1250630,513016,508037,229577,1250630
2023-05-01 20:44,1250651,513036,508037,229578,1250651
2023-05-01 20:45,1250672,513054,508037,229581,1250672
2023-05-01 20:46,1250693,513071,508037,229585,1250693
2023-05-01 20:47,1250715,513091,508037,229587,1250715
2023-05-01 20:48,1250736,513111,508037,229588,1250736
2023-05-01 20:49,1250757,513130,508037,229590,1250757
2023-05-01 20:50,1250779,513141,508046,229592,1250779
2023-05-01 20:51,1250800,513163,508046,229591,1250800
2023-05-01 20:52,1250822,513185,508046,229591,1250822
2023-05-01 20:53,1250845,513200,508051,229594,1250845
2023-05-01 20:54,1250866,513218,508051,229597,1250866
2023-05-01 20:55,1250888,513235,508055,229598,1250888
2023-05-01 20:56,1250909,513254,508055,229600,1250909
2023-05-01 20:57,1250931,513268,508062,229601,1250931
2023-05-01 20:58,1250953,513289,508062,229602,1250953
2023-05-01 20:59,1250973,513308,508063,229602,1250973
2023-05-01 21:00,1251001,513330,508067,229604,1251001
2023-05-01 21:01,1251033,513361,508067,229605,1251033
2023-05-01 21:02,1251065,513392,508067,229606,1251065
2023-05-01 21:03,1251100,513422,508067,229611,1251100
2023-05-01 21:04,1251129,513447,508068,229614,1251129
2023-05-01 21:05,1251161,513479,508067,229615,1251161
2023-05-01 21:06,1251193,513508,508069,229616,1251193
2023-05-01 21:07,1251225,513536,508069,229620,1251225
2023-05-01 21:08,1251256,513560,508074,229622,1251256
2023-05-01 21:09,1251288,513591,508074,229623,1251288
2023-05-01 21:10,1251320,513619,508076,229625,1251320
2023-05-01 21:12,1251352,513646,508076,229630,1251352
2023-05-01 21:13,1251382,513672,508078,229632,1251382
2023-05-01 21:14,1251415,513703,508078,229634,1251415
2023-05-01 21:15,1251446,513726,508085,229635,1251446
2023-05-01 21:16,1251478,513756,508085,229637,1251478
2023-05-01 21:17,1251511,513782,508088,229641,1251511
2023-05-01 21:18,1251542,513811,508088,229643,1251542
2023-05-01 21:19,1251573,513830,508098,229645,1251573
2023-05-01 21:20,1251606,513860,508098,229648,1251606
2023-05-01 21:21,1251637,513882,508102,229653,1251637
2023-05-01 21:22,1251669,513912,508102,229655,1251669
2023-05-01 21:23,1251701,513938,508104,229659,1251701
2023-05-01 21:24,1251732,513968,508104,229660,1251732
2023-05-01 21:25,1251766,513996,508106,229664,1251766
2023-05-01 21:26,1251797,514021,508108,229668,1251797
2023-05-01 21:27,1251827,514048,508108,229671,1251827
2023-05-01 21:28,1251860,514078,508108,229674,1251860
2023-05-01 21:29,1251892,514110,508108,229674,1251892
2023-05-01 21:30,1251922,514138,508108,229676,1251922
2023-05-01 21:31,1251954,514168,508108,229678,1251954
2023-05-01 21:32,1251986,514197,508108,229681,1251986
2023-05-01 21:33,1252017,514226,508108,229683,1252017
2023-05-01 21:34,1252049,514246,508119,229684,1252049
2023-05-01 21:35,1252080,514276,508119,229685,1252080
2023-05-01 21:36,1252112,514301,508124,229687,1252112
2023-05-01 21:37,1252144,514330,508124,229690,1252144
2023-05-01 21:38,1252176,514356,508126,229694,1252176
2023-05-01 21:39,1252210,514389,508126,229695,1252210
2023-05-01 21:40,1252241,514419,508127,229695,1252241
2023-05-01 21:41,1252272,514446,508128,229698,1252272
2023-05-01 21:42,1252303,514476,508128,229699,1252303
2023-05-01 21:43,1252336,514504,508132,229700,1252336
2023-05-01 21:44,1252367,514532,508132,229703,1252367
2023-05-01 21:45,1252399,514554,508140,229705,1252399
2023-05-01 21:46,1252429,514584,508140,229705,1252429
2023-05-01 21:47,1252462,514610,508144,229708,1252462
2023-05-01 21:48,1252494,514639,508144,229711,1252494
2023-05-01 21:49,1252526,514667,508148,229711,1252526
2023-05-01 21:50,1252557,514696,508148,229713,1252557
2023-05-01 21:51,1252589,514720,508153,229716,1252589
2023-05-01 21:52,1252619,514746,508153,229720,1252619
2023-05-01 21:53,1252653,514772,508157,229724,1252653
2023-05-01 21:54,1252685,514803,508157,229725,1252685
2023-05-01 21:55,1252717,514832,508159,229726,1252717
2023-05-01 21:57,1252749,514861,508159,229729,1252749
2023-05-01 21:58,1252778,514881,508166,229731,1252778
2023-05-01 21:59,1252811,514912,508166,229733,1252811
2023-05-01 22:00,1252843,514942,508167,229734,1252843
2023-05-01 22:01,1252857,514956,508167,229734,1252857
2023-05-01 22:02,1252870,514967,508167,229736,1252870
2023-05-01 22:03,1252884,514981,508167,229736,1252884
2023-05-01 22:04,1252897,514991,508167,229739,1252897
2023-05-01 22:05,1252911,514997,508173,229741,1252911
2023-05-01 22:06,1252923,515003,508173,229747,1252923
2023-05-01 22:07,1252937,515014,508173,229750,1252937
2023-05-01 22:08,1252950,515024,508175,229751,1252950
2023-05-01 22:09,1252965,515038,508175,229752,1252965
2023-05-01 22:10,1252977,515044,508179,229754,1252977
2023-05-01 22:11,1252991,515050,508184,229757,1252991
2023-05-01 22:12,1253004,515060,508184,229760,1253004
2023-05-01 22:13,1253018,515065,508190,229763,1253018
2023-05-01 22:14,1253030,515074,508192,229764,1253030
2023-05-01 22:15,1253044,515084,508192,229768,1253044
2023-05-01 22:16,1253057,515088,508199,229770,1253057
2023-05-01 22:17,1253071,515099,508199,229773,1253071
2023-05-01 22:18,1253083,515111,508198,229774,1253083
2023-05-01 22:19,1253097,515125,508198,229774,1253097
2023-05-01 22:20,1253110,515132,508202,229776,1253110
2023-05-01 22:21,1253124,515143,508202,229779,1253124
2023-05-01 22:22,1253138,515154,508203,229781,1253138
2023-05-01 22:23,1253152,515166,508203,229783,1253152
2023-05-01 22:24,1253166,515172,508207,229787,1253166
2023-05-01 22:25,1253179,515183,508207,229789,1253179
2023-05-01 22:26,1253192,515190,508210,229792,1253192
2023-05-01 22:27,1253206,515202,508210,229794,1253206
2023-05-01 22:28,1253219,515211,508214,229794,1253219
2023-05-01 22:29,1253233,515225,508214,229794,1253233
2023-05-01 22:30,1253246,515233,508218,229795,1253246
2023-05-01 22:31,1253260,515246,508218,229796,1253260
2023-05-01 22:32,1253273,515253,508222,229798,1253273
2023-05-01 22:33,1253286,515262,508222,229802,1253286
2023-05-01 22:34,1253301,515271,508227,229803,1253301
2023-05-01 22:35,1253314,515283,508227,229804,1253314
2023-05-01 22:36,1253327,515288,508228,229811,1253327
2023-05-01 22:37,1253341,515300,508228,229813,1253341
2023-05-01 22:38,1253355,515313,508228,229814,1253355
2023-05-01 22:39,1253368,515326,508228,229814,1253368
2023-05-01 22:40,1253381,515336,508229,229816,1253381
2023-05-01 22:41,1253394,515347,508229,229818,1253394
2023-05-01 22:42,1253409,515356,508234,229819,1253409
2023-05-01 22:43,1253421,515366,508234,229821,1253421
2023-05-01 22:45,1253435,515372,508238,229825,1253435
2023-05-01 22:46,1253448,515379,508237,229832,1253448
2023-05-01 22:47,1253461,515390,508237,229834,1253461
2023-05-01 22:48,1253475,515397,508240,229838,1253475
2023-05-01 22:49,1253489,515406,508240,229843,1253489
2023-05-01 22:50,1253502,515411,508246,229845,1253502
2023-05-01 22:51,1253515,515420,508246,229849,1253515
2023-05-01 22:52,1253529,515426,508251,229852,1253529
2023-05-01 22:53,1253542,515437,508251,229854,1253542
2023-05-01 22:54,1253555,515444,508253,229858,1253555
2023-05-01 22:55,1253569,515456,508253,229860,1253569
2023-05-01 22:56,1253581,515460,508255,229866,1253581
2023-05-01 22:57,1253595,515472,508255,229868,1253595
2023-05-01 22:58,1253608,515481,508257,229870,1253608
2023-05-01 22:59,1253622,515493,508257,229872,1253622
2023-05-01 23:00,1253640,515504,508262,229874,1253640
2023-05-01 23:01,1253668,515527,508264,229877,1253668
2023-05-01 23:02,1253695,515548,508266,229881,1253695
2023-05-01 23:03,1253725,515577,508266,229882,1253725
2023-05-01 23:04,1253752,515601,508269,229882,1253752
2023-05-01 23:05,1253780,515627,508269,229884,1253780
2023-05-01 23:06,1253807,515647,508272,229888,1253807
2023-05-01 23:07,1253836,515675,508272,229889,1253836
2023-05-01 23:08,1253864,515700,508275,229889,1253864
2023-05-01 23:09,1253890,515720,508277,229893,1253890
2023-05-01 23:10,1253920,515750,508277,229893,1253920
2023-05-01 23:11,1253948,515772,508280,229896,1253948
2023-05-01 23:12,1253976,515795,508280,229901,1253976
2023-05-01 23:13,1254003,515818,508282,229903,1254003
2023-05-01 23:14,1254030,515843,508282,229905,1254030
2023-05-01 23:15,1254058,515866,508284,229908,1254058
2023-05-01 23:16,1254086,515892,508284,229910,1254086
2023-05-01 23:17,1254116,515916,508286,229914,1254116
2023-05-01 23:18,1254144,515942,508286,229916,1254144
2023-05-01 23:19,1254173,515959,508296,229918,1254173
2023-05-01 23:20,1254200,515986,508296,229918,1254200
2023-05-01 23:21,1254230,516012,508299,229919,1254230
2023-05-01 23:22,1254257,516037,508299,229921,1254257
2023-05-01 23:23,1254285,516056,508302,229927,1254285
2023-05-01 23:24,1254312,516078,508302,229932,1254312
2023-05-01 23:25,1254340,516098,508304,229938,1254340
2023-05-01 23:26,1254368,516122,508306,229940,1254368
2023-05-01 23:27,1254396,516145,508306,229945,1254396
2023-05-01 23:28,1254423,516165,508309,229949,1254423
2023-05-01 23:29,1254453,516194,508309,229950,1254453
2023-05-01 23:30,1254481,516216,508313,229952,1254481
2023-05-01 23:32,1254509,516239,508316,229954,1254509
2023-05-01 23:33,1254537,516263,508318,229956,1254537
2023-05-01 23:34,1254564,516285,508318,229961,1254564
2023-05-01 23:35,1254592,516313,508318,229961,1254592
2023-05-01 23:36,1254621,516337,508318,229966,1254621
2023-05-01 23:37,1254649,516358,508322,229969,1254649
2023-05-01 23:38,1254677,516382,508322,229973,1254677
2023-05-01 23:39,1254704,516407,508323,229974,1254704
2023-05-01 23:40,1254733,516432,508323,229978,1254733
2023-05-01 23:41,1254762,516456,508326,229980,1254762
2023-05-01 23:42,1254791,516485,508326,229980,1254791
2023-05-01 23:43,1254818,516504,508330,229984,1254818
2023-05-01 23:44,1254846,516528,508330,229988,1254846
2023-05-01 23:45,1254872,516550,508332,229990,1254872
2023-05-01 23:46,1254901,516577,508332,229992,1254901
2023-05-01 23:47,1254930,516602,508334,229994,1254930
2023-05-01 23:48,1254956,516623,508334,229999,1254956
2023-05-01 23:49,1254984,516638,508342,230004,1254984
2023-05-01 23:50,1255014,516663,508342,230009,1255014
2023-05-01 23:51,1255041,516684,508344,230013,1255041
2023-05-01 23:52,1255070,516710,508344,230016,1255070
2023-05-01 23:53,1255098,516734,508346,230018,1255098
2023-05-01 23:54,1255126,516758,508348,230020,1255126
2023-05-01 23:55,1255153,516780,508350,230023,1255153
2023-05-01 23:56,1255181,516807,508350,230024,1255181
2023-05-01 23:57,1255209,516828,508355,230026,1255209
2023-05-01 23:58,1255240,516857,508355,230028,1255240
2023-05-01 23:59,1255266,516879,508357,230030,1255266
2023-05-02 00:00,1255298,516911,508357,230030,1255298
2023-05-02 00:01,1255333,516939,508363,230031,1255333
2023-05-02 00:02,1255368,516974,508363,230031,1255368
2023-05-02 00:03,1255405,517005,508367,230033,1255405
2023-05-02 00:04,1255437,517036,508367,230034,1255437
2023-05-02 00:05,1255471,517070,508366,230035,1255471
2023-05-02 00:06,1255507,517105,508366,230036,1255507
2023-05-02 00:07,1255540,517131,508368,230041,1255540
2023-05-02 00:08,1255576,517167,508368,230041,1255576
2023-05-02 00:09,1255611,517194,508373,230044,1255611
2023-05-02 00:10,1255645,517226,508373,230046,1255645
2023-05-02 00:11,1255680,517257,508376,230047,1255680
2023-05-02 00:12,1255715,517291,508376,230048,1255715
2023-05-02 00:13,1255748,517323,508377,230048,1255748
2023-05-02 00:14,1255784,517358,508377,230049,1255784
2023-05-02 00:15,1255818,517388,508379,230051,1255818
2023-05-02 00:16,1255851,517419,508379,230053,1255851
2023-05-02 00:17,1255885,517449,508382,230054,1255885
2023-05-02 00:18,1255922,517484,508382,230056,1255922
2023-05-02 00:20,1255954,517512,508384,230058,1255954
2023-05-02 00:21,1255989,517546,508384,230059,1255989
2023-05-02 00:22,1256023,517577,508386,230060,1256023
2023-05-02 00:23,1256056,517610,508386,230060,1256056
2023-05-02 00:24,1256093,517645,508386,230062,1256093
2023-05-02 00:25,1256125,517675,508386,230064,1256125
2023-05-02 00:26,1256160,517706,508390,230064,1256160
2023-05-02 00:27,1256193,517737,508390,230066,1256193
2023-05-02 00:28,1256228,517769,508391,230068,1256228
2023-05-02 00:29,1256263,517801,508391,230071,1256263
2023-05-02 00:30,1256297,517829,508394,230074,1256297
2023-05-02 00:31,1256329,517857,508394,230078,1256329
2023-05-02 00:32,1256365,517890,508394,230081,1256365
2023-05-02 00:33,1256398,517923,508394,230081,1256398
2023-05-02 00:34,1256433,517957,508394,230082,1256433
2023-05-02 00:35,1256468,517993,508394,230081,1256468
2023-05-02 00:36,1256500,518025,508394,230081,1256500
2023-05-02 00:37,1256536,518058,508394,230084,1256536
2023-05-02 00:38,1256569,518092,508394,230083,1256569
2023-05-02 00:39,1256604,518125,508394,230085,1256604
2023-05-02 00:40,1256639,518150,508403,230086,1256639
2023-05-02 00:41,1256672,518182,508403,230087,1256672
2023-05-02 00:42,1256706,518214,508405,230087,1256706
2023-05-02 00:43,1256740,518247,508405,230088,1256740
2023-05-02 00:44,1256776,518279,508409,230088,1256776
2023-05-02 00:45,1256809,518308,508409,230092,1256809
2023-05-02 00:46,1256843,518338,508411,230094,1256843
2023-05-02 00:47,1256877,518372,508411,230094,1256877
2023-05-02 00:48,1256911,518403,508413,230095,1256911
2023-05-02 00:49,1256947,518437,508413,230097,1256947
2023-05-02 00:50,1256979,518468,508413,230098,1256979
2023-05-02 00:51,1257014,518503,508413,230098,1257014
2023-05-02 00:52,1257049,518534,508413,230102,1257049
2023-05-02 00:53,1257083,518567,508413,230103,1257083
2023-05-02 00:54,1257119,518598,508413,230108,1257119
2023-05-02 00:55,1257153,518631,508413,230109,1257153
2023-05-02 00:56,1257185,518656,508417,230112,1257185
2023-05-02 00:57,1257221,518690,508417,230114,1257221
2023-05-02 00:58,1257256,518718,508421,230117,1257256
2023-05-02 00:59,1257288,518750,508421,230117,1257288
2023-05-02 01:00,1257329,518788,508422,230119,1257329
2023-05-02 01:01,1257371,518830,508422,230119,1257371
2023-05-02 01:02,1257410,518866,508425,230119,1257410
2023-05-02 01:03,1257452,518908,508425,230119,1257452
2023-05-02 01:04,1257496,518949,508427,230120,1257496
2023-05-02 01:05,1257537,518987,508427,230123,1257537
2023-05-02 01:07,1257577,519024,508429,230124,1257577
2023-05-02 01:08,1257619,519066,508429,230124,1257619
2023-05-02 01:09,1257660,519106,508429,230125,1257660
2023-05-02 01:10,1257702,519148,508429,230125,1257702
2023-05-02 01:11,1257745,519186,508433,230126,1257745
2023-05-02 01:12,1257787,519226,508433,230128,1257787
2023-05-02 01:13,1257828,519265,508434,230129,1257828
2023-05-02 01:14,1257868,519305,508434,230129,1257868
2023-05-02 01:15,1257910,519343,508436,230131,1257910
2023-05-02 01:16,1257951,519384,508436,230131,1257951
2023-05-02 01:17,1257994,519424,508439,230131,1257994
2023-05-02 01:18,1258037,519465,508439,230133,1258037
2023-05-02 01:19,1258076,519501,508441,230134,1258076
2023-05-02 01:20,1258119,519541,508441,230137,1258119
2023-05-02 01:21,1258161,519582,508442,230137,1258161
2023-05-02 01:22,1258202,519623,508442,230137,1258202
2023-05-02 01:23,1258243,519661,508444,230138,1258243
2023-05-02 01:24,1258286,519704,508444,230138,1258286
2023-05-02 01:25,1258329,519745,508445,230139,1258329
2023-05-02 01:26,1258369,519785,508445,230139,1258369
2023-05-02 01:27,1258411,519826,508446,230139,1258411
2023-05-02 01:28,1258451,519863,508446,230142,1258451
2023-05-02 01:29,1258492,519895,508451,230146,1258492
2023-05-02 01:30,1258535,519938,508451,230146,1258535
2023-05-02 01:31,1258575,519976,508453,230146,1258575
2023-05-02 01:32,1258617,520017,508453,230147,1258617
2023-05-02 01:33,1258660,520057,508454,230149,1258660
2023-05-02 01:34,1258700,520094,508456,230150,1258700
2023-05-02 01:35,1258741,520134,508456,230151,1258741
2023-05-02 01:36,1258786,520174,508461,230151,1258786
2023-05-02 01:37,1258827,520215,508461,230151,1258827
2023-05-02 01:38,1258868,520254,508463,230151,1258868
2023-05-02 01:39,1258908,520292,508463,230153,1258908
2023-05-02 01:40,1258950,520332,508463,230155,1258950
2023-05-02 01:41,1258993,520375,508463,230155,1258993
2023-05-02 01:42,1259035,520412,508466,230157,1259035
2023-05-02 01:43,1259075,520451,508466,230158,1259075
2023-05-02 01:44,1259115,520490,508467,230158,1259115
2023-05-02 01:45,1259158,520529,508467,230162,1259158
2023-05-02 01:46,1259198,520566,508469,230163,1259198
2023-05-02 01:47,1259243,520608,508469,230166,1259243
2023-05-02 01:48,1259284,520648,508469,230167,1259284
2023-05-02 01:49,1259324,520686,508470,230168,1259324
2023-05-02 01:50,1259366,520728,508470,230168,1259366
2023-05-02 01:51,1259406,520764,508471,230171,1259406
2023-05-02 01:52,1259451,520807,508471,230173,1259451
2023-05-02 01:53,1259492,520845,508472,230175,1259492
2023-05-02 01:55,1259533,520885,508472,230176,1259533
2023-05-02 01:56,1259576,520928,508472,230176,1259576
2023-05-02 01:57,1259615,520967,508472,230176,1259615
2023-05-02 01:58,1259661,521011,508474,230176,1259661
2023-05-02 01:59,1259699,521049,508474,230176,1259699
2023-05-02 02:00,1259741,521090,508474,230177,1259741
2023-05-02 02:01,1259763,521110,508474,230179,1259763
2023-05-02 02:02,1259786,521131,508475,230180,1259786
2023-05-02 02:03,1259808,521151,508475,230182,1259808
2023-05-02 02:04,1259829,521171,508475,230183,1259829
2023-05-02 02:05,1259851,521192,508475,230184,1259851
2023-05-02 02:06,1259873,521210,508477,230186,1259873
2023-05-02 02:07,1259896,521233,508477,230186,1259896
2023-05-02 02:08,1259918,521255,508477,230186,1259918
2023-05-02 02:09,1259940,521277,508477,230186,1259940
2023-05-02 02:10,1259961,521298,508477,230186,1259961
2023-05-02 02:11,1259984,521319,508477,230188,1259984
2023-05-02 02:12,1260006,521339,508478,230189,1260006
2023-05-02 02:13,1260027,521360,508478,230189,1260027
2023-05-02 02:14,1260049,521382,508478,230189,1260049
2023-05-02 02:15,1260072,521405,508478,230189,1260072
2023-05-02 02:16,1260094,521426,508479,230189,1260094
2023-05-02 02:17,1260116,521446,508479,230191,1260116
2023-05-02 02:18,1260138,521468,508479,230191,1260138
2023-05-02 02:19,1260159,521485,508479,230195,1260159
2023-05-02 02:20,1260183,521508,508479,230196,1260183
2023-05-02 02:21,1260203,521528,508479,230196,1260203
2023-05-02 02:22,1260226,521550,508480,230196,1260226
2023-05-02 02:23,1260247,521571,508480,230196,1260247
2023-05-02 02:24,1260270,521592,508481,230197,1260270
2023-05-02 02:25,1260293,521614,508481,230198,1260293
2023-05-02 02:26,1260314,521633,508481,230200,1260314
2023-05-02 02:27,1260338,521657,508481,230200,1260338
2023-05-02 02:28,1260359,521676,508482,230201,1260359
2023-05-02 02:29,1260381,521698,508482,230201,1260381
2023-05-02 02:30,1260404,521718,508485,230201,1260404
2023-05-02 02:31,1260425,521738,508485,230202,1260425
2023-05-02 02:32,1260447,521758,508486,230203,1260447
2023-05-02 02:33,1260470,521780,508486,230204,1260470
2023-05-02 02:34,1260491,521799,508487,230205,1260491
2023-05-02 02:35,1260512,521819,508487,230206,1260512
2023-05-02 02:36,1260534,521838,508487,230209,1260534
2023-05-02 02:37,1260558,521861,508487,230210,1260558
2023-05-02 02:38,1260580,521883,508487,230210,1260580
2023-05-02 02:39,1260602,521903,508487,230212,1260602
2023-05-02 02:40,1260623,521921,508489,230213,1260623
2023-05-02 02:41,1260646,521944,508489,230213,1260646
2023-05-02 02:42,1260667,521965,508489,230213,1260667
2023-05-02 02:44,1260689,521987,508489,230213,1260689
2023-05-02 02:45,1260711,522005,508489,230217,1260711
2023-05-02 02:46,1260734,522027,508489,230218,1260734
2023-05-02 02:47,1260756,522048,508490,230218,1260756
2023-05-02 02:48,1260777,522069,508490,230218,1260777
2023-05-02 02:49,1260801,522092,508490,230219,1260801
2023-05-02 02:50,1260822,522112,508490,230220,1260822
2023-05-02 02:51,1260843,522133,508490,230220,1260843
2023-05-02 02:52,1260866,522155,508491,230220,1260866
2023-05-02 02:53,1260887,522176,508491,230220,1260887
2023-05-02 02:54,1260910,522197,508493,230220,1260910
2023-05-02 02:55,1260932,522218,508493,230221,1260932
2023-05-02 02:56,1260954,522239,508494,230221,1260954
2023-05-02 02:57,1260976,522260,508494,230222,1260976
2023-05-02 02:58,1260997,522280,508495,230222,1260997
2023-05-02 02:59,1261019,522302,508495,230222,1261019
2023-05-02 03:00,1261043,522324,508496,230223,1261043
2023-05-02 03:01,1261069,522350,508496,230223,1261069
2023-05-02 03:02,1261095,522375,508497,230223,1261095
2023-05-02 03:03,1261121,522401,508497,230223,1261121
2023-05-02 03:04,1261147,522427,508497,230223,1261147
2023-05-02 03:05,1261174,522454,508497,230223,1261174
2023-05-02 03:06,1261199,522477,508499,230223,1261199
2023-05-02 03:07,1261225,522503,508499,230223,1261225
2023-05-02 03:08,1261252,522527,508501,230224,1261252
2023-05-02 03:09,1261278,522553,508501,230224,1261278
2023-05-02 03:10,1261303,522577,508502,230224,1261303
2023-05-02 03:11,1261329,522603,508502,230224,1261329
2023-05-02 03:12,1261357,522630,508502,230225,1261357
2023-05-02 03:13,1261382,522655,508502,230225,1261382
2023-05-02 03:14,1261408,522680,508503,230225,1261408
2023-05-02 03:15,1261434,522705,508503,230226,1261434
2023-05-02 03:16,1261461,522731,508503,230227,1261461
2023-05-02 03:17,1261487,522757,508503,230227,1261487
2023-05-02 03:18,1261513,522781,508505,230227,1261513
2023-05-02 03:19,1261539,522807,508505,230227,1261539
2023-05-02 03:20,1261565,522832,508506,230227,1261565
2023-05-02 03:21,1261592,522856,508506,230230,1261592
2023-05-02 03:22,1261617,522880,508507,230230,1261617
2023-05-02 03:23,1261643,522905,508507,230231,1261643
2023-05-02 03:24,1261669,522931,508507,230231,1261669
2023-05-02 03:25,1261697,522959,508507,230231,1261697
2023-05-02 03:26,1261722,522982,508507,230233,1261722
2023-05-02 03:27,1261748,523008,508507,230233,1261748
2023-05-02 03:28,1261774,523033,508508,230233,1261774
2023-05-02 03:29,1261801,523059,508508,230234,1261801
2023-05-02 03:31,1261826,523083,508508,230235,1261826
2023-05-02 03:32,1261853,523110,508508,230235,1261853
2023-05-02 03:33,1261877,523133,508508,230236,1261877
2023-05-02 03:34,1261904,523158,508508,230238,1261904
2023-05-02 03:35,1261929,523182,508508,230239,1261929
2023-05-02 03:36,1261957,523209,508508,230240,1261957
2023-05-02 03:37,1261982,523234,508508,230240,1261982
2023-05-02 03:38,1262009,523261,508508,230240,1262009
2023-05-02 03:39,1262034,523286,508508,230240,1262034
2023-05-02 03:40,1262060,523312,508508,230240,1262060
2023-05-02 03:41,1262087,523338,508508,230241,1262087
2023-05-02 03:42,1262113,523364,508508,230241,1262113
2023-05-02 03:43,1262139,523389,508509,230241,1262139
2023-05-02 03:44,1262165,523414,508509,230242,1262165
2023-05-02 03:45,1262192,523440,508510,230242,1262192
2023-05-02 03:46,1262218,523466,508510,230242,1262218
2023-05-02 03:47,1262243,523490,508510,230243,1262243
2023-05-02 03:48,1262269,523516,508510,230243,1262269
2023-05-02 03:49,1262295,523540,508510,230245,1262295
2023-05-02 03:50,1262322,523566,508510,230246,1262322
2023-05-02 03:51,1262348,523592,508510,230246,1262348
2023-05-02 03:52,1262373,523617,508510,230246,1262373
2023-05-02 03:53,1262400,523642,508512,230246,1262400
2023-05-02 03:54,1262426,523667,508512,230247,1262426
2023-05-02 03:55,1262452,523693,508512,230247,1262452
2023-05-02 03:56,1262477,523718,508512,230247,1262477
2023-05-02 03:57,1262504,523745,508512,230247,1262504
2023-05-02 03:58,1262529,523770,508512,230247,1262529
2023-05-02 03:59,1262557,523796,508514,230247,1262557
2023-05-02 04:00,1262576,523815,508514,230247,1262576
2023-05-02 04:01,1262593,523829,508517,230247,1262593
2023-05-02 04:02,1262608,523844,508517,230247,1262608
2023-05-02 04:03,1262625,523861,508517,230247,1262625
2023-05-02 04:04,1262641,523877,508517,230247,1262641
2023-05-02 04:05,1262657,523891,508517,230249,1262657
2023-05-02 04:06,1262674,523907,508517,230250,1262674
2023-05-02 04:07,1262689,523922,508517,230250,1262689
2023-05-02 04:08,1262706,523939,508517,230250,1262706
2023-05-02 04:09,1262722,523955,508517,230250,1262722
2023-05-02 04:10,1262738,523970,508517,230251,1262738
2023-05-02 04:11,1262755,523986,508518,230251,1262755
2023-05-02 04:12,1262771,524002,508518,230251,1262771
2023-05-02 04:13,1262788,524017,508520,230251,1262788
2023-05-02 04:14,1262804,524033,508520,230251,1262804
2023-05-02 04:15,1262820,524049,508520,230251,1262820
2023-05-02 04:16,1262836,524065,508520,230251,1262836
2023-05-02 04:17,1262852,524079,508521,230252,1262852
2023-05-02 04:19,1262869,524095,508521,230253,1262869
2023-05-02 04:20,1262885,524111,508521,230253,1262885
2023-05-02 04:21,1262901,524127,508521,230253,1262901
2023-05-02 04:22,1262917,524143,508521,230253,1262917
2023-05-02 04:23,1262933,524159,508521,230253,1262933
2023-05-02 04:24,1262949,524175,508521,230253,1262949
2023-05-02 04:25,1262966,524192,508521,230253,1262966
2023-05-02 04:26,1262982,524208,508521,230253,1262982
2023-05-02 04:27,1262999,524224,508521,230254,1262999
2023-05-02 04:28,1263014,524238,508522,230254,1263014
2023-05-02 04:29,1263030,524254,508522,230254,1263030
2023-05-02 04:30,1263047,524271,508522,230254,1263047
2023-05-02 04:31,1263063,524287,508522,230254,1263063
2023-05-02 04:32,1263079,524303,508522,230254,1263079
2023-05-02 04:33,1263095,524319,508522,230254,1263095
2023-05-02 04:34,1263112,524336,508522,230254,1263112
2023-05-02 04:35,1263127,524351,508522,230254,1263127
2023-05-02 04:36,1263144,524367,508523,230254,1263144
2023-05-02 04:37,1263160,524383,508523,230254,1263160
2023-05-02 04:38,1263176,524399,508523,230254,1263176
2023-05-02 04:39,1263192,524415,508523,230254,1263192
2023-05-02 04:40,1263208,524430,508523,230255,1263208
2023-05-02 04:41,1263225,524447,508523,230255,1263225
2023-05-02 04:42,1263240,524461,508524,230255,1263240
2023-05-02 04:43,1263257,524478,508524,230255,1263257
2023-05-02 04:44,1263274,524494,508525,230255,1263274
2023-05-02 04:45,1263289,524509,508525,230255,1263289
2023-05-02 04:46,1263306,524526,508525,230255,1263306
2023-05-02 04:47,1263322,524541,508525,230256,1263322
2023-05-02 04:48,1263338,524557,508525,230256,1263338
2023-05-02 04:49,1263354,524570,508525,230259,1263354
2023-05-02 04:50,1263371,524587,508525,230259,1263371
2023-05-02 04:51,1263387,524601,508525,230261,1263387
2023-05-02 04:52,1263403,524616,508525,230262,1263403
2023-05-02 04:53,1263418,524630,508525,230263,1263418
2023-05-02 04:54,1263434,524643,508527,230264,1263434
2023-05-02 04:55,1263452,524661,508527,230264,1263452
2023-05-02 04:56,1263468,524674,508529,230265,1263468
2023-05-02 04:57,1263485,524691,508529,230265,1263485
2023-05-02 04:58,1263500,524704,508531,230265,1263500
2023-05-02 04:59,1263516,524720,508531,230265,1263516
2023-05-02 05:00,1263529,524733,508531,230265,1263529
2023-05-02 05:01,1263541,524745,508531,230265,1263541
2023-05-02 05:02,1263553,524756,508532,230265,1263553
2023-05-02 05:03,1263564,524767,508532,230265,1263564
2023-05-02 05:04,1263576,524779,508532,230265,1263576
2023-05-02 05:06,1263587,524789,508532,230266,1263587
2023-05-02 05:07,1263599,524799,508532,230268,1263599
2023-05-02 05:08,1263611,524811,508532,230268,1263611
2023-05-02 05:09,1263623,524822,508533,230268,1263623
2023-05-02 05:10,1263634,524833,508533,230268,1263634
2023-05-02 05:11,1263646,524845,508533,230268,1263646
2023-05-02 05:12,1263657,524856,508533,230268,1263657
2023-05-02 05:13,1263670,524868,508534,230268,1263670
2023-05-02 05:14,1263682,524879,508534,230269,1263682
2023-05-02 05:15,1263694,524891,508534,230269,1263694
2023-05-02 05:16,1263706,524903,508534,230269,1263706
2023-05-02 05:17,1263717,524914,508534,230269,1263717
2023-05-02 05:18,1263730,524927,508534,230269,1263730
2023-05-02 05:19,1263741,524937,508534,230270,1263741
2023-05-02 05:20,1263753,524949,508534,230270,1263753
2023-05-02 05:21,1263765,524961,508534,230270,1263765
2023-05-02 05:22,1263776,524972,508534,230270,1263776
2023-05-02 05:23,1263788,524984,508534,230270,1263788
2023-05-02 05:24,1263800,524996,508534,230270,1263800
2023-05-02 05:25,1263811,525007,508534,230270,1263811
2023-05-02 05:26,1263823,525019,508534,230270,1263823
2023-05-02 05:27,1263835,525031,508534,230270,1263835
2023-05-02 05:28,1263846,525042,508534,230270,1263846
2023-05-02 05:29,1263858,525053,508535,230270,1263858
2023-05-02 05:30,1263869,525064,508535,230270,1263869
2023-05-02 05:31,1263881,525076,508535,230270,1263881
2023-05-02 05:32,1263892,525087,508535,230270,1263892
2023-05-02 05:33,1263905,525100,508535,230270,1263905
2023-05-02 05:34,1263916,525111,508535,230270,1263916
2023-05-02 05:35,1263927,525121,508536,230270,1263927
2023-05-02 05:36,1263939,525133,508536,230270,1263939
2023-05-02 05:37,1263951,525145,508536,230270,1263951
2023-05-02 05:38,1263963,525157,508536,230270,1263963
2023-05-02 05:39,1263975,525168,508536,230271,1263975
2023-05-02 05:40,1263986,525179,508536,230271,1263986
2023-05-02 05:41,1263998,525191,508536,230271,1263998
2023-05-02 05:42,1264009,525202,508536,230271,1264009
2023-05-02 05:43,1264021,525214,508536,230271,1264021
2023-05-02 05:44,1264032,525225,508536,230271,1264032
2023-05-02 05:45,1264045,525238,508536,230271,1264045
2023-05-02 05:46,1264056,525249,508536,230271,1264056
2023-05-02 05:47,1264068,525261,508536,230271,1264068
2023-05-02 05:48,1264080,525273,508536,230271,1264080
2023-05-02 05:49,1264091,525283,508537,230271,1264091
2023-05-02 05:50,1264103,525294,508537,230272,1264103
2023-05-02 05:51,1264115,525306,508537,230272,1264115
2023-05-02 05:53,1264126,525317,508537,230272,1264126
2023-05-02 05:54,1264138,525327,508538,230273,1264138
2023-05-02 05:55,1264149,525337,508539,230273,1264149
2023-05-02 05:56,1264161,525349,508539,230273,1264161
2023-05-02 05:57,1264172,525360,508539,230273,1264172
2023-05-02 05:58,1264185,525373,508539,230273,1264185
2023-05-02 05:59,1264196,525383,508539,230274,1264196
2023-05-02 06:00,1264208,525395,508539,230274,1264208
2023-05-02 06:01,1264221,525408,508539,230274,1264221
2023-05-02 06:02,1264233,525420,508539,230274,1264233
2023-05-02 06:03,1264246,525433,508539,230274,1264246
2023-05-02 06:04,1264258,525444,508539,230275,1264258
2023-05-02 06:05,1264271,525457,508539,230275,1264271
2023-05-02 06:06,1264284,525469,508539,230276,1264284
2023-05-02 06:07,1264296,525480,508540,230276,1264296
2023-05-02 06:08,1264309,525493,508540,230276,1264309
2023-05-02 06:09,1264321,525505,508540,230276,1264321
2023-05-02 06:10,1264334,525518,508540,230276,1264334
2023-05-02 06:11,1264347,525530,508541,230276,1264347
2023-05-02 06:12,1264359,525542,508541,230276,1264359
2023-05-02 06:13,1264372,525554,508542,230276,1264372
2023-05-02 06:14,1264384,525565,508542,230277,1264384
2023-05-02 06:15,1264397,525578,508542,230277,1264397
2023-05-02 06:16,1264410,525591,508542,230277,1264410
2023-05-02 06:17,1264423,525604,508541,230278,1264423
2023-05-02 06:18,1264435,525616,508541,230278,1264435
2023-05-02 06:19,1264448,525629,508541,230278,1264448
2023-05-02 06:20,1264461,525642,508541,230278,1264461
2023-05-02 06:21,1264473,525652,508541,230280,1264473
2023-05-02 06:22,1264486,525665,508541,230280,1264486
2023-05-02 06:23,1264499,525677,508542,230280,1264499
2023-05-02 06:24,1264511,525689,508542,230280,1264511
2023-05-02 06:25,1264524,525703,508541,230280,1264524
2023-05-02 06:26,1264537,525715,508541,230281,1264537
2023-05-02 06:27,1264549,525726,508541,230282,1264549
2023-05-02 06:28,1264562,525739,508541,230282,1264562
2023-05-02 06:29,1264574,525751,508541,230282,1264574
2023-05-02 06:30,1264587,525764,508541,230282,1264587
2023-05-02 06:31,1264599,525774,508543,230282,1264599
2023-05-02 06:32,1264612,525786,508543,230283,1264612
2023-05-02 06:33,1264624,525798,508543,230283,1264624
2023-05-02 06:34,1264637,525811,508543,230283,1264637
2023-05-02 06:35,1264650,525824,508543,230283,1264650
2023-05-02 06:36,1264662,525835,508543,230284,1264662
2023-05-02 06:37,1264675,525848,508543,230284,1264675
2023-05-02 06:38,1264688,525861,508543,230284,1264688
2023-05-02 06:40,1264701,525872,508544,230285,1264701
2023-05-02 06:41,1264714,525884,508544,230286,1264714
2023-05-02 06:42,1264726,525892,508546,230288,1264726
2023-05-02 06:43,1264739,525903,508546,230290,1264739
2023-05-02 06:44,1264752,525915,508547,230290,1264752
2023-05-02 06:45,1264764,525927,508547,230290,1264764
2023-05-02 06:46,1264777,525937,508549,230291,1264777
2023-05-02 06:47,1264789,525949,508549,230291,1264789
2023-05-02 06:48,1264802,525960,508550,230292,1264802
2023-05-02 06:49,1264815,525973,508550,230292,1264815
2023-05-02 06:50,1264828,525984,508551,230293,1264828
2023-05-02 06:51,1264841,525996,508551,230294,1264841
2023-05-02 06:52,1264854,526009,508551,230294,1264854
2023-05-02 06:53,1264866,526021,508551,230294,1264866
2023-05-02 06:54,1264879,526032,508552,230295,1264879
2023-05-02 06:55,1264892,526045,508552,230295,1264892
2023-05-02 06:56,1264905,526058,508552,230295,1264905
2023-05-02 06:57,1264918,526070,508551,230297,1264918
2023-05-02 06:58,1264930,526082,508551,230297,1264930
2023-05-02 06:59,1264943,526095,508551,230297,1264943
2023-05-02 07:00,1264962,526114,508551,230297,1264962
2023-05-02 07:01,1264990,526140,508553,230297,1264990
2023-05-02 07:02,1265018,526168,508553,230297,1265018
2023-05-02 07:03,1265044,526191,508555,230298,1265044
2023-05-02 07:04,1265073,526218,508555,230300,1265073
2023-05-02 07:05,1265102,526247,508555,230300,1265102
2023-05-02 07:06,1265130,526275,508555,230300,1265130
2023-05-02 07:07,1265158,526303,508555,230300,1265158
2023-05-02 07:08,1265187,526330,508555,230302,1265187
2023-05-02 07:09,1265214,526355,508557,230302,1265214
2023-05-02 07:10,1265245,526383,508558,230304,1265245
2023-05-02 07:11,1265271,526407,508558,230306,1265271
2023-05-02 07:12,1265299,526433,508559,230307,1265299
2023-05-02 07:13,1265329,526462,508559,230308,1265329
2023-05-02 07:14,1265355,526487,508559,230309,1265355
2023-05-02 07:15,1265385,526516,508559,230310,1265385
2023-05-02 07:16,1265413,526544,508559,230310,1265413
2023-05-02 07:17,1265441,526572,508559,230310,1265441
2023-05-02 07:18,1265470,526600,508560,230310,1265470
2023-05-02 07:19,1265498,526627,508560,230311,1265498
2023-05-02 07:20,1265527,526655,508560,230312,1265527
2023-05-02 07:21,1265554,526682,508560,230312,1265554
2023-05-02 07:22,1265581,526707,508562,230312,1265581
2023-05-02 07:23,1265610,526736,508562,230312,1265610
2023-05-02 07:24,1265638,526764,508562,230312,1265638
2023-05-02 07:25,1265666,526791,508562,230313,1265666
2023-05-02 07:27,1265695,526817,508564,230314,1265695
2023-05-02 07:28,1265722,526844,508564,230314,1265722
2023-05-02 07:29,1265750,526871,508565,230314,1265750
2023-05-02 07:30,1265779,526899,508565,230315,1265779
2023-05-02 07:31,1265808,526927,508566,230315,1265808
2023-05-02 07:32,1265835,526954,508566,230315,1265835
2023-05-02 07:33,1265865,526981,508568,230316,1265865
2023-05-02 07:34,1265892,527006,508568,230318,1265892
2023-05-02 07:35,1265921,527032,508570,230319,1265921
2023-05-02 07:36,1265949,527059,508571,230319,1265949
2023-05-02 07:37,1265976,527086,508571,230319,1265976
2023-05-02 07:38,1266006,527113,508574,230319,1266006
2023-05-02 07:39,1266034,527138,508574,230322,1266034
2023-05-02 07:40,1266061,527162,508575,230324,1266061
2023-05-02 07:41,1266091,527191,508575,230325,1266091
2023-05-02 07:42,1266117,527214,508576,230327,1266117
2023-05-02 07:43,1266147,527244,508576,230327,1266147
2023-05-02 07:44,1266175,527270,508577,230328,1266175
2023-05-02 07:45,1266204,527298,508577,230329,1266204
2023-05-02 07:46,1266231,527324,508578,230329,1266231
2023-05-02 07:47,1266260,527353,508578,230329,1266260
2023-05-02 07:48,1266287,527378,508579,230330,1266287
2023-05-02 07:49,1266315,527406,508579,230330,1266315
2023-05-02 07:50,1266344,527433,508581,230330,1266344
2023-05-02 07:51,1266373,527462,508581,230330,1266373
2023-05-02 07:52,1266401,527489,508581,230331,1266401
2023-05-02 07:53,1266430,527516,508581,230333,1266430
2023-05-02 07:54,1266460,527544,508582,230334,1266460
2023-05-02 07:55,1266486,527570,508582,230334,1266486
2023-05-02 07:56,1266514,527596,508582,230336,1266514
2023-05-02 07:57,1266544,527627,508582,230335,1266544
2023-05-02 07:58,1266572,527652,508584,230336,1266572
2023-05-02 07:59,1266601,527680,508584,230337,1266601
2023-05-02 08:00,1266621,527698,508585,230338,1266621
2023-05-02 08:01,1266638,527715,508585,230338,1266638
2023-05-02 08:02,1266654,527731,508585,230338,1266654
2023-05-02 08:03,1266671,527748,508585,230338,1266671
2023-05-02 08:04,1266688,527763,508586,230339,1266688
2023-05-02 08:05,1266704,527779,508586,230339,1266704
2023-05-02 08:06,1266721,527794,508588,230339,1266721
2023-05-02 08:07,1266737,527809,508588,230340,1266737
2023-05-02 08:08,1266755,527826,508588,230341,1266755
2023-05-02 08:09,1266771,527842,508588,230341,1266771
2023-05-02 08:10,1266787,527856,508590,230341,1266787
2023-05-02 08:11,1266804,527872,508590,230342,1266804
2023-05-02 08:12,1266820,527884,508593,230343,1266820
2023-05-02 08:14,1266837,527898,508593,230346,1266837
2023-05-02 08:15,1266854,527913,508595,230346,1266854
2023-05-02 08:16,1266871,527930,508595,230346,1266871
2023-05-02 08:17,1266887,527940,508598,230349,1266887
2023-05-02 08:18,1266904,527955,508598,230351,1266904
2023-05-02 08:19,1266921,527970,508600,230351,1266921
2023-05-02 08:20,1266938,527987,508600,230351,1266938
2023-05-02 08:21,1266954,528001,508602,230351,1266954
2023-05-02 08:22,1266970,528016,508602,230352,1266970
2023-05-02 08:23,1266988,528031,508605,230352,1266988
2023-05-02 08:24,1267004,528045,508605,230354,1267004
2023-05-02 08:25,1267020,528055,508608,230357,1267020
2023-05-02 08:26,1267037,528072,508608,230357,1267037
2023-05-02 08:27,1267053,528085,508610,230358,1267053
2023-05-02 08:28,1267069,528100,508610,230359,1267069
2023-05-02 08:29,1267086,528116,508611,230359,1267086
2023-05-02 08:30,1267103,528133,508611,230359,1267103
2023-05-02 08:31,1267119,528146,508612,230361,1267119
2023-05-02 08:32,1267137,528163,508612,230362,1267137
2023-05-02 08:33,1267153,528178,508613,230362,1267153
2023-05-02 08:34,1267170,528194,508613,230363,1267170
2023-05-02 08:35,1267187,528208,508615,230364,1267187
2023-05-02 08:36,1267204,528225,508615,230364,1267204
2023-05-02 08:37,1267221,528240,508617,230364,1267221
2023-05-02 08:38,1267237,528255,508617,230365,1267237
2023-05-02 08:39,1267254,528270,508618,230366,1267254
2023-05-02 08:40,1267271,528285,508619,230367,1267271
2023-05-02 08:41,1267288,528301,508619,230368,1267288
2023-05-02 08:42,1267305,528311,508623,230371,1267305
2023-05-02 08:43,1267321,528326,508623,230372,1267321
2023-05-02 08:44,1267337,528339,508625,230373,1267337
2023-05-02 08:45,1267354,528356,508625,230373,1267354
2023-05-02 08:46,1267371,528373,508625,230373,1267371
2023-05-02 08:47,1267387,528389,508625,230373,1267387
2023-05-02 08:48,1267405,528403,508625,230377,1267405
2023-05-02 08:49,1267421,528418,508625,230378,1267421
2023-05-02 08:50,1267438,528434,508625,230379,1267438
2023-05-02 08:51,1267454,528448,508625,230381,1267454
2023-05-02 08:52,1267471,528462,508625,230384,1267471
2023-05-02 08:53,1267488,528476,508627,230385,1267488
2023-05-02 08:54,1267504,528492,508627,230385,1267504
2023-05-02 08:55,1267521,528507,508628,230386,1267521
2023-05-02 08:56,1267538,528523,508628,230387,1267538
2023-05-02 08:57,1267554,528537,508630,230387,1267554
2023-05-02 08:58,1267571,528552,508630,230389,1267571
2023-05-02 08:59,1267589,528561,508634,230394,1267589
2023-05-02 09:00,1267627,528599,508634,230394,1267627
2023-05-02 09:02,1267665,528633,508635,230397,1267665
2023-05-02 09:03,1267706,528672,508635,230399,1267706
2023-05-02 09:04,1267744,528705,508639,230400,1267744
2023-05-02 09:05,1267784,528742,508639,230403,1267784
2023-05-02 09:06,1267824,528780,508639,230405,1267824
2023-05-02 09:07,1267864,528818,508639,230407,1267864
2023-05-02 09:08,1267905,528858,508640,230407,1267905
2023-05-02 09:09,1267944,528896,508640,230408,1267944
2023-05-02 09:10,1267984,528934,508641,230409,1267984
2023-05-02 09:11,1268024,528972,508641,230411,1268024
2023-05-02 09:12,1268065,529010,508643,230412,1268065
2023-05-02 09:13,1268105,529050,508643,230412,1268105
2023-05-02 09:14,1268145,529089,508643,230413,1268145
2023-05-02 09:15,1268183,529127,508643,230413,1268183
2023-05-02 09:16,1268224,529165,508645,230414,1268224
2023-05-02 09:17,1268266,529206,508645,230415,1268266
2023-05-02 09:18,1268305,529241,508646,230418,1268305
2023-05-02 09:19,1268346,529281,508646,230419,1268346
2023-05-02 09:20,1268386,529317,508648,230421,1268386
2023-05-02 09:21,1268425,529354,508648,230423,1268425
2023-05-02 09:22,1268466,529391,508651,230424,1268466
2023-05-02 09:23,1268507,529431,508651,230425,1268507
2023-05-02 09:24,1268545,529468,508652,230425,1268545
2023-05-02 09:25,1268587,529510,508652,230425,1268587
2023-05-02 09:26,1268627,529549,508653,230425,1268627
2023-05-02 09:27,1268668,529590,508653,230425,1268668
2023-05-02 09:28,1268707,529628,508654,230425,1268707
2023-05-02 09:29,1268746,529665,508655,230426,1268746
2023-05-02 09:30,1268787,529706,508655,230426,1268787
2023-05-02 09:31,1268826,529740,508657,230429,1268826
2023-05-02 09:32,1268865,529776,508657,230432,1268865
2023-05-02 09:33,1268905,529814,508658,230433,1268905
2023-05-02 09:34,1268948,529856,508658,230434,1268948
2023-05-02 09:35,1268986,529890,508661,230435,1268986
2023-05-02 09:36,1269029,529933,508661,230435,1269029
2023-05-02 09:37,1269068,529972,508661,230435,1269068
2023-05-02 09:38,1269107,530011,508661,230435,1269107
2023-05-02 09:39,1269147,530049,508661,230437,1269147
2023-05-02 09:40,1269186,530085,508661,230440,1269186
2023-05-02 09:41,1269228,530125,508661,230442,1269228
2023-05-02 09:42,1269266,530161,508661,230444,1269266
2023-05-02 09:43,1269306,530199,508661,230446,1269306
2023-05-02 09:44,1269348,530240,508661,230447,1269348
2023-05-02 09:45,1269386,530262,508674,230450,1269386
2023-05-02 09:46,1269426,530302,508674,230450,1269426
2023-05-02 09:47,1269467,530340,508675,230452,1269467
2023-05-02 09:48,1269506,530379,508675,230452,1269506
2023-05-02 09:50,1269548,530418,508675,230455,1269548
2023-05-02 09:51,1269587,530455,508675,230457,1269587
2023-05-02 09:52,1269629,530494,508676,230459,1269629
2023-05-02 09:53,1269669,530532,508676,230461,1269669
2023-05-02 09:54,1269707,530568,508678,230461,1269707
2023-05-02 09:55,1269747,530606,508678,230463,1269747
2023-05-02 09:56,1269789,530640,508682,230467,1269789
2023-05-02 09:57,1269829,530679,508682,230468,1269829
2023-05-02 09:58,1269868,530713,508686,230469,1269868
2023-05-02 09:59,1269908,530752,508686,230470,1269908
2023-05-02 10:00,1269944,530786,508687,230471,1269944
2023-05-02 10:01,1269962,530804,508687,230471,1269962
2023-05-02 10:02,1269980,530818,508689,230473,1269980
2023-05-02 10:03,1269997,530835,508689,230473,1269997
2023-05-02 10:04,1270013,530849,508690,230474,1270013
2023-05-02 10:05,1270033,530866,508692,230475,1270033
2023-05-02 10:06,1270051,530882,508692,230477,1270051
2023-05-02 10:07,1270068,530894,508694,230480,1270068
2023-05-02 10:08,1270085,530910,508694,230481,1270085
2023-05-02 10:09,1270103,530926,508696,230481,1270103
2023-05-02 10:10,1270120,530939,508697,230484,1270120
2023-05-02 10:11,1270138,530956,508697,230485,1270138
2023-05-02 10:12,1270154,530968,508700,230486,1270154
2023-05-02 10:13,1270172,530985,508700,230487,1270172
2023-05-02 10:14,1270189,531001,508701,230487,1270189
2023-05-02 10:15,1270207,531018,508701,230488,1270207
2023-05-02 10:16,1270225,531032,508705,230488,1270225
2023-05-02 10:17,1270241,531047,508705,230489,1270241
2023-05-02 10:18,1270260,531059,508710,230491,1270260
2023-05-02 10:19,1270277,531073,508710,230494,1270277
2023-05-02 10:20,1270295,531086,508714,230495,1270295
2023-05-02 10:21,1270312,531103,508714,230495,1270312
2023-05-02 10:22,1270330,531116,508719,230495,1270330
2023-05-02 10:23,1270348,531133,508719,230496,1270348
2023-05-02 10:24,1270365,531142,508727,230496,1270365
2023-05-02 10:25,1270382,531159,508727,230496,1270382
2023-05-02 10:26,1270399,531172,508729,230498,1270399
2023-05-02 10:27,1270418,531190,508729,230499,1270418
2023-05-02 10:28,1270435,531200,508735,230500,1270435
2023-05-02 10:29,1270452,531215,508735,230502,1270452
2023-05-02 10:30,1270470,531231,508735,230504,1270470
2023-05-02 10:31,1270486,531246,508735,230505,1270486
2023-05-02 10:32,1270505,531263,508736,230506,1270505
2023-05-02 10:33,1270521,531278,508736,230507,1270521
2023-05-02 10:34,1270540,531291,508739,230510,1270540
2023-05-02 10:35,1270558,531306,508739,230513,1270558
2023-05-02 10:37,1270575,531321,508741,230513,1270575
2023-05-02 10:38,1270592,531338,508741,230513,1270592
2023-05-02 10:39,1270610,531354,508742,230514,1270610
2023-05-02 10:40,1270628,531370,508742,230516,1270628
2023-05-02 10:41,1270645,531384,508743,230518,1270645
2023-05-02 10:42,1270663,531401,508743,230519,1270663
2023-05-02 10:43,1270680,531412,508747,230521,1270680
2023-05-02 10:44,1270698,531426,508747,230525,1270698
2023-05-02 10:45,1270716,531441,508749,230526,1270716
2023-05-02 10:46,1270733,531456,508749,230528,1270733
2023-05-02 10:47,1270751,531470,508751,230530,1270751
2023-05-02 10:48,1270769,531484,508751,230534,1270769
2023-05-02 10:49,1270786,531494,508754,230538,1270786
2023-05-02 10:50,1270803,531510,508754,230539,1270803
2023-05-02 10:51,1270821,531517,508762,230542,1270821
2023-05-02 10:52,1270839,531534,508762,230543,1270839
2023-05-02 10:53,1270856,531545,508764,230547,1270856
2023-05-02 10:54,1270873,531558,508767,230548,1270873
2023-05-02 10:55,1270892,531573,508767,230552,1270892
2023-05-02 10:56,1270909,531584,508769,230556,1270909
2023-05-02 10:57,1270927,531596,508774,230557,1270927
2023-05-02 10:58,1270944,531611,508774,230559,1270944
2023-05-02 10:59,1270961,531622,508778,230561,1270961
2023-05-02 11:00,1270978,531635,508778,230565,1270978
2023-05-02 11:01,1270993,531645,508781,230567,1270993
2023-05-02 11:02,1271008,531660,508781,230567,1271008
2023-05-02 11:03,1271023,531673,508782,230568,1271023
2023-05-02 11:04,1271038,531686,508782,230570,1271038
2023-05-02 11:05,1271054,531697,508785,230572,1271054
2023-05-02 11:06,1271068,531710,508785,230573,1271068
2023-05-02 11:07,1271084,531724,508787,230573,1271084
2023-05-02 11:08,1271098,531736,508787,230575,1271098
2023-05-02 11:09,1271114,531747,508791,230576,1271114
2023-05-02 11:10,1271128,531760,508791,230577,1271128
2023-05-02 11:11,1271144,531771,508794,230579,1271144
2023-05-02 11:12,1271158,531783,508794,230581,1271158
2023-05-02 11:13,1271174,531796,508796,230582,1271174
2023-05-02 11:14,1271188,531808,508796,230584,1271188
2023-05-02 11:15,1271203,531818,508798,230587,1271203
2023-05-02 11:16,1271218,531832,508798,230588,1271218
2023-05-02 11:17,1271232,531841,508803,230588,1271232
2023-05-02 11:18,1271248,531854,508803,230591,1271248
2023-05-02 11:19,1271263,531866,508805,230592,1271263
2023-05-02 11:20,1271278,531879,508805,230594,1271278
2023-05-02 11:21,1271293,531890,508806,230597,1271293
2023-05-02 11:22,1271307,531904,508806,230597,1271307
2023-05-02 11:23,1271322,531915,508810,230597,1271322
2023-05-02 11:25,1271337,531927,508810,230600,1271337
2023-05-02 11:26,1271352,531938,508813,230601,1271352
2023-05-02 11:27,1271367,531952,508813,230602,1271367
2023-05-02 11:28,1271383,531967,508813,230603,1271383
2023-05-02 11:29,1271397,531979,508813,230605,1271397
2023-05-02 11:30,1271413,531990,508815,230608,1271413
2023-05-02 11:31,1271427,532005,508815,230607,1271427
2023-05-02 11:32,1271442,532014,508816,230612,1271442
2023-05-02 11:33,1271459,532027,508816,230616,1271459
2023-05-02 11:34,1271473,532035,508821,230617,1271473
2023-05-02 11:35,1271488,532045,508821,230622,1271488
2023-05-02 11:36,1271504,532058,508823,230623,1271504
2023-05-02 11:37,1271519,532072,508823,230624,1271519
2023-05-02 11:38,1271534,532083,508826,230625,1271534
2023-05-02 11:39,1271549,532097,508826,230626,1271549
2023-05-02 11:40,1271565,532113,508826,230626,1271565
2023-05-02 11:41,1271581,532129,508826,230626,1271581
2023-05-02 11:42,1271595,532139,508828,230628,1271595
2023-05-02 11:43,1271610,532146,508828,230636,1271610
2023-05-02 11:44,1271626,532157,508831,230638,1271626
2023-05-02 11:45,1271643,532173,508831,230639,1271643
2023-05-02 11:46,1271657,532185,508833,230639,1271657
2023-05-02 11:47,1271674,532203,508833,230638,1271674
2023-05-02 11:48,1271689,532212,508835,230642,1271689
2023-05-02 11:49,1271704,532226,508835,230643,1271704
2023-05-02 11:50,1271718,532238,508835,230645,1271718
2023-05-02 11:51,1271733,532253,508835,230645,1271733
2023-05-02 11:52,1271748,532263,508840,230645,1271748
2023-05-02 11:53,1271763,532275,508840,230648,1271763
2023-05-02 11:54,1271778,532289,508840,230649,1271778
2023-05-02 11:55,1271794,532302,508840,230652,1271794
2023-05-02 11:56,1271809,532313,508841,230655,1271809
2023-05-02 11:57,1271825,532328,508841,230656,1271825
2023-05-02 11:58,1271840,532340,508841,230659,1271840
2023-05-02 11:59,1271856,532354,508841,230661,1271856
2023-05-02 12:00,1271876,532367,508846,230663,1271876
2023-05-02 12:01,1271899,532389,508846,230664,1271899
2023-05-02 12:02,1271923,532412,508847,230664,1271923
2023-05-02 12:03,1271943,532431,508847,230665,1271943
2023-05-02 12:04,1271966,532450,508849,230667,1271966
2023-05-02 12:05,1271988,532472,508849,230667,1271988
2023-05-02 12:06,1272009,532489,508852,230668,1272009
2023-05-02 12:07,1272031,532510,508852,230669,1272031
2023-05-02 12:08,1272053,532531,508852,230670,1272053
2023-05-02 12:09,1272076,532550,508852,230674,1272076
2023-05-02 12:10,1272098,532569,508852,230677,1272098
2023-05-02 12:11,1272120,532591,508852,230677,1272120
2023-05-02 12:13,1272142,532610,508852,230680,1272142
2023-05-02 12:14,1272164,532627,508852,230685,1272164
2023-05-02 12:15,1272187,532647,508855,230685,1272187
2023-05-02 12:16,1272209,532665,508855,230689,1272209
2023-05-02 12:17,1272229,532681,508859,230689,1272229
2023-05-02 12:18,1272251,532703,508859,230689,1272251
2023-05-02 12:19,1272274,532722,508859,230693,1272274
2023-05-02 12:20,1272296,532740,508860,230696,1272296
2023-05-02 12:21,1272319,532759,508860,230700,1272319
2023-05-02 12:22,1272341,532775,508863,230703,1272341
2023-05-02 12:23,1272362,532794,508863,230705,1272362
2023-05-02 12:24,1272384,532810,508867,230707,1272384
2023-05-02 12:25,1272406,532829,508867,230710,1272406
2023-05-02 12:26,1272428,532849,508868,230711,1272428
2023-05-02 12:27,1272451,532872,508868,230711,1272451
2023-05-02 12:28,1272472,532887,508872,230713,1272472
2023-05-02 12:29,1272494,532906,508873,230715,1272494
2023-05-02 12:30,1272516,532928,508873,230715,1272516
2023-05-02 12:31,1272539,532942,508877,230720,1272539
2023-05-02 12:32,1272561,532964,508877,230720,1272561
2023-05-02 12:33,1272584,532983,508880,230721,1272584
2023-05-02 12:34,1272605,533002,508880,230723,1272605
2023-05-02 12:35,1272628,533018,508887,230723,1272628
2023-05-02 12:36,1272649,533036,508887,230726,1272649
2023-05-02 12:37,1272672,533056,508889,230727,1272672
2023-05-02 12:38,1272693,533075,508889,230729,1272693
2023-05-02 12:39,1272717,533096,508890,230731,1272717
2023-05-02 12:40,1272738,533115,508890,230733,1272738
2023-05-02 12:41,1272760,533132,508893,230735,1272760
2023-05-02 12:42,1272782,533152,508893,230737,1272782
2023-05-02 12:43,1272807,533172,508896,230739,1272807
2023-05-02 12:44,1272828,533193,508896,230739,1272828
2023-05-02 12:45,1272851,533214,508897,230740,1272851
2023-05-02 12:46,1272873,533235,508897,230741,1272873
2023-05-02 12:47,1272895,533253,508898,230744,1272895
2023-05-02 12:48,1272917,533274,508898,230745,1272917
2023-05-02 12:49,1272939,533290,508903,230746,1272939
2023-05-02 12:50,1272961,533310,508903,230748,1272961
2023-05-02 12:51,1272982,533328,508906,230748,1272982
2023-05-02 12:52,1273005,533351,508906,230748,1273005
2023-05-02 12:53,1273027,533368,508911,230748,1273027
2023-05-02 12:54,1273049,533390,508911,230748,1273049
2023-05-02 12:55,1273070,533405,508914,230751,1273070
2023-05-02 12:56,1273093,533427,508914,230752,1273093
2023-05-02 12:57,1273115,533444,508917,230754,1273115
2023-05-02 12:58,1273136,533465,508917,230754,1273136
2023-05-02 12:59,1273160,533483,508921,230756,1273160
2023-05-02 13:01,1273176,533496,508921,230759,1273176
2023-05-02 13:02,1273194,533512,508923,230759,1273194
2023-05-02 13:03,1273212,533528,508923,230761,1273212
2023-05-02 13:04,1273228,533538,508926,230764,1273228
2023-05-02 13:05,1273247,533557,508926,230764,1273247
2023-05-02 13:06,1273264,533575,508925,230764,1273264
2023-05-02 13:07,1273281,533591,508925,230765,1273281
2023-05-02 13:08,1273300,533605,508928,230767,1273300
2023-05-02 13:09,1273317,533620,508928,230769,1273317
2023-05-02 13:10,1273335,533635,508929,230771,1273335
2023-05-02 13:11,1273351,533648,508929,230774,1273351
2023-05-02 13:12,1273369,533662,508933,230774,1273369
2023-05-02 13:13,1273387,533679,508933,230775,1273387
2023-05-02 13:14,1273404,533689,508936,230779,1273404
2023-05-02 13:15,1273421,533706,508936,230779,1273421
2023-05-02 13:16,1273438,533722,508937,230779,1273438
2023-05-02 13:17,1273455,533738,508937,230780,1273455
2023-05-02 13:18,1273473,533756,508937,230780,1273473
2023-05-02 13:19,1273490,533770,508937,230783,1273490
2023-05-02 13:20,1273508,533785,508939,230784,1273508
2023-05-02 13:21,1273526,533801,508939,230786,1273526
2023-05-02 13:22,1273543,533812,508941,230790,1273543
2023-05-02 13:23,1273561,533828,508941,230792,1273561
2023-05-02 13:24,1273579,533839,508943,230797,1273579
2023-05-02 13:25,1273596,533855,508943,230798,1273596
2023-05-02 13:26,1273613,533869,508944,230800,1273613
2023-05-02 13:27,1273631,533887,508945,230799,1273631
2023-05-02 13:28,1273648,533902,508945,230801,1273648
2023-05-02 13:29,1273667,533918,508947,230802,1273667
2023-05-02 13:30,1273683,533929,508947,230807,1273683
2023-05-02 13:31,1273701,533946,508947,230808,1273701
2023-05-02 13:32,1273718,533962,508947,230809,1273718
2023-05-02 13:33,1273736,533973,508951,230812,1273736
2023-05-02 13:34,1273753,533987,508951,230815,1273753
2023-05-02 13:35,1273770,534001,508953,230816,1273770
2023-05-02 13:36,1273788,534018,508953,230817,1273788
2023-05-02 13:37,1273805,534028,508959,230818,1273805
2023-05-02 13:38,1273823,534043,508959,230821,1273823
2023-05-02 13:39,1273840,534052,508965,230823,1273840
2023-05-02 13:40,1273857,534069,508965,230823,1273857
2023-05-02 13:41,1273875,534087,508965,230823,1273875
2023-05-02 13:42,1273893,534103,508965,230825,1273893
2023-05-02 13:43,1273910,534118,508966,230826,1273910
2023-05-02 13:44,1273928,534133,508966,230829,1273928
2023-05-02 13:45,1273945,534145,508969,230831,1273945
2023-05-02 13:46,1273963,534163,508969,230831,1273963
2023-05-02 13:47,1273981,534176,508973,230832,1273981
2023-05-02 13:49,1273999,534193,508973,230833,1273999
2023-05-02 13:50,1274017,534209,508975,230833,1274017
2023-05-02 13:51,1274034,534222,508977,230835,1274034
2023-05-02 13:52,1274051,534239,508977,230835,1274051
2023-05-02 13:53,1274069,534251,508979,230839,1274069
2023-05-02 13:54,1274086,534266,508979,230841,1274086
2023-05-02 13:55,1274104,534281,508980,230843,1274104
2023-05-02 13:56,1274121,534296,508980,230845,1274121
2023-05-02 13:57,1274138,534309,508982,230847,1274138
2023-05-02 13:58,1274156,534325,508982,230849,1274156
2023-05-02 13:59,1274173,534344,508981,230848,1274173
2023-05-02 14:00,1274191,534362,508981,230848,1274191
2023-05-02 14:01,1274217,534382,508985,230850,1274217
2023-05-02 14:02,1274243,534406,508985,230852,1274243
2023-05-02 14:03,1274267,534424,508989,230854,1274267
2023-05-02 14:04,1274293,534448,508989,230856,1274293
2023-05-02 14:05,1274318,534467,508991,230860,1274318
2023-05-02 14:06,1274343,534490,508991,230862,1274343
2023-05-02 14:07,1274369,534513,508993,230863,1274369
2023-05-02 14:08,1274393,534536,508993,230864,1274393
2023-05-02 14:09,1274420,534561,508995,230864,1274420
2023-05-02 14:10,1274445,534583,508995,230867,1274445
2023-05-02 14:11,1274471,534608,508996,230867,1274471
2023-05-02 14:12,1274495,534632,508996,230867,1274495
2023-05-02 14:13,1274522,534651,509002,230869,1274522
2023-05-02 14:14,1274546,534675,509002,230869,1274546
2023-05-02 14:15,1274572,534698,509004,230870,1274572
2023-05-02 14:16,1274596,534719,509004,230873,1274596
2023-05-02 14:17,1274622,534741,509006,230875,1274622
2023-05-02 14:18,1274649,534767,509006,230876,1274649
2023-05-02 14:19,1274674,534786,509009,230879,1274674
2023-05-02 14:20,1274700,534808,509009,230883,1274700
2023-05-02 14:21,1274725,534830,509010,230885,1274725
2023-05-02 14:22,1274749,534851,509012,230886,1274749
2023-05-02 14:23,1274774,534875,509012,230887,1274774
2023-05-02 14:24,1274800,534899,509013,230888,1274800
2023-05-02 14:25,1274826,534924,509014,230888,1274826
2023-05-02 14:26,1274852,534950,509014,230888,1274852
2023-05-02 14:27,1274877,534972,509017,230888,1274877
2023-05-02 14:28,1274903,534996,509017,230890,1274903
2023-05-02 14:29,1274928,535019,509019,230890,1274928
2023-05-02 14:30,1274954,535043,509019,230892,1274954
2023-05-02 14:31,1274979,535061,509022,230896,1274979
2023-05-02 14:32,1275004,535086,509022,230896,1275004
2023-05-02 14:33,1275031,535108,509026,230897,1275031
2023-05-02 14:34,1275055,535131,509026,230898,1275055
2023-05-02 14:35,1275079,535153,509026,230900,1275079
2023-05-02 14:37,1275107,535179,509026,230902,1275107
2023-05-02 14:38,1275131,535201,509027,230903,1275131
2023-05-02 14:39,1275157,535227,509027,230903,1275157
2023-05-02 14:40,1275184,535249,509029,230906,1275184
2023-05-02 14:41,1275208,535272,509029,230907,1275208
2023-05-02 14:42,1275234,535294,509030,230910,1275234
2023-05-02 14:43,1275258,535317,509030,230911,1275258
2023-05-02 14:44,1275283,535336,509036,230911,1275283
2023-05-02 14:45,1275310,535360,509036,230914,1275310
2023-05-02 14:46,1275336,535384,509037,230915,1275336
2023-05-02 14:47,1275359,535405,509037,230917,1275359
2023-05-02 14:48,1275385,535425,509040,230920,1275385
2023-05-02 14:49,1275411,535450,509040,230921,1275411
2023-05-02 14:50,1275437,535474,509042,230921,1275437
2023-05-02 14:51,1275460,535497,509042,230921,1275460
2023-05-02 14:52,1275486,535519,509043,230924,1275486
2023-05-02 14:53,1275511,535544,509043,230924,1275511
2023-05-02 14:54,1275537,535567,509046,230924,1275537
2023-05-02 14:55,1275561,535589,509046,230926,1275561
2023-05-02 14:56,1275589,535616,509047,230926,1275589
2023-05-02 14:57,1275615,535639,509049,230927,1275615
2023-05-02 14:58,1275639,535661,509049,230929,1275639
2023-05-02 14:59,1275666,535682,509052,230932,1275666
2023-05-02 15:00,1275696,535711,509052,230933,1275696
2023-05-02 15:01,1275738,535750,509054,230934,1275738
2023-05-02 15:02,1275776,535787,509054,230935,1275776
2023-05-02 15:03,1275817,535821,509060,230936,1275817
2023-05-02 15:04,1275855,535857,509060,230938,1275855
2023-05-02 15:05,1275894,535896,509060,230938,1275894
2023-05-02 15:06,1275934,535933,509060,230941,1275934
2023-05-02 15:07,1275976,535972,509063,230941,1275976
2023-05-02 15:08,1276014,536009,509063,230942,1276014
2023-05-02 15:09,1276055,536046,509066,230943,1276055
2023-05-02 15:10,1276093,536082,509066,230945,1276093
2023-05-02 15:11,1276133,536116,509070,230947,1276133
2023-05-02 15:12,1276176,536155,509070,230951,1276176
2023-05-02 15:13,1276215,536188,509074,230953,1276215
2023-05-02 15:14,1276254,536223,509074,230957,1276254
2023-05-02 15:15,1276295,536260,509075,230960,1276295
2023-05-02 15:16,1276334,536298,509075,230961,1276334
2023-05-02 15:17,1276373,536333,509077,230963,1276373
2023-05-02 15:18,1276413,536370,509077,230966,1276413
2023-05-02 15:19,1276454,536407,509079,230968,1276454
2023-05-02 15:20,1276493,536444,509079,230970,1276493
2023-05-02 15:21,1276533,536478,509082,230973,1276533
2023-05-02 15:22,1276573,536516,509083,230974,1276573
2023-05-02 15:23,1276612,536557,509083,230972,1276612
2023-05-02 15:25,1276653,536595,509086,230972,1276653
2023-05-02 15:26,1276691,536632,509086,230973,1276691
2023-05-02 15:27,1276732,536671,509086,230975,1276732
2023-05-02 15:28,1276771,536707,509088,230976,1276771
2023-05-02 15:29,1276811,536746,509088,230977,1276811
2023-05-02 15:30,1276852,536785,509089,230978,1276852
2023-05-02 15:31,1276892,536823,509091,230978,1276892
2023-05-02 15:32,1276931,536859,509091,230981,1276931
2023-05-02 15:33,1276971,536893,509096,230982,1276971
2023-05-02 15:34,1277011,536932,509096,230983,1277011
2023-05-02 15:35,1277050,536967,509100,230983,1277050
2023-05-02 15:36,1277090,537005,509100,230985,1277090
2023-05-02 15:37,1277130,537039,509105,230986,1277130
2023-05-02 15:38,1277170,537079,509105,230986,1277170
2023-05-02 15:39,1277209,537115,509108,230986,1277209
2023-05-02 15:40,1277252,537156,509108,230988,1277252
2023-05-02 15:41,1277292,537194,509110,230988,1277292
2023-05-02 15:42,1277331,537231,509110,230990,1277331
2023-05-02 15:43,1277369,537263,509115,230991,1277369
2023-05-02 15:44,1277410,537301,509115,230994,1277410
2023-05-02 15:45,1277448,537336,509114,230998,1277448
2023-05-02 15:46,1277489,537373,509115,231001,1277489
2023-05-02 15:47,1277528,537412,509115,231001,1277528
2023-05-02 15:48,1277569,537448,509117,231004,1277569
2023-05-02 15:49,1277607,537486,509117,231004,1277607
2023-05-02 15:50,1277646,537522,509120,231004,1277646
2023-05-02 15:51,1277685,537559,509120,231006,1277685
2023-05-02 15:52,1277727,537597,509123,231007,1277727
2023-05-02 15:53,1277765,537633,509123,231009,1277765
2023-05-02 15:54,1277805,537667,509126,231012,1277805
2023-05-02 15:55,1277847,537708,509126,231013,1277847
2023-05-02 15:56,1277887,537748,509126,231013,1277887
2023-05-02 15:57,1277925,537779,509128,231018,1277925
2023-05-02 15:58,1277966,537818,509128,231020,1277966
2023-05-02 15:59,1278005,537850,509132,231023,1278005
2023-05-02 16:00,1278041,537885,509132,231024,1278041
2023-05-02 16:01,1278075,537912,509137,231026,1278075
2023-05-02 16:02,1278109,537945,509137,231027,1278109
2023-05-02 16:03,1278142,537975,509139,231028,1278142
2023-05-02 16:04,1278177,538009,509139,231029,1278177
2023-05-02 16:05,1278211,538038,509140,231033,1278211
2023-05-02 16:06,1278246,538071,509140,231035,1278246
2023-05-02 16:07,1278278,538100,509141,231037,1278278
2023-05-02 16:08,1278313,538129,509145,231039,1278313
2023-05-02 16:09,1278345,538158,509145,231042,1278345
2023-05-02 16:10,1278380,538189,509149,231042,1278380
2023-05-02 16:12,1278414,538222,509149,231043,1278414
2023-05-02 16:13,1278448,538254,509149,231045,1278448
2023-05-02 16:14,1278481,538287,509149,231045,1278481
2023-05-02 16:15,1278515,538319,509150,231046,1278515
2023-05-02 16:16,1278548,538352,509150,231046,1278548
2023-05-02 16:17,1278582,538382,509151,231049,1278582
2023-05-02 16:18,1278618,538417,509151,231050,1278618
2023-05-02 16:19,1278651,538446,509152,231053,1278651
2023-05-02 16:20,1278686,538480,509152,231054,1278686
2023-05-02 16:21,1278719,538509,509153,231057,1278719
2023-05-02 16:22,1278754,538543,509153,231058,1278754
2023-05-02 16:23,1278788,538575,509155,231058,1278788
2023-05-02 16:24,1278822,538605,509157,231060,1278822
2023-05-02 16:25,1278856,538638,509157,231061,1278856
2023-05-02 16:26,1278888,538663,509161,231064,1278888
2023-05-02 16:27,1278923,538698,509161,231064,1278923
2023-05-02 16:28,1278956,538724,509166,231066,1278956
2023-05-02 16:29,1278991,538755,509166,231070,1278991
2023-05-02 16:30,1279023,538786,509166,231071,1279023
2023-05-02 16:31,1279057,538820,509166,231071,1279057
2023-05-02 16:32,1279089,538849,509167,231073,1279089
2023-05-02 16:33,1279125,538883,509167,231075,1279125
2023-05-02 16:34,1279160,538913,509170,231077,1279160
2023-05-02 16:35,1279196,538949,509170,231077,1279196
2023-05-02 16:36,1279228,538977,509173,231078,1279228
2023-05-02 16:37,1279261,539009,509173,231079,1279261
2023-05-02 16:38,1279295,539039,509177,231079,1279295
2023-05-02 16:39,1279330,539072,509177,231081,1279330
2023-05-02 16:40,1279363,539101,509180,231082,1279363
2023-05-02 16:41,1279396,539130,509180,231086,1279396
2023-05-02 16:42,1279431,539162,509183,231086,1279431
2023-05-02 16:43,1279465,539195,509183,231087,1279465
2023-05-02 16:44,1279498,539224,509187,231087,1279498
2023-05-02 16:45,1279531,539255,509187,231089,1279531
2023-05-02 16:46,1279567,539289,509189,231089,1279567
2023-05-02 16:47,1279599,539321,509189,231089,1279599
2023-05-02 16:48,1279634,539352,509193,231089,1279634
2023-05-02 16:49,1279668,539386,509193,231089,1279668
2023-05-02 16:50,1279702,539417,509195,231090,1279702
2023-05-02 16:51,1279735,539450,509195,231090,1279735
2023-05-02 16:52,1279767,539478,509198,231091,1279767
2023-05-02 16:53,1279801,539509,509198,231094,1279801
2023-05-02 16:54,1279836,539539,509201,231096,1279836
2023-05-02 16:55,1279872,539574,509201,231097,1279872
2023-05-02 16:56,1279906,539607,509201,231098,1279906
2023-05-02 16:57,1279937,539638,509201,231098,1279937
2023-05-02 16:59,1279973,539666,509205,231102,1279973
2023-05-02 17:00,1280006,539698,509205,231103,1280006
2023-05-02 17:01,1280022,539708,509209,231105,1280022
2023-05-02 17:02,1280038,539723,509209,231106,1280038
2023-05-02 17:03,1280055,539737,509211,231107,1280055
2023-05-02 17:04,1280071,539753,509211,231107,1280071
2023-05-02 17:05,1280088,539765,509213,231110,1280088
2023-05-02 17:06,1280103,539779,509213,231111,1280103
2023-05-02 17:07,1280121,539794,509215,231112,1280121
2023-05-02 17:08,1280137,539809,509215,231113,1280137
2023-05-02 17:09,1280153,539823,509218,231112,1280153
2023-05-02 17:10,1280169,539839,509218,231112,1280169
2023-05-02 17:11,1280185,539854,509219,231112,1280185
2023-05-02 17:12,1280202,539869,509219,231114,1280202
2023-05-02 17:13,1280219,539881,509221,231117,1280219
2023-05-02 17:14,1280235,539896,509221,231118,1280235
2023-05-02 17:15,1280251,539906,509226,231119,1280251
2023-05-02 17:16,1280268,539921,509226,231121,1280268
2023-05-02 17:17,1280284,539928,509235,231121,1280284
2023-05-02 17:18,1280300,539943,509235,231122,1280300
2023-05-02 17:19,1280316,539950,509242,231124,1280316
2023-05-02 17:20,1280334,539963,509242,231129,1280334
2023-05-02 17:21,1280352,539973,509249,231130,1280352
2023-05-02 17:22,1280367,539987,509249,231131,1280367
2023-05-02 17:23,1280385,540001,509251,231133,1280385
2023-05-02 17:24,1280400,540015,509251,231134,1280400
2023-05-02 17:25,1280416,540026,509254,231136,1280416
2023-05-02 17:26,1280434,540040,509254,231140,1280434
2023-05-02 17:27,1280450,540055,509254,231141,1280450
2023-05-02 17:28,1280466,540069,509254,231143,1280466
2023-05-02 17:29,1280483,540082,509257,231144,1280483
2023-05-02 17:30,1280500,540093,509257,231150,1280500
2023-05-02 17:31,1280517,540104,509262,231151,1280517
2023-05-02 17:32,1280533,540120,509262,231151,1280533
2023-05-02 17:33,1280549,540129,509267,231153,1280549
2023-05-02 17:34,1280567,540146,509267,231154,1280567
2023-05-02 17:35,1280584,540155,509275,231154,1280584
2023-05-02 17:36,1280600,540166,509276,231158,1280600
2023-05-02 17:37,1280617,540183,509276,231158,1280617
2023-05-02 17:38,1280632,540194,509280,231158,1280632
2023-05-02 17:39,1280649,540211,509280,231158,1280649
2023-05-02 17:40,1280665,540223,509283,231159,1280665
2023-05-02 17:41,1280681,540238,509283,231160,1280681
2023-05-02 17:42,1280698,540248,509286,231164,1280698
2023-05-02 17:43,1280714,540263,509286,231165,1280714
2023-05-02 17:44,1280730,540276,509287,231167,1280730
2023-05-02 17:45,1280747,540289,509286,231172,1280747
2023-05-02 17:47,1280763,540305,509286,231172,1280763
2023-05-02 17:48,1280780,540318,509289,231173,1280780
2023-05-02 17:49,1280797,540334,509290,231173,1280797
2023-05-02 17:50,1280813,540348,509290,231175,1280813
2023-05-02 17:51,1280829,540356,509297,231176,1280829
2023-05-02 17:52,1280847,540370,509299,231178,1280847
2023-05-02 17:53,1280863,540385,509299,231179,1280863
2023-05-02 17:54,1280880,540396,509302,231182,1280880
2023-05-02 17:55,1280896,540413,509302,231181,1280896
2023-05-02 17:56,1280912,540426,509302,231184,1280912
2023-05-02 17:57,1280930,540441,509302,231187,1280930
2023-05-02 17:58,1280946,540456,509302,231188,1280946
2023-05-02 17:59,1280962,540472,509302,231188,1280962
2023-05-02 18:00,1280979,540486,509302,231191,1280979
2023-05-02 18:01,1280998,540503,509302,231193,1280998
2023-05-02 18:02,1281017,540512,509310,231195,1281017
2023-05-02 18:03,1281036,540529,509310,231197,1281036
2023-05-02 18:04,1281056,540542,509314,231200,1281056
2023-05-02 18:05,1281075,540559,509314,231202,1281075
2023-05-02 18:06,1281095,540576,509314,231205,1281095
2023-05-02 18:07,1281113,540591,509317,231205,1281113
2023-05-02 18:08,1281134,540609,509317,231208,1281134
2023-05-02 18:09,1281153,540627,509318,231208,1281153
2023-05-02 18:10,1281172,540646,509318,231208,1281172
2023-05-02 18:11,1281192,540664,509320,231208,1281192
2023-05-02 18:12,1281210,540681,509320,231209,1281210
2023-05-02 18:13,1281229,540691,509327,231211,1281229
2023-05-02 18:14,1281250,540710,509327,231213,1281250
2023-05-02 18:15,1281271,540725,509332,231214,1281271
2023-05-02 18:16,1281290,540742,509332,231216,1281290
2023-05-02 18:17,1281309,540756,509334,231219,1281309
2023-05-02 18:18,1281329,540775,509334,231220,1281329
2023-05-02 18:19,1281348,540788,509338,231222,1281348
2023-05-02 18:20,1281368,540805,509338,231225,1281368
2023-05-02 18:21,1281387,540822,509340,231225,1281387
2023-05-02 18:22,1281408,540842,509340,231226,1281408
2023-05-02 18:23,1281427,540852,509346,231229,1281427
2023-05-02 18:24,1281446,540870,509346,231230,1281446
2023-05-02 18:25,1281466,540887,509347,231232,1281466
2023-05-02 18:26,1281485,540904,509347,231234,1281485
2023-05-02 18:27,1281504,540918,509349,231237,1281504
2023-05-02 18:28,1281523,540935,509349,231239,1281523
2023-05-02 18:29,1281542,540949,509353,231240,1281542
2023-05-02 18:30,1281561,540967,509353,231241,1281561
2023-05-02 18:31,1281580,540983,509354,231243,1281580
2023-05-02 18:32,1281601,541003,509354,231244,1281601
2023-05-02 18:34,1281619,541017,509356,231246,1281619
2023-05-02 18:35,1281638,541034,509356,231248,1281638
2023-05-02 18:36,1281658,541049,509359,231250,1281658
2023-05-02 18:37,1281677,541067,509359,231251,1281677
2023-05-02 18:38,1281697,541085,509359,231253,1281697
2023-05-02 18:39,1281717,541105,509359,231253,1281717
2023-05-02 18:40,1281736,541119,509362,231255,1281736
2023-05-02 18:41,1281755,541136,509362,231257,1281755
2023-05-02 18:42,1281774,541153,509362,231259,1281774
2023-05-02 18:43,1281795,541173,509362,231260,1281795
2023-05-02 18:44,1281814,541186,509367,231261,1281814
2023-05-02 18:45,1281834,541203,509367,231264,1281834
2023-05-02 18:46,1281852,541218,509369,231265,1281852
2023-05-02 18:47,1281871,541236,509369,231266,1281871
2023-05-02 18:48,1281890,541249,509375,231266,1281890
2023-05-02 18:49,1281911,541269,509375,231267,1281911
2023-05-02 18:50,1281929,541285,509375,231269,1281929
2023-05-02 18:51,1281948,541303,509375,231270,1281948
2023-05-02 18:52,1281967,541321,509376,231270,1281967
2023-05-02 18:53,1281987,541340,509376,231271,1281987
2023-05-02 18:54,1282006,541355,509378,231273,1282006
2023-05-02 18:55,1282025,541372,509378,231275,1282025
2023-05-02 18:56,1282046,541391,509380,231275,1282046
2023-05-02 18:57,1282065,541408,509381,231276,1282065
2023-05-02 18:58,1282084,541426,509381,231277,1282084
2023-05-02 18:59,1282104,541442,509384,231278,1282104
2023-05-02 19:00,1282134,541471,509384,231279,1282134
2023-05-02 19:01,1282177,541507,509389,231281,1282177
2023-05-02 19:02,1282218,541546,509389,231283,1282218
2023-05-02 19:03,1282258,541579,509394,231285,1282258
2023-05-02 19:04,1282300,541616,509397,231287,1282300
2023-05-02 19:05,1282342,541658,509397,231287,1282342
2023-05-02 19:06,1282384,541696,509399,231289,1282384
2023-05-02 19:07,1282425,541735,509399,231291,1282425
2023-05-02 19:08,1282467,541772,509401,231294,1282467
2023-05-02 19:09,1282508,541811,509401,231296,1282508
2023-05-02 19:10,1282553,541851,509405,231297,1282553
2023-05-02 19:11,1282594,541892,509405,231297,1282594
2023-05-02 19:12,1282633,541929,509406,231298,1282633
2023-05-02 19:13,1282676,541967,509408,231301,1282676
2023-05-02 19:14,1282718,542006,509408,231304,1282718
2023-05-02 19:15,1282761,542045,509412,231304,1282761
2023-05-02 19:16,1282801,542079,509416,231306,1282801
2023-05-02 19:17,1282844,542121,509416,231307,1282844
2023-05-02 19:18,1282886,542156,509422,231308,1282886
2023-05-02 19:20,1282925,542194,509422,231309,1282925
2023-05-02 19:21,1282969,542235,509424,231310,1282969
2023-05-02 19:22,1283011,542276,509424,231311,1283011
2023-05-02 19:23,1283054,542317,509424,231313,1283054
2023-05-02 19:24,1283094,542356,509424,231314,1283094
2023-05-02 19:25,1283134,542391,509427,231316,1283134
2023-05-02 19:26,1283178,542430,509427,231321,1283178
2023-05-02 19:27,1283218,542464,509431,231323,1283218
2023-05-02 19:28,1283262,542503,509431,231328,1283262
2023-05-02 19:29,1283303,542538,509433,231332,1283303
2023-05-02 19:30,1283344,542578,509433,231333,1283344
2023-05-02 19:31,1283385,542618,509434,231333,1283385
2023-05-02 19:32,1283426,542657,509434,231335,1283426
2023-05-02 19:33,1283468,542695,509436,231337,1283468
2023-05-02 19:34,1283512,542738,509437,231337,1283512
2023-05-02 19:35,1283552,542775,509438,231339,1283552
2023-05-02 19:36,1283594,542816,509438,231340,1283594
2023-05-02 19:37,1283638,542856,509440,231342,1283638
2023-05-02 19:38,1283678,542893,509440,231345,1283678
2023-05-02 19:39,1283723,542930,509447,231346,1283723
2023-05-02 19:40,1283766,542971,509447,231348,1283766
2023-05-02 19:41,1283807,543004,509450,231353,1283807
2023-05-02 19:42,1283851,543047,509450,231354,1283851
2023-05-02 19:43,1283891,543083,509453,231355,1283891
2023-05-02 19:44,1283934,543124,509453,231357,1283934
2023-05-02 19:45,1283976,543161,509458,231357,1283976
2023-05-02 19:46,1284018,543198,509458,231362,1284018
2023-05-02 19:47,1284058,543229,509465,231364,1284058
2023-05-02 19:48,1284102,543273,509465,231364,1284102
2023-05-02 19:49,1284142,543306,509469,231367,1284142
2023-05-02 19:50,1284186,543349,509469,231368,1284186
2023-05-02 19:51,1284228,543386,509473,231369,1284228
2023-05-02 19:52,1284269,543425,509473,231371,1284269
2023-05-02 19:53,1284312,543466,509474,231372,1284312
2023-05-02 19:54,1284353,543501,509477,231375,1284353
2023-05-02 19:55,1284392,543539,509477,231376,1284392
2023-05-02 19:56,1284438,543583,509479,231376,1284438
2023-05-02 19:57,1284480,543625,509479,231376,1284480
2023-05-02 19:58,1284521,543662,509483,231376,1284521
2023-05-02 19:59,1284565,543704,509483,231378,1284565
2023-05-02 20:00,1284608,543742,509486,231380,1284608
2023-05-02 20:01,1284651,543786,509486,231379,1284651
2023-05-02 20:02,1284692,543822,509488,231382,1284692
2023-05-02 20:03,1284736,543864,509489,231383,1284736
2023-05-02 20:04,1284778,543900,509493,231385,1284778
2023-05-02 20:05,1284823,543944,509493,231386,1284823
2023-05-02 20:07,1284865,543978,509498,231389,1284865
2023-05-02 20:08,1284910,544021,509498,231391,1284910
2023-05-02 20:09,1284951,544058,509500,231393,1284951
2023-05-02 20:10,1284997,544105,509500,231392,1284997
2023-05-02 20:11,1285038,544144,509502,231392,1285038
2023-05-02 20:12,1285083,544188,509502,231393,1285083
2023-05-02 20:13,1285128,544228,509506,231394,1285128
2023-05-02 20:14,1285170,544269,509506,231395,1285170
2023-05-02 20:15,1285212,544305,509510,231397,1285212
2023-05-02 20:16,1285255,544346,509510,231399,1285255
2023-05-02 20:17,1285299,544385,509512,231402,1285299
2023-05-02 20:18,1285342,544428,509512,231402,1285342
2023-05-02 20:19,1285386,544473,509511,231402,1285386
2023-05-02 20:20,1285430,544515,509512,231403,1285430
2023-05-02 20:21,1285471,544554,509512,231405,1285471
2023-05-02 20:22,1285515,544594,509516,231405,1285515
2023-05-02 20:23,1285558,544634,509516,231408,1285558
2023-05-02 20:24,1285601,544675,509517,231409,1285601
2023-05-02 20:25,1285645,544717,509517,231411,1285645
2023-05-02 20:26,1285688,544755,509520,231413,1285688
2023-05-02 20:27,1285732,544796,509520,231416,1285732
2023-05-02 20:28,1285773,544834,509522,231417,1285773
2023-05-02 20:29,1285818,544876,509522,231420,1285818
2023-05-02 20:30,1285862,544916,509524,231422,1285862
2023-05-02 20:31,1285903,544957,509524,231422,1285903
2023-05-02 20:32,1285946,544993,509528,231425,1285946
2023-05-02 20:33,1285993,545040,509528,231425,1285993
2023-05-02 20:34,1286034,545076,509533,231425,1286034
2023-05-02 20:35,1286077,545113,509536,231428,1286077
2023-05-02 20:36,1286119,545152,509536,231431,1286119
2023-05-02 20:37,1286163,545192,509537,231434,1286163
2023-05-02 20:38,1286207,545235,509537,231435,1286207
2023-05-02 20:39,1286252,545273,509544,231435,1286252
2023-05-02 20:40,1286294,545315,509544,231435,1286294
2023-05-02 20:41,1286338,545356,509547,231435,1286338
2023-05-02 20:42,1286379,545397,509547,231435,1286379
2023-05-02 20:43,1286424,545439,509549,231436,1286424
2023-05-02 20:44,1286465,545476,509550,231439,1286465
2023-05-02 20:45,1286508,545518,509550,231440,1286508
2023-05-02 20:46,1286551,545555,509555,231441,1286551
2023-05-02 20:47,1286595,545596,509555,231444,1286595
2023-05-02 20:48,1286639,545634,509561,231444,1286639
2023-05-02 20:49,1286683,545678,509561,231444,1286683
2023-05-02 20:50,1286723,545709,509569,231445,1286723
2023-05-02 20:51,1286768,545753,509569,231446,1286768
2023-05-02 20:53,1286812,545794,509570,231448,1286812
2023-05-02 20:54,1286852,545834,509570,231448,1286852
2023-05-02 20:55,1286896,545873,509572,231451,1286896
2023-05-02 20:56,1286940,545916,509572,231452,1286940
2023-05-02 20:57,1286982,545954,509576,231452,1286982
2023-05-02 20:58,1287027,545994,509576,231457,1287027
2023-05-02 20:59,1287070,546029,509582,231459,1287070
2023-05-02 21:00,1287114,546072,509582,231460,1287114
2023-05-02 21:01,1287153,546107,509583,231463,1287153
2023-05-02 21:02,1287193,546146,509583,231464,1287193
2023-05-02 21:03,1287233,546180,509585,231468,1287233
2023-05-02 21:04,1287272,546218,509585,231469,1287272
2023-05-02 21:05,1287310,546248,509591,231471,1287310
2023-05-02 21:06,1287348,546284,509591,231473,1287348
2023-05-02 21:07,1287389,546322,509591,231476,1287389
2023-05-02 21:08,1287428,546358,509591,231479,1287428
2023-05-02 21:09,1287467,546396,509591,231480,1287467
2023-05-02 21:10,1287506,546432,509591,231483,1287506
2023-05-02 21:11,1287544,546470,509591,231483,1287544
2023-05-02 21:12,1287582,546507,509591,231484,1287582
2023-05-02 21:13,1287620,546543,509592,231485,1287620
2023-05-02 21:14,1287661,546582,509592,231487,1287661
2023-05-02 21:15,1287698,546611,509598,231489,1287698
2023-05-02 21:16,1287739,546649,509598,231492,1287739
2023-05-02 21:17,1287777,546680,509604,231493,1287777
2023-05-02 21:18,1287814,546715,509604,231495,1287814
2023-05-02 21:19,1287856,546756,509604,231496,1287856
2023-05-02 21:20,1287893,546792,509604,231497,1287893
2023-05-02 21:21,1287932,546828,509604,231500,1287932
2023-05-02 21:22,1287975,546869,509604,231502,1287975
2023-05-02 21:23,1288013,546897,509613,231503,1288013
2023-05-02 21:24,1288052,546935,509613,231504,1288052
2023-05-02 21:25,1288092,546967,509619,231506,1288092
2023-05-02 21:26,1288129,547002,509619,231508,1288129
2023-05-02 21:27,1288170,547035,509625,231510,1288170
2023-05-02 21:28,1288208,547069,509625,231514,1288208
2023-05-02 21:29,1288246,547099,509630,231517,1288246
2023-05-02 21:30,1288285,547136,509632,231517,1288285
2023-05-02 21:31,1288324,547175,509632,231517,1288324
2023-05-02 21:32,1288362,547211,509634,231517,1288362
2023-05-02 21:33,1288404,547249,509637,231518,1288404
2023-05-02 21:34,1288444,547288,509637,231519,1288444
2023-05-02 21:35,1288483,547325,509638,231520,1288483
2023-05-02 21:36,1288521,547361,509638,231522,1288521
2023-05-02 21:37,1288561,547398,509641,231522,1288561
2023-05-02 21:38,1288599,547434,509641,231524,1288599
2023-05-02 21:40,1288638,547471,509642,231525,1288638
2023-05-02 21:41,1288678,547510,509642,231526,1288678
2023-05-02 21:42,1288720,547548,509643,231529,1288720
2023-05-02 21:43,1288757,547582,509643,231532,1288757
2023-05-02 21:44,1288797,547618,509643,231536,1288797
2023-05-02 21:45,1288835,547652,509645,231538,1288835
2023-05-02 21:46,1288876,547691,509645,231540,1288876
2023-05-02 21:47,1288914,547723,509646,231545,1288914
2023-05-02 21:48,1288955,547764,509646,231545,1288955
2023-05-02 21:49,1288991,547797,509649,231545,1288991
2023-05-02 21:50,1289030,547833,509649,231548,1289030
2023-05-02 21:51,1289071,547867,509653,231551,1289071
2023-05-02 21:52,1289108,547904,509653,231551,1289108
2023-05-02 21:53,1289149,547939,509654,231556,1289149
2023-05-02 21:54,1289188,547977,509654,231557,1289188
2023-05-02 21:55,1289227,548014,509654,231559,1289227
2023-05-02 21:56,1289265,548049,509654,231562,1289265
2023-05-02 21:57,1289303,548079,509660,231564,1289303
2023-05-02 21:58,1289342,548116,509660,231566,1289342
2023-05-02 21:59,1289382,548154,509661,231567,1289382
2023-05-02 22:00,1289411,548181,509661,231569,1289411
2023-05-02 22:01,1289420,548187,509661,231572,1289420
2023-05-02 22:02,1289430,548193,509664,231573,1289430
2023-05-02 22:03,1289438,548200,509664,231574,1289438
2023-05-02 22:04,1289447,548202,509670,231575,1289447
2023-05-02 22:05,1289457,548209,509670,231578,1289457
2023-05-02 22:06,1289466,548218,509669,231579,1289466
2023-05-02 22:07,1289474,548225,509669,231580,1289474
2023-05-02 22:08,1289483,548229,509673,231581,1289483
2023-05-02 22:09,1289493,548238,509673,231582,1289493
2023-05-02 22:10,1289502,548245,509674,231583,1289502
2023-05-02 22:11,1289510,548252,509674,231584,1289510
2023-05-02 22:12,1289519,548258,509676,231585,1289519
2023-05-02 22:13,1289528,548267,509676,231585,1289528
2023-05-02 22:14,1289537,548272,509679,231586,1289537
2023-05-02 22:15,1289546,548279,509679,231588,1289546
2023-05-02 22:16,1289555,548288,509678,231589,1289555
2023-05-02 22:17,1289563,548294,509678,231591,1289563
2023-05-02 22:18,1289572,548301,509679,231592,1289572
2023-05-02 22:19,1289581,548310,509679,231592,1289581
2023-05-02 22:20,1289590,548313,509684,231593,1289590
2023-05-02 22:21,1289599,548318,509684,231597,1289599
2023-05-02 22:22,1289608,548322,509687,231599,1289608
2023-05-02 22:23,1289617,548329,509687,231601,1289617
2023-05-02 22:24,1289626,548333,509689,231604,1289626
2023-05-02 22:25,1289635,548342,509689,231604,1289635
2023-05-02 22:26,1289644,548348,509691,231605,1289644
2023-05-02 22:28,1289652,548355,509691,231606,1289652
2023-05-02 22:29,1289661,548356,509695,231610,1289661
2023-05-02 22:30,1289670,548363,509695,231612,1289670
2023-05-02 22:31,1289679,548365,509702,231612,1289679
2023-05-02 22:32,1289687,548371,509702,231614,1289687
2023-05-02 22:33,1289697,548381,509702,231614,1289697
2023-05-02 22:34,1289706,548390,509702,231614,1289706
2023-05-02 22:35,1289715,548392,509707,231616,1289715
2023-05-02 22:36,1289725,548401,509707,231617,1289725
2023-05-02 22:37,1289734,548407,509708,231619,1289734
2023-05-02 22:38,1289742,548413,509708,231621,1289742
2023-05-02 22:39,1289751,548415,509713,231623,1289751
2023-05-02 22:40,1289760,548423,509713,231624,1289760
2023-05-02 22:41,1289770,548426,509718,231626,1289770
2023-05-02 22:42,1289779,548434,509718,231627,1289779
2023-05-02 22:43,1289787,548437,509720,231630,1289787
2023-05-02 22:44,1289796,548445,509720,231631,1289796
2023-05-02 22:45,1289805,548450,509723,231632,1289805
2023-05-02 22:46,1289814,548454,509723,231637,1289814
2023-05-02 22:47,1289823,548461,509725,231637,1289823
2023-05-02 22:48,1289831,548465,509728,231638,1289831
2023-05-02 22:49,1289840,548474,509728,231638,1289840
2023-05-02 22:50,1289849,548478,509732,231639,1289849
2023-05-02 22:51,1289858,548485,509732,231641,1289858
2023-05-02 22:52,1289867,548494,509732,231641,1289867
2023-05-02 22:53,1289876,548503,509732,231641,1289876
2023-05-02 22:54,1289884,548498,509738,231648,1289884
2023-05-02 22:55,1289893,548505,509739,231649,1289893
2023-05-02 22:56,1289902,548514,509739,231649,1289902
2023-05-02 22:57,1289911,548516,509743,231652,1289911
2023-05-02 22:58,1289919,548516,509743,231660,1289919
2023-05-02 22:59,1289928,548518,509749,231661,1289928
2023-05-02 23:00,1289947,548526,509758,231663,1289947
2023-05-02 23:01,1289973,548551,509758,231664,1289973
2023-05-02 23:02,1290000,548574,509759,231667,1290000
2023-05-02 23:03,1290026,548600,509759,231667,1290026
2023-05-02 23:04,1290052,548621,509763,231668,1290052
2023-05-02 23:05,1290077,548644,509763,231670,1290077
2023-05-02 23:06,1290102,548664,509766,231672,1290102
2023-05-02 23:07,1290127,548689,509766,231672,1290127
2023-05-02 23:08,1290153,548710,509770,231673,1290153
2023-05-02 23:09,1290179,548733,509770,231676,1290179
2023-05-02 23:10,1290205,548754,509774,231677,1290205
2023-05-02 23:11,1290231,548780,509774,231677,1290231
2023-05-02 23:12,1290255,548800,509777,231678,1290255
2023-05-02 23:13,1290281,548826,509777,231678,1290281
2023-05-02 23:15,1290308,548849,509781,231678,1290308
2023-05-02 23:16,1290334,548870,509785,231679,1290334
2023-05-02 23:17,1290358,548891,509786,231681,1290358
2023-05-02 23:18,1290384,548917,509786,231681,1290384
2023-05-02 23:19,1290409,548937,509788,231684,1290409
2023-05-02 23:20,1290435,548959,509788,231688,1290435
2023-05-02 23:21,1290461,548979,509794,231688,1290461
2023-05-02 23:22,1290486,549003,509794,231689,1290486
2023-05-02 23:23,1290512,549024,509799,231689,1290512
2023-05-02 23:24,1290538,549048,509799,231691,1290538
2023-05-02 23:25,1290564,549071,509800,231693,1290564
2023-05-02 23:26,1290591,549099,509800,231692,1290591
2023-05-02 23:27,1290616,549115,509804,231697,1290616
2023-05-02 23:28,1290640,549138,509804,231698,1290640
2023-05-02 23:29,1290667,549159,509807,231701,1290667
2023-05-02 23:30,1290694,549184,509807,231703,1290694
2023-05-02 23:31,1290719,549201,509812,231706,1290719
2023-05-02 23:32,1290745,549225,509812,231708,1290745
2023-05-02 23:33,1290770,549250,509811,231709,1290770
2023-05-02 23:34,1290796,549273,509811,231712,1290796
2023-05-02 23:35,1290823,549297,509814,231712,1290823
2023-05-02 23:36,1290848,549318,509814,231716,1290848
2023-05-02 23:37,1290873,549340,509816,231717,1290873
2023-05-02 23:38,1290898,549361,509816,231721,1290898
2023-05-02 23:39,1290923,549383,509818,231722,1290923
2023-05-02 23:40,1290950,549408,509818,231724,1290950
2023-05-02 23:41,1290976,549432,509819,231725,1290976
2023-05-02 23:42,1291001,549457,509819,231725,1291001
2023-05-02 23:43,1291027,549473,509826,231728,1291027
2023-05-02 23:44,1291054,549499,509826,231729,1291054
2023-05-02 23:45,1291080,549520,509830,231730,1291080
2023-05-02 23:46,1291106,549545,509830,231731,1291106
2023-05-02 23:47,1291131,549565,509834,231732,1291131
2023-05-02 23:48,1291157,549588,509834,231735,1291157
2023-05-02 23:49,1291182,549609,509838,231735,1291182
2023-05-02 23:50,1291209,549636,509838,231735,1291209
2023-05-02 23:51,1291234,549657,509841,231736,1291234
2023-05-02 23:52,1291260,549681,509841,231738,1291260
2023-05-02 23:53,1291285,549701,509846,231738,1291285
2023-05-02 23:54,1291311,549726,509846,231739,1291311
2023-05-02 23:55,1291338,549746,509848,231744,1291338
2023-05-02 23:56,1291362,549768,509848,231746,1291362
2023-05-02 23:57,1291387,549788,509851,231748,1291387
2023-05-02 23:58,1291414,549815,509851,231748,1291414
2023-05-02 23:59,1291438,549834,509855,231749,1291438
2023-05-03 00:00,1291463,549858,509855,231750,1291463
2023-05-03 00:01,1291487,549874,509857,231756,1291487
2023-05-03 00:03,1291511,549897,509857,231757,1291511
2023-05-03 00:04,1291537,549919,509859,231759,1291537
2023-05-03 00:05,1291561,549943,509859,231759,1291561
2023-05-03 00:06,1291585,549967,509858,231760,1291585
2023-05-03 00:07,1291609,549990,509858,231761,1291609
2023-05-03 00:08,1291633,550005,509863,231765,1291633
2023-05-03 00:09,1291659,550029,509864,231766,1291659
2023-05-03 00:10,1291683,550052,509865,231766,1291683
2023-05-03 00:11,1291708,550067,509870,231771,1291708
2023-05-03 00:12,1291733,550086,509876,231771,1291733
2023-05-03 00:13,1291757,550104,509876,231777,1291757
2023-05-03 00:14,1291780,550123,509879,231778,1291780
2023-05-03 00:15,1291806,550146,509879,231781,1291806
2023-05-03 00:16,1291830,550168,509880,231782,1291830
2023-05-03 00:17,1291854,550187,509880,231787,1291854
2023-05-03 00:18,1291878,550206,509883,231789,1291878
2023-05-03 00:19,1291903,550229,509883,231791,1291903
2023-05-03 00:20,1291929,550251,509886,231792,1291929
2023-05-03 00:21,1291953,550274,509885,231794,1291953
2023-05-03 00:22,1291978,550297,509886,231795,1291978
2023-05-03 00:23,1292002,550322,509885,231795,1292002
2023-05-03 00:24,1292026,550344,509885,231797,1292026
2023-05-03 00:25,1292052,550366,509887,231799,1292052
2023-05-03 00:26,1292076,550389,509887,231800,1292076
2023-05-03 00:27,1292101,550406,509891,231804,1292101
2023-05-03 00:28,1292126,550429,509891,231806,1292126
2023-05-03 00:29,1292150,550448,509895,231807,1292150
2023-05-03 00:30,1292175,550471,509895,231809,1292175
2023-05-03 00:31,1292199,550491,509897,231811,1292199
2023-05-03 00:32,1292224,550515,509897,231812,1292224
2023-05-03 00:33,1292249,550532,509903,231814,1292249
2023-05-03 00:34,1292273,550556,509903,231814,1292273
2023-05-03 00:35,1292297,550577,509905,231815,1292297
2023-05-03 00:36,1292321,550599,509905,231817,1292321
2023-05-03 00:37,1292346,550621,509908,231817,1292346
2023-05-03 00:38,1292372,550646,509908,231818,1292372
2023-05-03 00:39,1292396,550662,509915,231819,1292396
2023-05-03 00:40,1292422,550680,509921,231821,1292422
2023-05-03 00:41,1292445,550701,509922,231822,1292445
2023-05-03 00:42,1292471,550727,509922,231822,1292471
2023-05-03 00:43,1292496,550743,509928,231825,1292496
2023-05-03 00:44,1292519,550766,509928,231825,1292519
2023-05-03 00:45,1292544,550787,509932,231825,1292544
2023-05-03 00:46,1292567,550808,509934,231825,1292567
2023-05-03 00:47,1292592,550833,509934,231825,1292592
2023-05-03 00:48,1292617,550856,509935,231826,1292617
2023-05-03 00:50,1292642,550876,509935,231831,1292642
2023-05-03 00:51,1292667,550899,509937,231831,1292667
2023-05-03 00:52,1292693,550924,509937,231832,1292693
2023-05-03 00:53,1292717,550944,509939,231834,1292717
2023-05-03 00:54,1292743,550968,509939,231836,1292743
2023-05-03 00:55,1292769,550989,509942,231838,1292769
2023-05-03 00:56,1292793,551011,509943,231839,1292793
2023-05-03 00:57,1292817,551035,509943,231839,1292817
2023-05-03 00:58,1292842,551055,509946,231841,1292842
2023-05-03 00:59,1292867,551079,509947,231841,1292867
2023-05-03 01:00,1292893,551104,509947,231842,1292893
2023-05-03 01:01,1292932,551142,509947,231843,1292932
2023-05-03 01:02,1292966,551175,509947,231844,1292966
2023-05-03 01:03,1293007,551215,509947,231845,1293007
2023-05-03 01:04,1293045,551247,509951,231847,1293045
2023-05-03 01:05,1293082,551283,509951,231848,1293082
2023-05-03 01:06,1293119,551310,509959,231850,1293119
2023-05-03 01:07,1293155,551344,509961,231850,1293155
2023-05-03 01:08,1293193,551382,509961,231850,1293193
2023-05-03 01:09,1293232,551418,509962,231852,1293232
2023-05-03 01:10,1293268,551452,509962,231854,1293268
2023-05-03 01:11,1293306,551487,509964,231855,1293306
2023-05-03 01:12,1293344,551525,509964,231855,1293344
2023-05-03 01:13,1293383,551559,509969,231855,1293383
2023-05-03 01:14,1293420,551594,509969,231857,1293420
2023-05-03 01:15,1293456,551628,509970,231858,1293456
2023-05-03 01:16,1293495,551667,509970,231858,1293495
2023-05-03 01:17,1293535,551706,509970,231859,1293535
2023-05-03 01:18,1293571,551741,509970,231860,1293571
2023-05-03 01:19,1293610,551777,509973,231860,1293610
2023-05-03 01:20,1293645,551812,509973,231860,1293645
2023-05-03 01:21,1293685,551849,509974,231862,1293685
2023-05-03 01:22,1293722,551884,509974,231864,1293722
2023-05-03 01:23,1293759,551918,509977,231864,1293759
2023-05-03 01:24,1293795,551952,509977,231866,1293795
2023-05-03 01:25,1293835,551990,509979,231866,1293835
2023-05-03 01:26,1293870,552022,509979,231869,1293870
2023-05-03 01:27,1293909,552055,509982,231872,1293909
2023-05-03 01:28,1293947,552093,509982,231872,1293947
2023-05-03 01:29,1293983,552128,509982,231873,1293983
2023-05-03 01:30,1294021,552165,509982,231874,1294021
2023-05-03 01:31,1294059,552202,509983,231874,1294059
2023-05-03 01:32,1294096,552237,509983,231876,1294096
2023-05-03 01:33,1294135,552273,509984,231878,1294135
2023-05-03 01:34,1294172,552311,509984,231877,1294172
2023-05-03 01:35,1294213,552348,509986,231879,1294213
2023-05-03 01:36,1294248,552382,509986,231880,1294248
2023-05-03 01:38,1294287,552418,509989,231880,1294287
2023-05-03 01:39,1294326,552457,509989,231880,1294326
2023-05-03 01:40,1294363,552488,509992,231883,1294363
2023-05-03 01:41,1294401,552525,509992,231884,1294401
2023-05-03 01:42,1294437,552560,509993,231884,1294437
2023-05-03 01:43,1294477,552600,509993,231884,1294477
2023-05-03 01:44,1294515,552636,509994,231885,1294515
2023-05-03 01:45,1294552,552671,509994,231887,1294552
2023-05-03 01:46,1294588,552706,509995,231887,1294588
2023-05-03 01:47,1294628,552745,509995,231888,1294628
2023-05-03 01:48,1294665,552780,509997,231888,1294665
2023-05-03 01:49,1294702,552817,509997,231888,1294702
2023-05-03 01:50,1294738,552849,509999,231890,1294738
2023-05-03 01:51,1294775,552885,509999,231891,1294775
2023-05-03 01:52,1294816,552926,509999,231891,1294816
2023-05-03 01:53,1294853,552963,509999,231891,1294853
2023-05-03 01:54,1294891,552999,510001,231891,1294891
2023-05-03 01:55,1294927,553032,510001,231894,1294927
2023-05-03 01:56,1294964,553066,510004,231894,1294964
2023-05-03 01:57,1295003,553104,510004,231895,1295003
2023-05-03 01:58,1295038,553139,510004,231895,1295038
2023-05-03 01:59,1295077,553176,510004,231897,1295077
2023-05-03 02:00,1295115,553214,510004,231897,1295115
2023-05-03 02:01,1295152,553251,510004,231897,1295152
2023-05-03 02:02,1295190,553288,510004,231898,1295190
2023-05-03 02:03,1295226,553316,510011,231899,1295226
2023-05-03 02:04,1295263,553351,510011,231901,1295263
2023-05-03 02:05,1295303,553388,510014,231901,1295303
2023-05-03 02:06,1295340,553425,510014,231901,1295340
2023-05-03 02:07,1295376,553459,510015,231902,1295376
2023-05-03 02:08,1295415,553498,510015,231902,1295415
2023-05-03 02:09,1295451,553533,510014,231904,1295451
2023-05-03 02:10,1295490,553570,510014,231906,1295490
2023-05-03 02:11,1295527,553607,510014,231906,1295527
2023-05-03 02:12,1295565,553644,510014,231907,1295565
2023-05-03 02:13,1295602,553680,510015,231907,1295602
2023-05-03 02:14,1295642,553719,510015,231908,1295642
2023-05-03 02:15,1295680,553757,510015,231908,1295680
2023-05-03 02:16,1295715,553791,510015,231909,1295715
2023-05-03 02:17,1295752,553827,510015,231910,1295752
2023-05-03 02:18,1295792,553867,510015,231910,1295792
2023-05-03 02:19,1295828,553899,510016,231913,1295828
2023-05-03 02:20,1295866,553937,510016,231913,1295866
2023-05-03 02:21,1295904,553975,510015,231914,1295904
2023-05-03 02:22,1295940,554011,510015,231914,1295940
2023-05-03 02:23,1295978,554049,510015,231914,1295978
2023-05-03 02:25,1296015,554085,510015,231915,1296015
2023-05-03 02:26,1296053,554120,510018,231915,1296053
2023-05-03 02:27,1296092,554158,510018,231916,1296092
2023-05-03 02:28,1296130,554196,510018,231916,1296130
2023-05-03 02:29,1296166,554230,510018,231918,1296166
2023-05-03 02:30,1296205,554268,510018,231919,1296205
2023-05-03 02:31,1296240,554303,510018,231919,1296240
2023-05-03 02:32,1296279,554341,510018,231920,1296279
2023-05-03 02:33,1296316,554377,510018,231921,1296316
2023-05-03 02:34,1296354,554412,510020,231922,1296354
2023-05-03 02:35,1296393,554451,510020,231922,1296393
2023-05-03 02:36,1296428,554485,510020,231923,1296428
2023-05-03 02:37,1296467,554523,510020,231924,1296467
2023-05-03 02:38,1296504,554560,510020,231924,1296504
2023-05-03 02:39,1296541,554597,510020,231924,1296541
2023-05-03 02:40,1296579,554634,510021,231924,1296579
2023-05-03 02:41,1296617,554671,510021,231925,1296617
2023-05-03 02:42,1296654,554707,510021,231926,1296654
2023-05-03 02:43,1296691,554743,510022,231926,1296691
2023-05-03 02:44,1296729,554780,510022,231927,1296729
2023-05-03 02:45,1296766,554816,510023,231927,1296766
2023-05-03 02:46,1296804,554853,510023,231928,1296804
2023-05-03 02:47,1296843,554890,510024,231929,1296843
2023-05-03 02:48,1296881,554927,510025,231929,1296881
2023-05-03 02:49,1296918,554964,510025,231929,1296918
2023-05-03 02:50,1296955,555000,510025,231930,1296955
2023-05-03 02:51,1296994,555039,510025,231930,1296994
2023-05-03 02:52,1297031,555073,510028,231930,1297031
2023-05-03 02:53,1297067,555107,510028,231932,1297067
2023-05-03 02:54,1297105,555143,510030,231932,1297105
2023-05-03 02:55,1297144,555181,510030,231933,1297144
2023-05-03 02:56,1297179,555213,510031,231935,1297179
2023-05-03 02:57,1297219,555251,510031,231937,1297219
2023-05-03 02:58,1297256,555287,510031,231938,1297256
2023-05-03 02:59,1297292,555324,510031,231937,1297292
2023-05-03 03:00,1297324,555354,510033,231937,1297324
2023-05-03 03:01,1297353,555383,510033,231937,1297353
2023-05-03 03:02,1297383,555410,510034,231939,1297383
2023-05-03 03:03,1297411,555436,510036,231939,1297411
2023-05-03 03:04,1297440,555465,510036,231939,1297440
2023-05-03 03:05,1297468,555494,510035,231939,1297468
2023-05-03 03:06,1297497,555523,510035,231939,1297497
2023-05-03 03:07,1297528,555552,510036,231940,1297528
2023-05-03 03:08,1297556,555580,510036,231940,1297556
2023-05-03 03:09,1297585,555608,510037,231940,1297585
2023-05-03 03:10,1297616,555639,510037,231940,1297616
2023-05-03 03:12,1297644,555666,510037,231941,1297644
2023-05-03 03:13,1297674,555696,510037,231941,1297674
2023-05-03 03:14,1297702,555723,510038,231941,1297702
2023-05-03 03:15,1297732,555751,510038,231943,1297732
2023-05-03 03:16,1297760,555777,510039,231944,1297760
2023-05-03 03:17,1297789,555805,510039,231945,1297789
2023-05-03 03:18,1297818,555834,510039,231945,1297818
2023-05-03 03:19,1297846,555862,510039,231945,1297846
2023-05-03 03:20,1297876,555890,510041,231945,1297876
2023-05-03 03:21,1297905,555919,510041,231945,1297905
2023-05-03 03:22,1297933,555945,510043,231945,1297933
2023-05-03 03:23,1297964,555976,510043,231945,1297964
2023-05-03 03:24,1297993,556004,510044,231945,1297993
2023-05-03 03:25,1298020,556031,510044,231945,1298020
2023-05-03 03:26,1298050,556059,510046,231945,1298050
2023-05-03 03:27,1298078,556087,510046,231945,1298078
2023-05-03 03:28,1298108,556117,510046,231945,1298108
2023-05-03 03:29,1298137,556146,510046,231945,1298137
2023-05-03 03:30,1298165,556174,510046,231945,1298165
2023-05-03 03:31,1298193,556201,510046,231946,1298193
2023-05-03 03:32,1298224,556232,510046,231946,1298224
2023-05-03 03:33,1298253,556260,510046,231947,1298253
2023-05-03 03:34,1298282,556289,510046,231947,1298282
2023-05-03 03:35,1298310,556316,510046,231948,1298310
2023-05-03 03:36,1298338,556342,510047,231949,1298338
2023-05-03 03:37,1298367,556371,510047,231949,1298367
2023-05-03 03:38,1298397,556400,510047,231950,1298397
2023-05-03 03:39,1298427,556429,510047,231951,1298427
2023-05-03 03:40,1298454,556456,510047,231951,1298454
2023-05-03 03:41,1298483,556485,510047,231951,1298483
2023-05-03 03:42,1298512,556513,510047,231952,1298512
2023-05-03 03:43,1298542,556542,510047,231953,1298542
2023-05-03 03:44,1298570,556570,510047,231953,1298570
2023-05-03 03:45,1298599,556599,510047,231953,1298599
2023-05-03 03:46,1298627,556623,510051,231953,1298627
2023-05-03 03:47,1298657,556652,510051,231954,1298657
2023-05-03 03:48,1298685,556680,510051,231954,1298685
2023-05-03 03:49,1298715,556709,510051,231955,1298715
2023-05-03 03:50,1298743,556736,510051,231956,1298743
2023-05-03 03:51,1298773,556766,510051,231956,1298773
2023-05-03 03:52,1298803,556794,510051,231958,1298803
2023-05-03 03:53,1298830,556821,510051,231958,1298830
2023-05-03 03:54,1298862,556853,510051,231958,1298862
2023-05-03 03:55,1298888,556879,510051,231958,1298888
2023-05-03 03:56,1298919,556908,510053,231958,1298919
2023-05-03 03:57,1298946,556935,510053,231958,1298946
2023-05-03 03:58,1298976,556965,510053,231958,1298976
2023-05-03 04:00,1299004,556992,510053,231959,1299004
2023-05-03 04:01,1299042,557030,510053,231959,1299042
2023-05-03 04:02,1299082,557070,510053,231959,1299082
2023-05-03 04:03,1299119,557107,510053,231959,1299119
2023-05-03 04:04,1299158,557146,510053,231959,1299158
2023-05-03 04:05,1299195,557183,510053,231959,1299195
2023-05-03 04:06,1299235,557223,510053,231959,1299235
2023-05-03 04:07,1299274,557258,510057,231959,1299274
2023-05-03 04:08,1299311,557295,510057,231959,1299311
2023-05-03 04:09,1299350,557334,510057,231959,1299350
2023-05-03 04:10,1299390,557374,510057,231959,1299390
2023-05-03 04:11,1299428,557412,510057,231959,1299428
2023-05-03 04:12,1299464,557448,510057,231959,1299464
2023-05-03 04:13,1299505,557489,510057,231959,1299505
2023-05-03 04:14,1299542,557526,510057,231959,1299542
2023-05-03 04:15,1299581,557565,510057,231959,1299581
2023-05-03 04:16,1299617,557601,510057,231959,1299617
2023-05-03 04:17,1299656,557635,510062,231959,1299656
2023-05-03 04:18,1299695,557674,510062,231959,1299695
2023-05-03 04:19,1299733,557712,510062,231959,1299733
2023-05-03 04:20,1299771,557750,510062,231959,1299771
2023-05-03 04:21,1299809,557787,510062,231960,1299809
2023-05-03 04:22,1299847,557825,510062,231960,1299847
2023-05-03 04:23,1299885,557863,510062,231960,1299885
2023-05-03 04:24,1299923,557901,510062,231960,1299923
2023-05-03 04:25,1299963,557941,510062,231960,1299963
2023-05-03 04:26,1300001,557979,510062,231960,1300001
2023-05-03 04:27,1300040,558018,510062,231960,1300040
2023-05-03 04:28,1300077,558055,510062,231960,1300077
2023-05-03 04:29,1300116,558094,510062,231960,1300116
2023-05-03 04:30,1300154,558132,510062,231960,1300154
2023-05-03 04:31,1300193,558171,510062,231960,1300193
2023-05-03 04:32,1300232,558209,510062,231961,1300232
2023-05-03 04:33,1300269,558246,510062,231961,1300269
2023-05-03 04:34,1300308,558285,510062,231961,1300308
2023-05-03 04:35,1300346,558323,510062,231961,1300346
2023-05-03 04:36,1300384,558359,510064,231961,1300384
2023-05-03 04:37,1300420,558395,510064,231961,1300420
2023-05-03 04:38,1300460,558435,510064,231961,1300460
2023-05-03 04:39,1300497,558472,510064,231961,1300497
2023-05-03 04:40,1300538,558513,510064,231961,1300538
2023-05-03 04:41,1300574,558548,510064,231962,1300574
2023-05-03 04:42,1300612,558585,510064,231963,1300612
2023-05-03 04:43,1300650,558623,510064,231963,1300650
2023-05-03 04:44,1300690,558663,510064,231963,1300690
2023-05-03 04:45,1300727,558699,510064,231964,1300727
2023-05-03 04:47,1300767,558737,510066,231964,1300767
2023-05-03 04:48,1300804,558774,510066,231964,1300804
2023-05-03 04:49,1300841,558811,510066,231964,1300841
2023-05-03 04:50,1300882,558852,510066,231964,1300882
2023-05-03 04:51,1300919,558889,510066,231964,1300919
2023-05-03 04:52,1300957,558927,510066,231964,1300957
2023-05-03 04:53,1300995,558964,510066,231965,1300995
2023-05-03 04:54,1301034,559003,510066,231965,1301034
2023-05-03 04:55,1301073,559042,510066,231965,1301073
2023-05-03 04:56,1301111,559079,510066,231966,1301111
2023-05-03 04:57,1301148,559114,510068,231966,1301148
2023-05-03 04:58,1301186,559152,510068,231966,1301186
2023-05-03 04:59,1301226,559191,510068,231967,1301226
2023-05-03 05:00,1301260,559225,510068,231967,1301260
2023-05-03 05:01,1301283,559248,510068,231967,1301283
2023-05-03 05:02,1301307,559271,510068,231968,1301307
2023-05-03 05:03,1301329,559293,510068,231968,1301329
2023-05-03 05:04,1301352,559315,510068,231969,1301352
2023-05-03 05:05,1301376,559339,510068,231969,1301376
2023-05-03 05:06,1301398,559361,510068,231969,1301398
2023-05-03 05:07,1301422,559384,510069,231969,1301422
2023-05-03 05:08,1301444,559406,510069,231969,1301444
2023-05-03 05:09,1301467,559429,510069,231969,1301467
2023-05-03 05:10,1301491,559453,510069,231969,1301491
2023-05-03 05:11,1301514,559476,510069,231969,1301514
2023-05-03 05:12,1301537,559498,510069,231970,1301537
2023-05-03 05:13,1301561,559522,510069,231970,1301561
2023-05-03 05:14,1301583,559544,510069,231970,1301583
2023-05-03 05:15,1301606,559566,510069,231971,1301606
2023-05-03 05:16,1301629,559586,510072,231971,1301629
2023-05-03 05:17,1301651,559608,510072,231971,1301651
2023-05-03 05:18,1301675,559632,510072,231971,1301675
2023-05-03 05:19,1301699,559656,510072,231971,1301699
2023-05-03 05:20,1301720,559677,510072,231971,1301720
2023-05-03 05:21,1301744,559701,510072,231971,1301744
2023-05-03 05:22,1301767,559723,510072,231972,1301767
2023-05-03 05:23,1301791,559747,510072,231972,1301791
2023-05-03 05:24,1301814,559770,510072,231972,1301814
2023-05-03 05:25,1301837,559793,510072,231972,1301837
2023-05-03 05:26,1301859,559811,510076,231972,1301859
2023-05-03 05:27,1301883,559834,510076,231973,1301883
2023-05-03 05:28,1301905,559855,510076,231974,1301905
2023-05-03 05:29,1301928,559878,510076,231974,1301928
2023-05-03 05:30,1301951,559901,510076,231974,1301951
2023-05-03 05:31,1301974,559923,510076,231975,1301974
2023-05-03 05:32,1301998,559947,510076,231975,1301998
2023-05-03 05:34,1302021,559970,510076,231975,1302021
2023-05-03 05:35,1302044,559993,510076,231975,1302044
2023-05-03 05:36,1302067,560016,510076,231975,1302067
2023-05-03 05:37,1302089,560038,510076,231975,1302089
2023-05-03 05:38,1302112,560061,510076,231975,1302112
2023-05-03 05:39,1302135,560084,510076,231975,1302135
2023-05-03 05:40,1302158,560106,510076,231976,1302158
2023-05-03 05:41,1302181,560128,510076,231977,1302181
2023-05-03 05:42,1302204,560151,510076,231977,1302204
2023-05-03 05:43,1302228,560175,510076,231977,1302228
2023-05-03 05:44,1302251,560198,510076,231977,1302251
2023-05-03 05:45,1302273,560218,510076,231979,1302273
2023-05-03 05:46,1302297,560242,510076,231979,1302297
2023-05-03 05:47,1302320,560266,510075,231979,1302320
2023-05-03 05:48,1302343,560289,510075,231979,1302343
2023-05-03 05:49,1302367,560313,510075,231979,1302367
2023-05-03 05:50,1302388,560334,510075,231979,1302388
2023-05-03 05:51,1302411,560357,510075,231979,1302411
2023-05-03 05:52,1302435,560381,510075,231979,1302435
2023-05-03 05:53,1302457,560403,510075,231979,1302457
2023-05-03 05:54,1302480,560426,510075,231979,1302480
2023-05-03 05:55,1302503,560449,510075,231979,1302503
2023-05-03 05:56,1302527,560473,510075,231979,1302527
2023-05-03 05:57,1302550,560493,510078,231979,1302550
2023-05-03 05:58,1302573,560516,510078,231979,1302573
2023-05-03 05:59,1302595,560538,510078,231979,1302595
2023-05-03 06:00,1302615,560558,510078,231979,1302615
2023-05-03 06:01,1302629,560571,510078,231980,1302629
2023-05-03 06:02,1302644,560586,510078,231980,1302644
2023-05-03 06:03,1302658,560599,510078,231981,1302658
2023-05-03 06:04,1302673,560614,510078,231981,1302673
2023-05-03 06:05,1302688,560629,510078,231981,1302688
2023-05-03 06:06,1302702,560640,510081,231981,1302702
2023-05-03 06:07,1302716,560654,510081,231981,1302716
2023-05-03 06:08,1302730,560668,510081,231981,1302730
2023-05-03 06:09,1302745,560682,510081,231982,1302745
2023-05-03 06:10,1302759,560696,510081,231982,1302759
2023-05-03 06:11,1302773,560710,510081,231982,1302773
2023-05-03 06:12,1302789,560726,510081,231982,1302789
2023-05-03 06:13,1302803,560740,510081,231982,1302803
2023-05-03 06:14,1302817,560754,510081,231982,1302817
2023-05-03 06:15,1302831,560768,510081,231982,1302831
2023-05-03 06:16,1302847,560781,510084,231982,1302847
2023-05-03 06:17,1302861,560795,510084,231982,1302861
2023-05-03 06:18,1302875,560809,510084,231982,1302875
2023-05-03 06:19,1302890,560824,510084,231982,1302890
2023-05-03 06:21,1302904,560838,510084,231982,1302904
2023-05-03 06:22,1302919,560853,510084,231982,1302919
2023-05-03 06:23,1302933,560866,510084,231983,1302933
2023-05-03 06:24,1302948,560881,510084,231983,1302948
2023-05-03 06:25,1302962,560895,510084,231983,1302962
2023-05-03 06:26,1302977,560909,510084,231984,1302977
2023-05-03 06:27,1302991,560920,510087,231984,1302991
2023-05-03 06:28,1303006,560934,510087,231985,1303006
2023-05-03 06:29,1303020,560948,510087,231985,1303020
2023-05-03 06:30,1303035,560962,510087,231986,1303035
2023-05-03 06:31,1303049,560976,510087,231986,1303049
2023-05-03 06:32,1303063,560990,510087,231986,1303063
2023-05-03 06:33,1303078,561005,510087,231986,1303078
2023-05-03 06:34,1303093,561020,510087,231986,1303093
2023-05-03 06:35,1303107,561033,510087,231987,1303107
2023-05-03 06:36,1303123,561049,510087,231987,1303123
2023-05-03 06:37,1303137,561060,510090,231987,1303137
2023-05-03 06:38,1303151,561074,510090,231987,1303151
2023-05-03 06:39,1303165,561088,510090,231987,1303165
2023-05-03 06:40,1303180,561103,510090,231987,1303180
2023-05-03 06:41,1303195,561118,510090,231987,1303195
2023-05-03 06:42,1303209,561132,510090,231987,1303209
2023-05-03 06:43,1303223,561146,510090,231987,1303223
2023-05-03 06:44,1303237,561160,510090,231987,1303237
2023-05-03 06:45,1303252,561175,510090,231987,1303252
2023-05-03 06:46,1303267,561190,510090,231987,1303267
2023-05-03 06:47,1303282,561203,510091,231988,1303282
2023-05-03 06:48,1303296,561217,510091,231988,1303296
2023-05-03 06:49,1303311,561231,510091,231989,1303311
2023-05-03 06:50,1303324,561244,510091,231989,1303324
2023-05-03 06:51,1303340,561259,510091,231990,1303340
2023-05-03 06:52,1303355,561274,510091,231990,1303355
2023-05-03 06:53,1303370,561288,510091,231991,1303370
2023-05-03 06:54,1303385,561303,510091,231991,1303385
2023-05-03 06:55,1303399,561317,510091,231991,1303399
2023-05-03 06:56,1303413,561325,510097,231991,1303413
2023-05-03 06:57,1303428,561340,510097,231991,1303428
2023-05-03 06:58,1303443,561355,510097,231991,1303443
2023-05-03 06:59,1303457,561369,510097,231991,1303457
2023-05-03 07:00,1303474,561386,510097,231991,1303474
2023-05-03 07:01,1303490,561402,510097,231991,1303490
2023-05-03 07:02,1303509,561421,510097,231991,1303509
2023-05-03 07:03,1303526,561437,510097,231992,1303526
2023-05-03 07:04,1303543,561454,510097,231992,1303543
2023-05-03 07:05,1303562,561472,510097,231993,1303562
2023-05-03 07:06,1303579,561483,510101,231995,1303579
2023-05-03 07:07,1303597,561501,510101,231995,1303597
2023-05-03 07:09,1303613,561515,510102,231996,1303613
2023-05-03 07:10,1303631,561533,510102,231996,1303631
2023-05-03 07:11,1303648,561550,510102,231996,1303648
2023-05-03 07:12,1303666,561568,510102,231996,1303666
2023-05-03 07:13,1303683,561583,510103,231997,1303683
2023-05-03 07:14,1303700,561600,510103,231997,1303700
2023-05-03 07:15,1303717,561616,510104,231997,1303717
2023-05-03 07:16,1303736,561635,510104,231997,1303736
2023-05-03 07:17,1303753,561650,510105,231998,1303753
2023-05-03 07:18,1303770,561667,510105,231998,1303770
2023-05-03 07:19,1303787,561683,510106,231998,1303787
2023-05-03 07:20,1303804,561699,510106,231999,1303804
2023-05-03 07:21,1303822,561717,510106,231999,1303822
2023-05-03 07:22,1303839,561734,510106,231999,1303839
2023-05-03 07:23,1303857,561748,510108,232001,1303857
2023-05-03 07:24,1303874,561765,510108,232001,1303874
2023-05-03 07:25,1303891,561782,510108,232001,1303891
2023-05-03 07:26,1303908,561798,510108,232002,1303908
2023-05-03 07:27,1303926,561814,510109,232003,1303926
2023-05-03 07:28,1303944,561831,510109,232004,1303944
2023-05-03 07:29,1303961,561848,510109,232004,1303961
2023-05-03 07:30,1303979,561866,510109,232004,1303979
2023-05-03 07:31,1303997,561881,510111,232005,1303997
2023-05-03 07:32,1304013,561897,510111,232005,1304013
2023-05-03 07:33,1304031,561912,510113,232006,1304031
2023-05-03 07:34,1304048,561928,510113,232007,1304048
2023-05-03 07:35,1304065,561943,510113,232009,1304065
2023-05-03 07:36,1304082,561960,510113,232009,1304082
2023-05-03 07:37,1304100,561977,510113,232010,1304100
2023-05-03 07:38,1304119,561996,510113,232010,1304119
2023-05-03 07:39,1304137,562012,510114,232011,1304137
2023-05-03 07:40,1304155,562030,510114,232011,1304155
2023-05-03 07:41,1304171,562044,510116,232011,1304171
2023-05-03 07:42,1304188,562060,510116,232012,1304188
2023-05-03 07:43,1304206,562076,510117,232013,1304206
2023-05-03 07:44,1304224,562094,510117,232013,1304224
2023-05-03 07:45,1304241,562110,510117,232014,1304241
2023-05-03 07:46,1304258,562127,510117,232014,1304258
2023-05-03 07:47,1304276,562143,510118,232015,1304276
2023-05-03 07:48,1304293,562160,510118,232015,1304293
2023-05-03 07:49,1304310,562175,510120,232015,1304310
2023-05-03 07:50,1304329,562194,510120,232015,1304329
2023-05-03 07:51,1304345,562206,510124,232015,1304345
2023-05-03 07:52,1304362,562222,510124,232016,1304362
2023-05-03 07:53,1304380,562240,510124,232016,1304380
2023-05-03 07:54,1304397,562257,510124,232016,1304397
2023-05-03 07:56,1304415,562273,510127,232015,1304415
2023-05-03 07:57,1304433,562289,510127,232017,1304433
2023-05-03 07:58,1304449,562305,510127,232017,1304449
2023-05-03 07:59,1304467,562323,510127,232017,1304467
2023-05-03 08:00,1304484,562340,510127,232017,1304484
2023-05-03 08:01,1304497,562351,510127,232019,1304497
2023-05-03 08:02,1304510,562362,510128,232020,1304510
2023-05-03 08:03,1304523,562374,510128,232021,1304523
2023-05-03 08:04,1304537,562386,510129,232022,1304537
2023-05-03 08:05,1304550,562398,510129,232023,1304550
2023-05-03 08:06,1304563,562409,510131,232023,1304563
2023-05-03 08:07,1304576,562422,510131,232023,1304576
2023-05-03 08:08,1304590,562436,510131,232023,1304590
2023-05-03 08:09,1304603,562447,510131,232025,1304603
2023-05-03 08:10,1304616,562459,510132,232025,1304616
2023-05-03 08:11,1304630,562472,510132,232026,1304630
2023-05-03 08:12,1304642,562483,510133,232026,1304642
2023-05-03 08:13,1304655,562496,510133,232026,1304655
2023-05-03 08:14,1304669,562508,510134,232027,1304669
2023-05-03 08:15,1304682,562521,510134,232027,1304682
2023-05-03 08:16,1304695,562534,510134,232027,1304695
2023-05-03 08:17,1304708,562547,510134,232027,1304708
2023-05-03 08:18,1304721,562559,510134,232028,1304721
2023-05-03 08:19,1304734,562572,510134,232028,1304734
2023-05-03 08:20,1304748,562585,510134,232029,1304748
2023-05-03 08:21,1304761,562596,510134,232031,1304761
2023-05-03 08:22,1304775,562607,510136,232032,1304775
2023-05-03 08:23,1304788,562620,510136,232032,1304788
2023-05-03 08:24,1304801,562631,510138,232032,1304801
2023-05-03 08:25,1304814,562644,510138,232032,1304814
2023-05-03 08:26,1304827,562656,510139,232032,1304827
2023-05-03 08:27,1304841,562669,510139,232033,1304841
2023-05-03 08:28,1304854,562682,510139,232033,1304854
2023-05-03 08:29,1304866,562694,510139,232033,1304866
2023-05-03 08:30,1304880,562706,510141,232033,1304880
2023-05-03 08:31,1304892,562718,510141,232033,1304892
2023-05-03 08:32,1304907,562731,510143,232033,1304907
2023-05-03 08:33,1304920,562743,510143,232034,1304920
2023-05-03 08:34,1304933,562753,510146,232034,1304933
2023-05-03 08:35,1304946,562766,510146,232034,1304946
2023-05-03 08:36,1304960,562778,510146,232036,1304960
2023-05-03 08:37,1304973,562791,510146,232036,1304973
2023-05-03 08:38,1304986,562802,510147,232037,1304986
2023-05-03 08:39,1305000,562816,510147,232037,1305000
2023-05-03 08:40,1305013,562824,510152,232037,1305013
2023-05-03 08:41,1305026,562837,510152,232037,1305026
2023-05-03 08:42,1305040,562850,510153,232037,1305040
2023-05-03 08:44,1305052,562861,510153,232038,1305052
2023-05-03 08:45,1305066,562873,510153,232040,1305066
2023-05-03 08:46,1305078,562885,510153,232040,1305078
2023-05-03 08:47,1305092,562898,510154,232040,1305092
2023-05-03 08:48,1305105,562911,510154,232040,1305105
2023-05-03 08:49,1305118,562919,510159,232040,1305118
2023-05-03 08:50,1305131,562931,510159,232041,1305131
2023-05-03 08:51,1305144,562944,510158,232042,1305144
2023-05-03 08:52,1305157,562955,510158,232044,1305157
2023-05-03 08:53,1305171,562967,510159,232045,1305171
2023-05-03 08:54,1305184,562980,510159,232045,1305184
2023-05-03 08:55,1305197,562990,510159,232048,1305197
2023-05-03 08:56,1305210,563000,510159,232051,1305210
2023-05-03 08:57,1305223,563011,510160,232052,1305223
2023-05-03 08:58,1305236,563024,510160,232052,1305236
2023-05-03 08:59,1305249,563035,510161,232053,1305249
2023-05-03 09:00,1305262,563047,510161,232054,1305262
2023-05-03 09:01,1305276,563058,510163,232055,1305276
2023-05-03 09:02,1305290,563071,510163,232056,1305290
2023-05-03 09:03,1305303,563080,510166,232057,1305303
2023-05-03 09:04,1305316,563093,510166,232057,1305316
2023-05-03 09:05,1305330,563103,510169,232058,1305330
2023-05-03 09:06,1305344,563114,510169,232061,1305344
2023-05-03 09:07,1305357,563121,510173,232063,1305357
2023-05-03 09:08,1305371,563135,510173,232063,1305371
2023-05-03 09:09,1305385,563146,510175,232064,1305385
2023-05-03 09:10,1305398,563155,510178,232065,1305398
2023-05-03 09:11,1305411,563166,510178,232067,1305411
2023-05-03 09:12,1305425,563180,510178,232067,1305425
2023-05-03 09:13,1305438,563192,510178,232068,1305438
2023-05-03 09:14,1305452,563203,510181,232068,1305452
2023-05-03 09:15,1305465,563216,510181,232068,1305465
2023-05-03 09:16,1305478,563227,510182,232069,1305478
2023-05-03 09:17,1305492,563237,510185,232070,1305492
2023-05-03 09:18,1305505,563249,510185,232071,1305505
2023-05-03 09:19,1305518,563261,510186,232071,1305518
2023-05-03 09:20,1305532,563274,510186,232072,1305532
2023-05-03 09:21,1305545,563285,510188,232072,1305545
2023-05-03 09:22,1305559,563296,510188,232075,1305559
2023-05-03 09:23,1305572,563304,510192,232076,1305572
2023-05-03 09:24,1305585,563314,510192,232079,1305585
2023-05-03 09:25,1305598,563323,510195,232080,1305598
2023-05-03 09:26,1305612,563337,510195,232080,1305612
2023-05-03 09:27,1305626,563350,510196,232080,1305626
2023-05-03 09:28,1305641,563364,510196,232081,1305641
2023-05-03 09:29,1305654,563375,510197,232082,1305654
2023-05-03 09:30,1305667,563388,510197,232082,1305667
2023-05-03 09:32,1305681,563399,510200,232082,1305681
2023-05-03 09:33,1305694,563411,510200,232083,1305694
2023-05-03 09:34,1305707,563421,510203,232083,1305707
2023-05-03 09:35,1305721,563435,510203,232083,1305721
2023-05-03 09:36,1305734,563447,510204,232083,1305734
2023-05-03 09:37,1305748,563461,510204,232083,1305748
2023-05-03 09:38,1305761,563470,510207,232084,1305761
2023-05-03 09:39,1305775,563484,510207,232084,1305775
2023-05-03 09:40,1305789,563496,510208,232085,1305789
2023-05-03 09:41,1305802,563508,510208,232086,1305802
2023-05-03 09:42,1305816,563517,510211,232088,1305816
2023-05-03 09:43,1305829,563529,510211,232089,1305829
2023-05-03 09:44,1305843,563541,510212,232090,1305843
2023-05-03 09:45,1305856,563553,510212,232091,1305856
2023-05-03 09:46,1305870,563563,510215,232092,1305870
2023-05-03 09:47,1305883,563576,510215,232092,1305883
2023-05-03 09:48,1305896,563587,510216,232093,1305896
2023-05-03 09:49,1305911,563602,510216,232093,1305911
2023-05-03 09:50,1305924,563612,510219,232093,1305924
2023-05-03 09:51,1305938,563623,510221,232094,1305938
2023-05-03 09:52,1305952,563637,510221,232094,1305952
2023-05-03 09:53,1305965,563646,510224,232095,1305965
2023-05-03 09:54,1305978,563658,510224,232096,1305978
2023-05-03 09:55,1305992,563670,510226,232096,1305992
2023-05-03 09:56,1306005,563683,510226,232096,1306005
2023-05-03 09:57,1306018,563689,510231,232098,1306018
2023-05-03 09:58,1306032,563703,510231,232098,1306032
2023-05-03 09:59,1306045,563712,510235,232098,1306045
2023-05-03 10:00,1306061,563727,510235,232099,1306061
2023-05-03 10:01,1306078,563741,510236,232101,1306078
2023-05-03 10:02,1306094,563756,510236,232102,1306094
2023-05-03 10:03,1306110,563767,510239,232104,1306110
2023-05-03 10:04,1306128,563784,510239,232105,1306128
2023-05-03 10:05,1306144,563799,510240,232105,1306144
2023-05-03 10:06,1306161,563814,510240,232107,1306161
2023-05-03 10:07,1306178,563830,510241,232107,1306178
2023-05-03 10:08,1306195,563846,510241,232108,1306195
2023-05-03 10:09,1306212,563861,510242,232109,1306212
2023-05-03 10:10,1306229,563877,510242,232110,1306229
2023-05-03 10:11,1306246,563891,510244,232111,1306246
2023-05-03 10:12,1306262,563907,510244,232111,1306262
2023-05-03 10:13,1306279,563924,510244,232111,1306279
2023-05-03 10:14,1306296,563941,510244,232111,1306296
2023-05-03 10:15,1306313,563954,510247,232112,1306313
2023-05-03 10:16,1306330,563969,510248,232113,1306330
2023-05-03 10:17,1306346,563984,510248,232114,1306346
2023-05-03 10:18,1306363,563998,510249,232116,1306363
2023-05-03 10:20,1306381,564015,510249,232117,1306381
2023-05-03 10:21,1306398,564028,510252,232118,1306398
2023-05-03 10:22,1306414,564043,510252,232119,1306414
2023-05-03 10:23,1306432,564058,510252,232122,1306432
2023-05-03 10:24,1306449,564074,510253,232122,1306449
2023-05-03 10:25,1306466,564091,510253,232122,1306466
2023-05-03 10:26,1306484,564104,510257,232123,1306484
2023-05-03 10:27,1306500,564119,510257,232124,1306500
2023-05-03 10:28,1306518,564134,510258,232126,1306518
2023-05-03 10:29,1306534,564150,510258,232126,1306534
2023-05-03 10:30,1306550,564160,510261,232129,1306550
2023-05-03 10:31,1306568,564177,510261,232130,1306568
2023-05-03 10:32,1306585,564189,510264,232132,1306585
2023-05-03 10:33,1306602,564205,510264,232133,1306602
2023-05-03 10:34,1306619,564219,510264,232136,1306619
2023-05-03 10:35,1306636,564234,510264,232138,1306636
2023-05-03 10:36,1306652,564249,510264,232139,1306652
2023-05-03 10:37,1306669,564266,510264,232139,1306669
2023-05-03 10:38,1306687,564282,510265,232140,1306687
2023-05-03 10:39,1306703,564296,510265,232142,1306703
2023-05-03 10:40,1306720,564312,510266,232142,1306720
2023-05-03 10:41,1306737,564329,510266,232142,1306737
2023-05-03 10:42,1306753,564340,510270,232143,1306753
2023-05-03 10:43,1306770,564357,510270,232143,1306770
2023-05-03 10:44,1306788,564374,510270,232144,1306788
2023-05-03 10:45,1306806,564392,510270,232144,1306806
2023-05-03 10:46,1306823,564401,510278,232144,1306823
2023-05-03 10:47,1306839,564417,510278,232144,1306839
2023-05-03 10:48,1306856,564431,510280,232145,1306856
2023-05-03 10:49,1306873,564445,510281,232147,1306873
2023-05-03 10:50,1306890,564462,510281,232147,1306890
2023-05-03 10:51,1306906,564473,510286,232147,1306906
2023-05-03 10:52,1306924,564490,510286,232148,1306924
2023-05-03 10:53,1306943,564506,510287,232150,1306943
2023-05-03 10:54,1306960,564520,510287,232153,1306960
2023-05-03 10:55,1306977,564534,510288,232155,1306977
2023-05-03 10:56,1306993,564549,510288,232156,1306993
2023-05-03 10:57,1307011,564564,510291,232156,1307011
2023-05-03 10:58,1307030,564583,510291,232156,1307030
2023-05-03 10:59,1307046,564599,510290,232157,1307046
2023-05-03 11:00,1307071,564623,510290,232158,1307071
2023-05-03 11:01,1307095,564643,510293,232159,1307095
2023-05-03 11:02,1307122,564665,510293,232164,1307122
2023-05-03 11:03,1307148,564688,510296,232164,1307148
2023-05-03 11:04,1307174,564712,510296,232166,1307174
2023-05-03 11:05,1307199,564730,510301,232168,1307199
2023-05-03 11:07,1307227,564754,510301,232172,1307227
2023-05-03 11:08,1307253,564776,510303,232174,1307253
2023-05-03 11:09,1307280,564798,510305,232177,1307280
2023-05-03 11:10,1307306,564823,510305,232178,1307306
2023-05-03 11:11,1307332,564845,510307,232180,1307332
2023-05-03 11:12,1307357,564868,510307,232182,1307357
2023-05-03 11:13,1307384,564889,510309,232186,1307384
2023-05-03 11:14,1307411,564915,510309,232187,1307411
2023-05-03 11:15,1307438,564940,510311,232187,1307438
2023-05-03 11:16,1307463,564965,510311,232187,1307463
2023-05-03 11:17,1307490,564988,510314,232188,1307490
2023-05-03 11:18,1307516,565011,510314,232191,1307516
2023-05-03 11:19,1307541,565036,510314,232191,1307541
2023-05-03 11:20,1307570,565061,510315,232194,1307570
2023-05-03 11:21,1307596,565086,510315,232195,1307596
2023-05-03 11:22,1307622,565110,510316,232196,1307622
2023-05-03 11:23,1307649,565137,510316,232196,1307649
2023-05-03 11:24,1307673,565160,510316,232197,1307673
2023-05-03 11:25,1307701,565185,510319,232197,1307701
2023-05-03 11:26,1307726,565209,510319,232198,1307726
2023-05-03 11:27,1307754,565231,510324,232199,1307754
2023-05-03 11:28,1307779,565256,510324,232199,1307779
2023-05-03 11:29,1307805,565278,510328,232199,1307805
2023-05-03 11:30,1307831,565300,510331,232200,1307831
2023-05-03 11:31,1307857,565324,510331,232202,1307857
2023-05-03 11:32,1307883,565344,510335,232204,1307883
2023-05-03 11:33,1307909,565369,510335,232205,1307909
2023-05-03 11:34,1307936,565392,510339,232205,1307936
2023-05-03 11:35,1307963,565417,510341,232205,1307963
2023-05-03 11:36,1307989,565441,510341,232207,1307989
2023-05-03 11:37,1308014,565459,510344,232211,1308014
2023-05-03 11:38,1308040,565483,510344,232213,1308040
2023-05-03 11:39,1308067,565505,510348,232214,1308067
2023-05-03 11:40,1308095,565531,510348,232216,1308095
2023-05-03 11:41,1308121,565555,510349,232217,1308121
2023-05-03 11:42,1308147,565580,510350,232217,1308147
2023-05-03 11:43,1308174,565606,510350,232218,1308174
2023-05-03 11:44,1308199,565628,510352,232219,1308199
2023-05-03 11:45,1308226,565653,510352,232221,1308226
2023-05-03 11:46,1308252,565673,510355,232224,1308252
2023-05-03 11:47,1308278,565699,510355,232224,1308278
2023-05-03 11:48,1308303,565724,510355,232224,1308303
2023-05-03 11:49,1308332,565753,510355,232224,1308332
2023-05-03 11:50,1308356,565775,510355,232226,1308356
2023-05-03 11:51,1308383,565802,510355,232226,1308383
2023-05-03 11:52,1308408,565826,510355,232227,1308408
2023-05-03 11:54,1308436,565853,510355,232228,1308436
2023-05-03 11:55,1308461,565859,510374,232228,1308461
2023-05-03 11:56,1308486,565882,510374,232230,1308486
2023-05-03 11:57,1308513,565901,510378,232234,1308513
2023-05-03 11:58,1308539,565922,510381,232236,1308539
2023-05-03 11:59,1308565,565947,510381,232237,1308565
2023-05-03 12:00,1308590,565970,510381,232239,1308590
2023-05-03 12:01,1308606,565977,510388,232241,1308606
2023-05-03 12:02,1308622,565992,510388,232242,1308622
2023-05-03 12:03,1308639,566006,510390,232243,1308639
2023-05-03 12:04,1308655,566019,510390,232246,1308655
2023-05-03 12:05,1308670,566029,510395,232246,1308670
2023-05-03 12:06,1308687,566045,510395,232247,1308687
2023-05-03 12:07,1308703,566058,510398,232247,1308703
2023-05-03 12:08,1308720,566073,510399,232248,1308720
2023-05-03 12:09,1308737,566084,510401,232252,1308737
2023-05-03 12:10,1308753,566100,510401,232252,1308753
2023-05-03 12:11,1308769,566114,510403,232252,1308769
2023-05-03 12:12,1308785,566127,510403,232255,1308785
2023-05-03 12:13,1308801,566141,510406,232254,1308801
2023-05-03 12:14,1308817,566156,510406,232255,1308817
2023-05-03 12:15,1308835,566172,510407,232256,1308835
2023-05-03 12:16,1308850,566185,510407,232258,1308850
2023-05-03 12:17,1308867,566198,510410,232259,1308867
2023-05-03 12:18,1308883,566211,510410,232262,1308883
2023-05-03 12:19,1308900,566222,510415,232263,1308900
2023-05-03 12:20,1308915,566236,510415,232264,1308915
2023-05-03 12:21,1308930,566242,510422,232266,1308930
2023-05-03 12:22,1308947,566258,510422,232267,1308947
2023-05-03 12:23,1308963,566268,510426,232269,1308963
2023-05-03 12:24,1308979,566282,510427,232270,1308979
2023-05-03 12:25,1308995,566296,510427,232272,1308995
2023-05-03 12:26,1309011,566307,510431,232273,1309011
2023-05-03 12:27,1309027,566322,510431,232274,1309027
2023-05-03 12:28,1309043,566335,510433,232275,1309043
2023-05-03 12:29,1309058,566350,510433,232275,1309058
2023-05-03 12:30,1309075,566364,510435,232276,1309075
2023-05-03 12:31,1309090,566378,510435,232277,1309090
2023-05-03 12:32,1309107,566393,510436,232278,1309107
2023-05-03 12:33,1309123,566409,510436,232278,1309123
2023-05-03 12:34,1309138,566424,510436,232278,1309138
2023-05-03 12:35,1309154,566436,510436,232282,1309154
2023-05-03 12:36,1309170,566449,510436,232285,1309170
2023-05-03 12:37,1309186,566465,510436,232285,1309186
2023-05-03 12:38,1309202,566465,510447,232290,1309202
2023-05-03 12:40,1309218,566480,510447,232291,1309218
2023-05-03 12:41,1309233,566493,510447,232293,1309233
2023-05-03 12:42,1309252,566512,510447,232293,1309252
2023-05-03 12:43,1309268,566523,510449,232296,1309268
2023-05-03 12:44,1309283,566536,510449,232298,1309283
2023-05-03 12:45,1309298,566542,510455,232301,1309298
2023-05-03 12:46,1309316,566560,510455,232301,1309316
2023-05-03 12:47,1309332,566575,510455,232302,1309332
2023-05-03 12:48,1309348,566589,510455,232304,1309348
2023-05-03 12:49,1309366,566606,510454,232306,1309366
2023-05-03 12:50,1309382,566622,510454,232306,1309382
2023-05-03 12:51,1309397,566634,510456,232307,1309397
2023-05-03 12:52,1309415,566652,510456,232307,1309415
2023-05-03 12:53,1309430,566664,510458,232308,1309430
2023-05-03 12:54,1309446,566679,510458,232309,1309446
2023-05-03 12:55,1309462,566690,510461,232311,1309462
2023-05-03 12:56,1309479,566703,510461,232315,1309479
2023-05-03 12:57,1309494,566714,510463,232317,1309494
2023-05-03 12:58,1309511,566729,510463,232319,1309511
2023-05-03 12:59,1309527,566737,510469,232321,1309527
2023-05-03 13:00,1309548,566758,510469,232321,1309548
2023-05-03 13:01,1309573,566777,510472,232324,1309573
2023-05-03 13:02,1309600,566803,510472,232325,1309600
2023-05-03 13:03,1309624,566826,510473,232325,1309624
2023-05-03 13:04,1309651,566852,510473,232326,1309651
2023-05-03 13:05,1309678,566877,510475,232326,1309678
2023-05-03 13:06,1309704,566903,510475,232326,1309704
2023-05-03 13:07,1309728,566923,510478,232327,1309728
2023-05-03 13:08,1309755,566948,510478,232329,1309755
2023-05-03 13:09,1309781,566970,510479,232332,1309781
2023-05-03 13:10,1309807,566992,510479,232336,1309807
2023-05-03 13:11,1309831,567012,510483,232336,1309831
2023-05-03 13:12,1309857,567033,510483,232341,1309857
2023-05-03 13:13,1309883,567054,510487,232342,1309883
2023-05-03 13:14,1309908,567075,510490,232343,1309908
2023-05-03 13:15,1309934,567098,510490,232346,1309934
2023-05-03 13:16,1309960,567118,510493,232349,1309960
2023-05-03 13:17,1309986,567141,510493,232352,1309986
2023-05-03 13:18,1310012,567165,510495,232352,1310012
2023-05-03 13:19,1310039,567188,510495,232356,1310039
2023-05-03 13:20,1310065,567208,510499,232358,1310065
2023-05-03 13:21,1310091,567231,510502,232358,1310091
2023-05-03 13:22,1310117,567256,510502,232359,1310117
2023-05-03 13:23,1310143,567279,510505,232359,1310143
2023-05-03 13:24,1310170,567306,510505,232359,1310170
2023-05-03 13:25,1310193,567327,510505,232361,1310193
2023-05-03 13:26,1310219,567349,510505,232365,1310219
2023-05-03 13:28,1310246,567373,510507,232366,1310246
2023-05-03 13:29,1310270,567395,510507,232368,1310270
2023-05-03 13:30,1310296,567420,510507,232369,1310296
2023-05-03 13:31,1310322,567443,510507,232372,1310322
2023-05-03 13:32,1310347,567463,510511,232373,1310347
2023-05-03 13:33,1310372,567487,510511,232374,1310372
2023-05-03 13:34,1310399,567508,510514,232377,1310399
2023-05-03 13:35,1310425,567527,510516,232382,1310425
2023-05-03 13:36,1310452,567550,510518,232384,1310452
2023-05-03 13:37,1310477,567571,510519,232387,1310477
2023-05-03 13:38,1310502,567595,510519,232388,1310502
2023-05-03 13:39,1310529,567618,510522,232389,1310529
2023-05-03 13:40,1310554,567640,510522,232392,1310554
2023-05-03 13:41,1310581,567664,510525,232392,1310581
2023-05-03 13:42,1310606,567688,510525,232393,1310606
2023-05-03 13:43,1310631,567709,510528,232394,1310631
2023-05-03 13:44,1310658,567734,510530,232394,1310658
2023-05-03 13:45,1310683,567759,510530,232394,1310683
2023-05-03 13:46,1310708,567777,510535,232396,1310708
2023-05-03 13:47,1310735,567804,510535,232396,1310735
2023-05-03 13:48,1310762,567829,510537,232396,1310762
2023-05-03 13:49,1310789,567856,510537,232396,1310789
2023-05-03 13:50,1310814,567877,510541,232396,1310814
2023-05-03 13:51,1310839,567901,510541,232397,1310839
2023-05-03 13:52,1310866,567923,510545,232398,1310866
2023-05-03 13:53,1310892,567949,510545,232398,1310892
2023-05-03 13:54,1310916,567973,510545,232398,1310916
2023-05-03 13:55,1310944,567996,510550,232398,1310944
2023-05-03 13:56,1310968,568015,510555,232398,1310968
2023-05-03 13:57,1310994,568041,510555,232398,1310994
2023-05-03 13:58,1311020,568061,510560,232399,1311020
2023-05-03 13:59,1311045,568084,510560,232401,1311045
2023-05-03 14:00,1311068,568104,510561,232403,1311068
2023-05-03 14:01,1311086,568120,510561,232405,1311086
2023-05-03 14:02,1311104,568134,510564,232406,1311104
2023-05-03 14:03,1311122,568151,510564,232407,1311122
2023-05-03 14:04,1311141,568168,510566,232407,1311141
2023-05-03 14:05,1311158,568182,510567,232409,1311158
2023-05-03 14:06,1311178,568200,510567,232411,1311178
2023-05-03 14:07,1311195,568212,510570,232413,1311195
2023-05-03 14:08,1311214,568226,510574,232414,1311214
2023-05-03 14:09,1311232,568241,510574,232417,1311232
2023-05-03 14:10,1311250,568255,510576,232419,1311250
2023-05-03 14:11,1311269,568272,510576,232421,1311269
2023-05-03 14:12,1311287,568284,510580,232423,1311287
2023-05-03 14:13,1311306,568302,510580,232424,1311306
2023-05-03 14:14,1311326,568322,510580,232424,1311326
2023-05-03 14:16,1311344,568338,510580,232426,1311344
2023-05-03 14:17,1311362,568355,510581,232426,1311362
2023-05-03 14:18,1311381,568374,510581,232426,1311381
2023-05-03 14:19,1311398,568387,510585,232426,1311398
2023-05-03 14:20,1311417,568405,510585,232427,1311417
2023-05-03 14:21,1311435,568422,510586,232427,1311435
2023-05-03 14:22,1311454,568440,510586,232428,1311454
2023-05-03 14:23,1311471,568453,510590,232428,1311471
2023-05-03 14:24,1311489,568470,510591,232428,1311489
2023-05-03 14:25,1311508,568486,510591,232431,1311508
2023-05-03 14:26,1311526,568497,510595,232434,1311526
2023-05-03 14:27,1311544,568513,510595,232436,1311544
2023-05-03 14:28,1311562,568528,510596,232438,1311562
2023-05-03 14:29,1311584,568548,510598,232438,1311584
2023-05-03 14:30,1311602,568566,510598,232438,1311602
2023-05-03 14:31,1311620,568581,510601,232438,1311620
2023-05-03 14:32,1311638,568595,510603,232440,1311638
2023-05-03 14:33,1311655,568612,510603,232440,1311655
2023-05-03 14:34,1311673,568624,510608,232441,1311673
2023-05-03 14:35,1311692,568642,510608,232442,1311692
2023-05-03 14:36,1311711,568657,510610,232444,1311711
2023-05-03 14:37,1311730,568675,510610,232445,1311730
2023-05-03 14:38,1311748,568689,510612,232447,1311748
2023-05-03 14:39,1311766,568706,510613,232447,1311766
2023-05-03 14:40,1311784,568723,510614,232447,1311784
2023-05-03 14:41,1311803,568742,510614,232447,1311803
2023-05-03 14:42,1311821,568755,510617,232449,1311821
2023-05-03 14:43,1311841,568773,510617,232451,1311841
2023-05-03 14:44,1311859,568788,510618,232453,1311859
2023-05-03 14:45,1311878,568807,510618,232453,1311878
2023-05-03 14:46,1311896,568820,510622,232454,1311896
2023-05-03 14:47,1311914,568837,510622,232455,1311914
2023-05-03 14:48,1311933,568853,510624,232456,1311933
2023-05-03 14:49,1311952,568869,510624,232459,1311952
2023-05-03 14:50,1311971,568886,510625,232460,1311971
2023-05-03 14:51,1311989,568903,510625,232461,1311989
2023-05-03 14:52,1312007,568917,510629,232461,1312007
2023-05-03 14:53,1312025,568935,510629,232461,1312025
2023-05-03 14:54,1312043,568951,510630,232462,1312043
2023-05-03 14:55,1312061,568965,510630,232466,1312061
2023-05-03 14:56,1312080,568985,510629,232466,1312080
2023-05-03 14:57,1312098,569003,510629,232466,1312098
2023-05-03 14:58,1312118,569017,510633,232468,1312118
2023-05-03 14:59,1312137,569036,510633,232468,1312137
2023-05-03 15:00,1312151,569047,510636,232468,1312151
2023-05-03 15:01,1312164,569059,510636,232469,1312164
2023-05-03 15:02,1312176,569067,510639,232470,1312176
2023-05-03 15:04,1312190,569078,510639,232473,1312190
2023-05-03 15:05,1312203,569084,510645,232474,1312203
2023-05-03 15:06,1312215,569094,510645,232476,1312215
2023-05-03 15:07,1312230,569106,510647,232477,1312230
2023-05-03 15:08,1312244,569119,510647,232478,1312244
2023-05-03 15:09,1312257,569126,510650,232481,1312257
2023-05-03 15:10,1312270,569139,510650,232481,1312270
2023-05-03 15:11,1312283,569149,510653,232481,1312283
2023-05-03 15:12,1312296,569159,510653,232484,1312296
2023-05-03 15:13,1312311,569169,510656,232486,1312311
2023-05-03 15:14,1312323,569181,510656,232486,1312323
2023-05-03 15:15,1312336,569190,510660,232486,1312336
2023-05-03 15:16,1312349,569200,510662,232487,1312349
2023-05-03 15:17,1312363,569212,510662,232489,1312363
2023-05-03 15:18,1312376,569220,510667,232489,1312376
2023-05-03 15:19,1312388,569231,510668,232489,1312388
2023-05-03 15:20,1312401,569243,510668,232490,1312401
2023-05-03 15:21,1312414,569253,510669,232492,1312414
2023-05-03 15:22,1312427,569263,510671,232493,1312427
2023-05-03 15:23,1312440,569276,510671,232493,1312440
2023-05-03 15:24,1312453,569284,510675,232494,1312453
2023-05-03 15:25,1312466,569294,510675,232497,1312466
2023-05-03 15:26,1312479,569305,510677,232497,1312479
2023-05-03 15:27,1312491,569317,510677,232497,1312491
2023-05-03 15:28,1312505,569327,510681,232497,1312505
2023-05-03 15:29,1312517,569338,510681,232498,1312517
2023-05-03 15:30,1312531,569347,510685,232499,1312531
2023-05-03 15:31,1312544,569359,510685,232500,1312544
2023-05-03 15:32,1312556,569369,510686,232501,1312556
2023-05-03 15:33,1312569,569382,510686,232501,1312569
2023-05-03 15:34,1312583,569392,510690,232501,1312583
2023-05-03 15:35,1312596,569405,510690,232501,1312596
2023-05-03 15:36,1312609,569412,510696,232501,1312609
2023-05-03 15:37,1312622,569425,510696,232501,1312622
2023-05-03 15:38,1312635,569436,510697,232502,1312635
2023-05-03 15:39,1312648,569449,510697,232502,1312648
2023-05-03 15:40,1312661,569459,510700,232502,1312661
2023-05-03 15:41,1312674,569471,510700,232503,1312674
2023-05-03 15:42,1312687,569480,510703,232504,1312687
2023-05-03 15:43,1312700,569492,510703,232505,1312700
2023-05-03 15:44,1312713,569503,510704,232506,1312713
2023-05-03 15:45,1312726,569516,510704,232506,1312726
2023-05-03 15:46,1312739,569528,510704,232507,1312739
2023-05-03 15:47,1312754,569543,510704,232507,1312754
2023-05-03 15:48,1312767,569552,510706,232509,1312767
2023-05-03 15:49,1312780,569565,510706,232509,1312780
2023-05-03 15:51,1312793,569573,510709,232511,1312793
2023-05-03 15:52,1312806,569585,510709,232512,1312806
2023-05-03 15:53,1312819,569595,510712,232512,1312819
2023-05-03 15:54,1312832,569607,510712,232513,1312832
2023-05-03 15:55,1312846,569616,510715,232515,1312846
2023-05-03 15:56,1312861,569628,510715,232518,1312861
2023-05-03 15:57,1312874,569637,510717,232520,1312874
2023-05-03 15:58,1312887,569649,510717,232521,1312887
2023-05-03 15:59,1312900,569661,510717,232522,1312900
2023-05-03 16:00,1312912,569671,510717,232524,1312912
2023-05-03 16:01,1312922,569678,510719,232525,1312922
2023-05-03 16:02,1312933,569688,510720,232525,1312933
2023-05-03 16:03,1312943,569695,510722,232526,1312943
2023-05-03 16:04,1312954,569705,510722,232527,1312954
2023-05-03 16:05,1312964,569711,510723,232530,1312964
2023-05-03 16:06,1312975,569719,510726,232530,1312975
2023-05-03 16:07,1312985,569728,510726,232531,1312985
2023-05-03 16:08,1312996,569737,510727,232532,1312996
2023-05-03 16:09,1313007,569748,510727,232532,1313007
2023-05-03 16:10,1313017,569752,510730,232535,1313017
2023-05-03 16:11,1313028,569761,510730,232537,1313028
2023-05-03 16:12,1313040,569769,510733,232538,1313040
2023-05-03 16:13,1313051,569779,510733,232539,1313051
2023-05-03 16:14,1313061,569786,510736,232539,1313061
2023-05-03 16:15,1313072,569792,510739,232541,1313072
2023-05-03 16:16,1313083,569801,510739,232543,1313083
2023-05-03 16:17,1313094,569807,510743,232544,1313094
2023-05-03 16:18,1313104,569817,510743,232544,1313104
2023-05-03 16:19,1313114,569817,510750,232547,1313114
2023-05-03 16:20,1313125,569827,510750,232548,1313125
2023-05-03 16:21,1313135,569835,510751,232549,1313135
2023-05-03 16:22,1313146,569845,510751,232550,1313146
2023-05-03 16:23,1313156,569854,510752,232550,1313156
2023-05-03 16:24,1313167,569862,510755,232550,1313167
2023-05-03 16:25,1313177,569871,510755,232551,1313177
2023-05-03 16:26,1313187,569880,510755,232552,1313187
2023-05-03 16:27,1313198,569887,510758,232553,1313198
2023-05-03 16:28,1313208,569893,510758,232557,1313208
2023-05-03 16:29,1313219,569901,510760,232558,1313219
2023-05-03 16:30,1313229,569909,510760,232560,1313229
2023-05-03 16:31,1313239,569916,510763,232560,1313239
2023-05-03 16:32,1313250,569925,510765,232560,1313250
2023-05-03 16:33,1313261,569935,510765,232561,1313261
2023-05-03 16:34,1313271,569942,510768,232561,1313271
2023-05-03 16:35,1313283,569954,510768,232561,1313283
2023-05-03 16:36,1313293,569963,510769,232561,1313293
2023-05-03 16:37,1313303,569973,510769,232561,1313303
2023-05-03 16:39,1313314,569980,510773,232561,1313314
2023-05-03 16:40,1313324,569984,510779,232561,1313324
2023-05-03 16:41,1313335,569993,510779,232563,1313335
2023-05-03 16:42,1313346,569996,510786,232564,1313346
2023-05-03 16:43,1313356,570004,510786,232566,1313356
2023-05-03 16:44,1313367,570011,510790,232566,1313367
2023-05-03 16:45,1313377,570021,510790,232566,1313377
2023-05-03 16:46,1313387,570026,510795,232566,1313387
2023-05-03 16:47,1313398,570035,510796,232567,1313398
2023-05-03 16:48,1313408,570042,510796,232570,1313408
2023-05-03 16:49,1313419,570048,510801,232570,1313419
2023-05-03 16:50,1313429,570058,510801,232570,1313429
2023-05-03 16:51,1313439,570066,510803,232570,1313439
2023-05-03 16:52,1313451,570075,510803,232573,1313451
2023-05-03 16:53,1313461,570080,510806,232575,1313461
2023-05-03 16:54,1313472,570090,510806,232576,1313472
2023-05-03 16:55,1313481,570100,510805,232576,1313481
2023-05-03 16:56,1313492,570106,510809,232577,1313492
2023-05-03 16:57,1313503,570116,510810,232577,1313503
2023-05-03 16:58,1313513,570122,510810,232581,1313513
2023-05-03 16:59,1313524,570133,510810,232581,1313524
2023-05-03 17:00,1313542,570148,510813,232581,1313542
2023-05-03 17:01,1313566,570170,510814,232582,1313566
2023-05-03 17:02,1313593,570196,510814,232583,1313593
2023-05-03 17:03,1313620,570216,510817,232587,1313620
2023-05-03 17:04,1313645,570241,510817,232587,1313645
2023-05-03 17:05,1313673,570266,510820,232587,1313673
2023-05-03 17:06,1313699,570292,510820,232587,1313699
2023-05-03 17:07,1313726,570318,510821,232587,1313726
2023-05-03 17:08,1313750,570342,510821,232587,1313750
2023-05-03 17:09,1313777,570367,510823,232587,1313777
2023-05-03 17:10,1313802,570393,510823,232586,1313802
2023-05-03 17:11,1313828,570417,510825,232586,1313828
2023-05-03 17:12,1313854,570443,510825,232586,1313854
2023-05-03 17:13,1313879,570465,510826,232588,1313879
2023-05-03 17:14,1313905,570490,510826,232589,1313905
2023-05-03 17:15,1313933,570513,510829,232591,1313933
2023-05-03 17:16,1313960,570538,510831,232591,1313960
2023-05-03 17:17,1313986,570561,510831,232594,1313986
2023-05-03 17:18,1314011,570580,510837,232594,1314011
2023-05-03 17:19,1314037,570605,510837,232595,1314037
2023-05-03 17:20,1314064,570625,510843,232596,1314064
2023-05-03 17:21,1314090,570651,510843,232596,1314090
2023-05-03 17:22,1314118,570672,510847,232599,1314118
2023-05-03 17:23,1314144,570696,510847,232601,1314144
2023-05-03 17:24,1314171,570722,510848,232601,1314171
2023-05-03 17:26,1314196,570746,510848,232602,1314196
2023-05-03 17:27,1314222,570764,510856,232602,1314222
2023-05-03 17:28,1314247,570784,510859,232604,1314247
2023-05-03 17:29,1314273,570810,510859,232604,1314273
2023-05-03 17:30,1314299,570834,510859,232606,1314299
2023-05-03 17:31,1314326,570861,510859,232606,1314326
2023-05-03 17:32,1314352,570885,510860,232607,1314352
2023-05-03 17:33,1314380,570913,510860,232607,1314380
2023-05-03 17:34,1314404,570932,510864,232608,1314404
2023-05-03 17:35,1314431,570961,510864,232606,1314431
2023-05-03 17:36,1314456,570983,510865,232608,1314456
2023-05-03 17:37,1314483,571009,510865,232609,1314483
2023-05-03 17:38,1314507,571032,510865,232610,1314507
2023-05-03 17:39,1314533,571055,510865,232613,1314533
2023-05-03 17:40,1314561,571082,510865,232614,1314561
2023-05-03 17:41,1314586,571102,510868,232616,1314586
2023-05-03 17:42,1314613,571129,510868,232616,1314613
2023-05-03 17:43,1314637,571144,510875,232618,1314637
2023-05-03 17:44,1314664,571170,510875,232619,1314664
2023-05-03 17:45,1314689,571189,510879,232621,1314689
2023-05-03 17:46,1314715,571213,510879,232623,1314715
2023-05-03 17:47,1314741,571237,510880,232624,1314741
2023-05-03 17:48,1314770,571266,510880,232624,1314770
2023-05-03 17:49,1314797,571289,510883,232625,1314797
2023-05-03 17:50,1314821,571310,510884,232627,1314821
2023-05-03 17:51,1314848,571335,510884,232629,1314848
2023-05-03 17:52,1314874,571356,510888,232630,1314874
2023-05-03 17:53,1314899,571381,510888,232630,1314899
2023-05-03 17:54,1314925,571406,510889,232630,1314925
2023-05-03 17:55,1314952,571432,510889,232631,1314952
2023-05-03 17:56,1314976,571451,510892,232633,1314976
2023-05-03 17:57,1315004,571478,510892,232634,1315004
2023-05-03 17:58,1315029,571502,510892,232635,1315029
2023-05-03 17:59,1315055,571525,510895,232635,1315055
2023-05-03 18:00,1315072,571539,510896,232637,1315072
2023-05-03 18:01,1315085,571551,510896,232638,1315085
2023-05-03 18:02,1315097,571556,510903,232638,1315097
2023-05-03 18:03,1315110,571569,510903,232638,1315110
2023-05-03 18:04,1315123,571581,510903,232639,1315123
2023-05-03 18:05,1315136,571593,510903,232640,1315136
2023-05-03 18:06,1315149,571602,510906,232641,1315149
2023-05-03 18:07,1315164,571614,510906,232644,1315164
2023-05-03 18:08,1315176,571618,510911,232647,1315176
2023-05-03 18:09,1315189,571630,510911,232648,1315189
2023-05-03 18:10,1315202,571641,510913,232648,1315202
2023-05-03 18:11,1315214,571652,510913,232649,1315214
2023-05-03 18:13,1315227,571662,510915,232650,1315227
2023-05-03 18:14,1315240,571675,510915,232650,1315240
2023-05-03 18:15,1315253,571684,510917,232652,1315253
2023-05-03 18:16,1315266,571696,510917,232653,1315266
2023-05-03 18:17,1315279,571704,510920,232655,1315279
2023-05-03 18:18,1315294,571719,510920,232655,1315294
2023-05-03 18:19,1315306,571728,510920,232658,1315306
2023-05-03 18:20,1315320,571742,510920,232658,1315320
2023-05-03 18:21,1315333,571756,510920,232657,1315333
2023-05-03 18:22,1315346,571769,510920,232657,1315346
2023-05-03 18:23,1315360,571782,510920,232658,1315360
2023-05-03 18:24,1315373,571794,510920,232659,1315373
2023-05-03 18:25,1315386,571807,510920,232659,1315386
2023-05-03 18:26,1315399,571820,510920,232659,1315399
2023-05-03 18:27,1315411,571818,510933,232660,1315411
2023-05-03 18:28,1315424,571829,510933,232662,1315424
2023-05-03 18:29,1315437,571841,510933,232663,1315437
2023-05-03 18:30,1315450,571852,510933,232665,1315450
2023-05-03 18:31,1315462,571864,510933,232665,1315462
2023-05-03 18:32,1315475,571876,510933,232666,1315475
2023-05-03 18:33,1315489,571890,510933,232666,1315489
2023-05-03 18:34,1315503,571903,510933,232667,1315503
2023-05-03 18:35,1315516,571916,510933,232667,1315516
2023-05-03 18:36,1315529,571928,510933,232668,1315529
2023-05-03 18:37,1315544,571931,510943,232670,1315544
2023-05-03 18:38,1315557,571943,510943,232671,1315557
2023-05-03 18:39,1315570,571956,510943,232671,1315570
2023-05-03 18:40,1315584,571968,510943,232673,1315584
2023-05-03 18:41,1315596,571981,510943,232672,1315596
2023-05-03 18:42,1315610,571995,510943,232672,1315610
2023-05-03 18:43,1315622,572005,510943,232674,1315622
2023-05-03 18:44,1315635,572017,510943,232675,1315635
2023-05-03 18:45,1315648,572028,510943,232677,1315648
2023-05-03 18:46,1315661,572038,510943,232680,1315661
2023-05-03 18:47,1315675,572038,510957,232680,1315675
2023-05-03 18:48,1315687,572048,510957,232682,1315687
2023-05-03 18:49,1315699,572057,510957,232685,1315699
2023-05-03 18:50,1315712,572069,510957,232686,1315712
2023-05-03 18:51,1315728,572085,510957,232686,1315728
2023-05-03 18:52,1315740,572095,510957,232688,1315740
2023-05-03 18:53,1315753,572107,510957,232689,1315753
2023-05-03 18:54,1315765,572118,510957,232690,1315765
2023-05-03 18:55,1315778,572116,510971,232691,1315778
2023-05-03 18:56,1315792,572129,510971,232692,1315792
2023-05-03 18:57,1315805,572135,510975,232695,1315805
2023-05-03 18:58,1315817,572146,510975,232696,1315817
2023-05-03 18:59,1315831,572153,510980,232698,1315831
2023-05-03 19:01,1315851,572172,510980,232699,1315851
2023-05-03 19:02,1315871,572188,510983,232700,1315871
2023-05-03 19:03,1315892,572209,510983,232700,1315892
2023-05-03 19:04,1315912,572221,510991,232700,1315912
2023-05-03 19:05,1315933,572241,510991,232701,1315933
2023-05-03 19:06,1315953,572261,510992,232700,1315953
2023-05-03 19:07,1315973,572278,510992,232703,1315973
2023-05-03 19:08,1315993,572295,510995,232703,1315993
2023-05-03 19:09,1316015,572317,510995,232703,1316015
2023-05-03 19:10,1316035,572333,510999,232703,1316035
2023-05-03 19:11,1316057,572355,510999,232703,1316057
2023-05-03 19:12,1316078,572373,511002,232703,1316078
2023-05-03 19:13,1316097,572392,511002,232703,1316097
2023-05-03 19:14,1316118,572410,511005,232703,1316118
2023-05-03 19:15,1316138,572430,511005,232703,1316138
2023-05-03 19:16,1316159,572450,511005,232704,1316159
2023-05-03 19:17,1316180,572469,511005,232706,1316180
2023-05-03 19:18,1316201,572489,511005,232707,1316201
2023-05-03 19:19,1316221,572509,511005,232707,1316221
2023-05-03 19:20,1316242,572527,511007,232708,1316242
2023-05-03 19:21,1316262,572546,511007,232709,1316262
2023-05-03 19:22,1316285,572565,511010,232710,1316285
2023-05-03 19:23,1316304,572583,511010,232711,1316304
2023-05-03 19:24,1316324,572602,511011,232711,1316324
2023-05-03 19:25,1316345,572621,511012,232712,1316345
2023-05-03 19:26,1316367,572643,511012,232712,1316367
2023-05-03 19:27,1316387,572656,511017,232714,1316387
2023-05-03 19:28,1316407,572675,511017,232715,1316407
2023-05-03 19:29,1316427,572695,511017,232715,1316427
2023-05-03 19:30,1316449,572716,511017,232716,1316449
2023-05-03 19:31,1316469,572735,511017,232717,1316469
2023-05-03 19:32,1316490,572755,511017,232718,1316490
2023-05-03 19:33,1316511,572773,511017,232721,1316511
2023-05-03 19:34,1316530,572791,511017,232722,1316530
2023-05-03 19:35,1316553,572812,511017,232724,1316553
2023-05-03 19:36,1316574,572822,511028,232724,1316574
2023-05-03 19:37,1316594,572842,511028,232724,1316594
2023-05-03 19:38,1316614,572858,511031,232725,1316614
2023-05-03 19:39,1316635,572878,511031,232726,1316635
2023-05-03 19:40,1316657,572896,511033,232728,1316657
2023-05-03 19:41,1316677,572916,511033,232728,1316677
2023-05-03 19:42,1316698,572934,511035,232729,1316698
2023-05-03 19:43,1316717,572953,511035,232729,1316717
2023-05-03 19:44,1316738,572973,511036,232729,1316738
2023-05-03 19:45,1316758,572993,511036,232729,1316758
2023-05-03 19:46,1316778,573012,511037,232729,1316778
2023-05-03 19:47,1316799,573032,511037,232730,1316799
2023-05-03 19:49,1316820,573050,511039,232731,1316820
2023-05-03 19:50,1316840,573069,511039,232732,1316840
2023-05-03 19:51,1316862,573084,511045,232733,1316862
2023-05-03 19:52,1316881,573102,511045,232734,1316881
2023-05-03 19:53,1316903,573122,511046,232735,1316903
2023-05-03 19:54,1316922,573137,511048,232737,1316922
2023-05-03 19:55,1316944,573159,511048,232737,1316944
2023-05-03 19:56,1316964,573173,511051,232740,1316964
2023-05-03 19:57,1316985,573191,511051,232743,1316985
2023-05-03 19:58,1317006,573204,511060,232742,1317006
2023-05-03 19:59,1317025,573222,511060,232743,1317025
2023-05-03 20:00,1317049,573244,511060,232745,1317049
2023-05-03 20:01,1317083,573275,511060,232748,1317083
2023-05-03 20:02,1317117,573309,511060,232748,1317117
2023-05-03 20:03,1317152,573342,511060,232750,1317152
2023-05-03 20:04,1317185,573373,511060,232752,1317185
2023-05-03 20:05,1317221,573409,511060,232752,1317221
2023-05-03 20:06,1317256,573436,511067,232753,1317256
2023-05-03 20:07,1317289,573469,511067,232753,1317289
2023-05-03 20:08,1317323,573502,511068,232753,1317323
2023-05-03 20:09,1317356,573532,511070,232754,1317356
2023-05-03 20:10,1317392,573567,511070,232755,1317392
2023-05-03 20:11,1317427,573600,511072,232755,1317427
2023-05-03 20:12,1317460,573631,511072,232757,1317460
2023-05-03 20:13,1317495,573662,511075,232758,1317495
2023-05-03 20:14,1317530,573696,511075,232759,1317530
2023-05-03 20:15,1317563,573727,511076,232760,1317563
2023-05-03 20:16,1317597,573759,511077,232761,1317597
2023-05-03 20:17,1317632,573794,511077,232761,1317632
2023-05-03 20:18,1317666,573822,511080,232764,1317666
2023-05-03 20:19,1317701,573854,511080,232767,1317701
2023-05-03 20:20,1317736,573887,511082,232767,1317736
2023-05-03 20:21,1317772,573921,511082,232769,1317772
2023-05-03 20:22,1317806,573954,511082,232770,1317806
2023-05-03 20:23,1317840,573982,511084,232774,1317840
2023-05-03 20:24,1317875,574016,511084,232775,1317875
2023-05-03 20:25,1317910,574048,511085,232777,1317910
2023-05-03 20:26,1317943,574080,511085,232778,1317943
2023-05-03 20:27,1317977,574109,511089,232779,1317977
2023-05-03 20:28,1318013,574146,511089,232778,1318013
2023-05-03 20:29,1318046,574173,511093,232780,1318046
2023-05-03 20:30,1318081,574208,511093,232780,1318081
2023-05-03 20:31,1318117,574240,511095,232782,1318117
2023-05-03 20:32,1318149,574271,511095,232783,1318149
2023-05-03 20:33,1318183,574299,511100,232784,1318183
2023-05-03 20:34,1318219,574335,511100,232784,1318219
2023-05-03 20:35,1318255,574369,511101,232785,1318255
2023-05-03 20:37,1318288,574400,511101,232787,1318288
2023-05-03 20:38,1318324,574435,511102,232787,1318324
2023-05-03 20:39,1318357,574464,511102,232791,1318357
2023-05-03 20:40,1318391,574492,511106,232793,1318391
2023-05-03 20:41,1318428,574524,511111,232793,1318428
2023-05-03 20:42,1318464,574560,511111,232793,1318464
2023-05-03 20:43,1318497,574588,511114,232795,1318497
2023-05-03 20:44,1318532,574621,511114,232797,1318532
2023-05-03 20:45,1318566,574652,511115,232799,1318566
2023-05-03 20:46,1318602,574688,511115,232799,1318602
2023-05-03 20:47,1318637,574720,511117,232800,1318637
2023-05-03 20:48,1318669,574752,511117,232800,1318669
2023-05-03 20:49,1318704,574784,511120,232800,1318704
2023-05-03 20:50,1318738,574815,511120,232803,1318738
2023-05-03 20:51,1318774,574847,511124,232803,1318774
2023-05-03 20:52,1318806,574879,511124,232803,1318806
2023-05-03 20:53,1318842,574911,511128,232803,1318842
2023-05-03 20:54,1318876,574943,511128,232805,1318876
2023-05-03 20:55,1318911,574976,511129,232806,1318911
2023-05-03 20:56,1318947,575012,511129,232806,1318947
2023-05-03 20:57,1318980,575039,511132,232809,1318980
2023-05-03 20:58,1319014,575073,511132,232809,1319014
2023-05-03 20:59,1319048,575102,511136,232810,1319048
2023-05-03 21:00,1319085,575139,511136,232810,1319085
2023-05-03 21:01,1319125,575177,511136,232812,1319125
2023-05-03 21:02,1319165,575217,511136,232812,1319165
2023-05-03 21:03,1319206,575254,511139,232813,1319206
2023-05-03 21:04,1319247,575292,511139,232816,1319247
2023-05-03 21:05,1319290,575332,511140,232818,1319290
2023-05-03 21:06,1319330,575372,511140,232818,1319330
2023-05-03 21:07,1319368,575407,511142,232819,1319368
2023-05-03 21:08,1319411,575450,511142,232819,1319411
2023-05-03 21:09,1319449,575484,511145,232820,1319449
2023-05-03 21:10,1319491,575526,511145,232820,1319491
2023-05-03 21:11,1319530,575564,511146,232820,1319530
2023-05-03 21:12,1319569,575602,511146,232821,1319569
2023-05-03 21:13,1319610,575640,511147,232823,1319610
2023-05-03 21:14,1319652,575682,511147,232823,1319652
2023-05-03 21:15,1319692,575719,511150,232823,1319692
2023-05-03 21:16,1319731,575756,511150,232825,1319731
2023-05-03 21:17,1319774,575796,511152,232826,1319774
2023-05-03 21:18,1319813,575834,511152,232827,1319813
2023-05-03 21:19,1319853,575868,511158,232827,1319853
2023-05-03 21:20,1319893,575906,511158,232829,1319893
2023-05-03 21:21,1319934,575942,511163,232829,1319934
2023-05-03 21:22,1319973,575976,511166,232831,1319973
2023-05-03 21:24,1320015,576017,511166,232832,1320015
2023-05-03 21:25,1320055,576049,511172,232834,1320055
2023-05-03 21:26,1320097,576091,511172,232834,1320097
2023-05-03 21:27,1320135,576124,511175,232836,1320135
2023-05-03 21:28,1320176,576164,511175,232837,1320176
2023-05-03 21:29,1320216,576200,511178,232838,1320216
2023-05-03 21:30,1320257,576239,511178,232840,1320257
2023-05-03 21:31,1320297,576276,511180,232841,1320297
2023-05-03 21:32,1320338,576314,511180,232844,1320338
2023-05-03 21:33,1320380,576351,511185,232844,1320380
2023-05-03 21:34,1320419,576389,511185,232845,1320419
2023-05-03 21:35,1320460,576428,511186,232846,1320460
2023-05-03 21:36,1320499,576467,511186,232846,1320499
2023-05-03 21:37,1320540,576504,511188,232848,1320540
2023-05-03 21:38,1320580,576544,511188,232848,1320580
2023-05-03 21:39,1320621,576573,511198,232850,1320621
2023-05-03 21:40,1320663,576615,511198,232850,1320663
2023-05-03 21:41,1320703,576653,511200,232850,1320703
2023-05-03 21:42,1320744,576693,511200,232851,1320744
2023-05-03 21:43,1320785,576731,511202,232852,1320785
2023-05-03 21:44,1320825,576770,511202,232853,1320825
2023-05-03 21:45,1320864,576809,511202,232853,1320864
2023-05-03 21:46,1320905,576850,511202,232853,1320905
2023-05-03 21:47,1320945,576886,511204,232855,1320945
2023-05-03 21:48,1320987,576927,511204,232856,1320987
2023-05-03 21:49,1321028,576966,511205,232857,1321028
2023-05-03 21:50,1321067,577004,511205,232858,1321067
2023-05-03 21:51,1321108,577040,511208,232860,1321108
2023-05-03 21:52,1321146,577077,511209,232860,1321146
2023-05-03 21:53,1321189,577118,511209,232862,1321189
2023-05-03 21:54,1321229,577151,511216,232862,1321229
2023-05-03 21:55,1321269,577190,511216,232863,1321269
2023-05-03 21:56,1321310,577228,511219,232863,1321310
2023-05-03 21:57,1321350,577267,511219,232864,1321350
2023-05-03 21:58,1321389,577304,511220,232865,1321389
2023-05-03 21:59,1321430,577343,511220,232867,1321430
2023-05-03 22:00,1321450,577360,511222,232868,1321450
2023-05-03 22:01,1321463,577372,511222,232869,1321463
2023-05-03 22:02,1321478,577382,511224,232872,1321478
2023-05-03 22:03,1321492,577394,511224,232874,1321492
2023-05-03 22:04,1321505,577400,511230,232875,1321505
2023-05-03 22:05,1321519,577412,511232,232875,1321519
2023-05-03 22:06,1321532,577425,511232,232875,1321532
2023-05-03 22:07,1321545,577435,511233,232877,1321545
2023-05-03 22:08,1321560,577443,511237,232880,1321560
2023-05-03 22:10,1321573,577454,511237,232882,1321573
2023-05-03 22:11,1321588,577464,511242,232882,1321588
2023-05-03 22:12,1321602,577475,511242,232885,1321602
2023-05-03 22:13,1321616,577485,511245,232886,1321616
2023-05-03 22:14,1321630,577499,511245,232886,1321630
2023-05-03 22:15,1321644,577506,511250,232888,1321644
2023-05-03 22:16,1321659,577521,511250,232888,1321659
2023-05-03 22:17,1321674,577534,511252,232888,1321674
2023-05-03 22:18,1321688,577548,511252,232888,1321688
2023-05-03 22:19,1321701,577555,511255,232891,1321701
2023-05-03 22:20,1321715,577569,511255,232891,1321715
2023-05-03 22:21,1321729,577580,511258,232891,1321729
2023-05-03 22:22,1321743,577592,511258,232893,1321743
2023-05-03 22:23,1321757,577603,511260,232894,1321757
2023-05-03 22:24,1321770,577614,511260,232896,1321770
2023-05-03 22:25,1321784,577626,511261,232897,1321784
2023-05-03 22:26,1321798,577640,511261,232897,1321798
2023-05-03 22:27,1321812,577651,511262,232899,1321812
2023-05-03 22:28,1321826,577664,511262,232900,1321826
2023-05-03 22:29,1321839,577675,511264,232900,1321839
2023-05-03 22:30,1321854,577687,511267,232900,1321854
2023-05-03 22:31,1321868,577699,511267,232902,1321868
2023-05-03 22:32,1321883,577708,511271,232904,1321883
2023-05-03 22:33,1321897,577722,511271,232904,1321897
2023-05-03 22:34,1321911,577734,511272,232905,1321911
2023-05-03 22:35,1321924,577746,511272,232906,1321924
2023-05-03 22:36,1321937,577758,511272,232907,1321937
2023-05-03 22:37,1321951,577770,511272,232909,1321951
2023-05-03 22:38,1321965,577780,511274,232911,1321965
2023-05-03 22:39,1321979,577790,511274,232915,1321979
2023-05-03 22:40,1321994,577800,511276,232918,1321994
2023-05-03 22:41,1322010,577815,511276,232919,1322010
2023-05-03 22:42,1322023,577826,511277,232920,1322023
2023-05-03 22:43,1322037,577839,511277,232921,1322037
2023-05-03 22:44,1322051,577848,511280,232923,1322051
2023-05-03 22:45,1322065,577861,511280,232924,1322065
2023-05-03 22:46,1322079,577866,511286,232927,1322079
2023-05-03 22:47,1322093,577880,511286,232927,1322093
2023-05-03 22:48,1322107,577888,511291,232928,1322107
2023-05-03 22:49,1322121,577898,511291,232932,1322121
2023-05-03 22:50,1322134,577907,511294,232933,1322134
2023-05-03 22:51,1322149,577920,511294,232935,1322149
2023-05-03 22:52,1322162,577928,511297,232937,1322162
2023-05-03 22:53,1322176,577938,511297,232941,1322176
2023-05-03 22:54,1322190,577944,511303,232943,1322190
2023-05-03 22:55,1322204,577958,511303,232943,1322204
2023-05-03 22:57,1322218,577973,511303,232942,1322218
2023-05-03 22:58,1322233,577986,511303,232944,1322233
2023-05-03 22:59,1322246,577996,511305,232945,1322246
2023-05-03 23:00,1322260,578009,511305,232946,1322260
2023-05-03 23:01,1322285,578027,511311,232947,1322285
2023-05-03 23:02,1322310,578050,511312,232948,1322310
2023-05-03 23:03,1322333,578072,511312,232949,1322333
2023-05-03 23:04,1322357,578093,511314,232950,1322357
2023-05-03 23:05,1322383,578117,511314,232952,1322383
2023-05-03 23:06,1322407,578138,511316,232953,1322407
2023-05-03 23:07,1322432,578162,511316,232954,1322432
2023-05-03 23:08,1322457,578182,511320,232955,1322457
2023-05-03 23:09,1322481,578205,511320,232956,1322481
2023-05-03 23:10,1322507,578222,511326,232959,1322507
2023-05-03 23:11,1322530,578243,511327,232960,1322530
2023-05-03 23:12,1322557,578267,511327,232963,1322557
2023-05-03 23:13,1322581,578285,511332,232964,1322581
2023-05-03 23:14,1322606,578308,511332,232966,1322606
2023-05-03 23:15,1322629,578326,511336,232967,1322629
2023-05-03 23:16,1322654,578351,511336,232967,1322654
2023-05-03 23:17,1322678,578370,511339,232969,1322678
2023-05-03 23:18,1322702,578392,511339,232971,1322702
2023-05-03 23:19,1322727,578416,511340,232971,1322727
2023-05-03 23:20,1322754,578442,511340,232972,1322754
2023-05-03 23:21,1322778,578464,511341,232973,1322778
2023-05-03 23:22,1322802,578487,511341,232974,1322802
2023-05-03 23:23,1322826,578506,511344,232976,1322826
2023-05-03 23:24,1322852,578530,511344,232978,1322852
2023-05-03 23:25,1322878,578554,511345,232979,1322878
2023-05-03 23:26,1322901,578574,511345,232982,1322901
2023-05-03 23:27,1322925,578597,511345,232983,1322925
2023-05-03 23:28,1322949,578619,511345,232985,1322949
2023-05-03 23:29,1322974,578643,511346,232985,1322974
2023-05-03 23:30,1322999,578668,511346,232985,1322999
2023-05-03 23:31,1323024,578691,511346,232987,1323024
2023-05-03 23:32,1323049,578708,511351,232990,1323049
2023-05-03 23:33,1323074,578732,511352,232990,1323074
2023-05-03 23:34,1323099,578754,511352,232993,1323099
2023-05-03 23:35,1323122,578771,511357,232994,1323122
2023-05-03 23:36,1323147,578794,511357,232996,1323147
2023-05-03 23:37,1323170,578815,511358,232997,1323170
2023-05-03 23:38,1323195,578836,511362,232997,1323195
2023-05-03 23:39,1323219,578860,511362,232997,1323219
2023-05-03 23:40,1323243,578879,511367,232997,1323243
2023-05-03 23:41,1323267,578903,511367,232997,1323267
2023-05-03 23:42,1323293,578926,511369,232998,1323293
2023-05-03 23:43,1323317,578950,511369,232998,1323317
2023-05-03 23:45,1323342,578974,511369,232999,1323342
2023-05-03 23:46,1323367,578997,511369,233001,1323367
2023-05-03 23:47,1323390,579015,511373,233002,1323390
2023-05-03 23:48,1323415,579039,511373,233003,1323415
2023-05-03 23:49,1323440,579063,511374,233003,1323440
2023-05-03 23:50,1323464,579087,511374,233003,1323464
2023-05-03 23:51,1323488,579108,511376,233004,1323488
2023-05-03 23:52,1323512,579128,511378,233006,1323512
2023-05-03 23:53,1323537,579151,511378,233008,1323537
2023-05-03 23:54,1323562,579172,511381,233009,1323562
2023-05-03 23:55,1323587,579196,511381,233010,1323587
2023-05-03 23:56,1323610,579216,511384,233010,1323610
2023-05-03 23:57,1323634,579240,511384,233010,1323634
2023-05-03 23:58,1323659,579262,511386,233011,1323659
2023-05-03 23:59,1323683,579283,511388,233012,1323683
2023-05-04 00:00,1323708,579308,511388,233012,1323708
2023-05-04 00:01,1323734,579333,511389,233012,1323734
2023-05-04 00:02,1323760,579357,511389,233014,1323760
2023-05-04 00:03,1323785,579379,511390,233016,1323785
2023-05-04 00:04,1323812,579405,511390,233017,1323812
2023-05-04 00:05,1323837,579430,511390,233017,1323837
2023-05-04 00:06,1323863,579456,511390,233017,1323863
2023-05-04 00:07,1323889,579481,511391,233017,1323889
2023-05-04 00:08,1323915,579507,511391,233017,1323915
2023-05-04 00:09,1323940,579528,511393,233019,1323940
2023-05-04 00:10,1323966,579551,511393,233022,1323966
2023-05-04 00:11,1323993,579574,511395,233024,1323993
2023-05-04 00:12,1324019,579599,511395,233025,1324019
2023-05-04 00:13,1324045,579622,511397,233026,1324045
2023-05-04 00:14,1324071,579646,511397,233028,1324071
2023-05-04 00:15,1324098,579669,511400,233029,1324098
2023-05-04 00:16,1324122,579691,511401,233030,1324122
2023-05-04 00:17,1324148,579717,511401,233030,1324148
2023-05-04 00:18,1324174,579741,511403,233030,1324174
2023-05-04 00:19,1324201,579767,511403,233031,1324201
2023-05-04 00:20,1324227,579787,511406,233034,1324227
2023-05-04 00:21,1324251,579811,511406,233034,1324251
2023-05-04 00:22,1324279,579833,511411,233035,1324279
2023-05-04 00:23,1324306,579858,511412,233036,1324306
2023-05-04 00:24,1324330,579881,511413,233036,1324330
2023-05-04 00:25,1324358,579909,511413,233036,1324358
2023-05-04 00:26,1324383,579931,511414,233038,1324383
2023-05-04 00:27,1324409,579956,511414,233039,1324409
2023-05-04 00:28,1324433,579978,511416,233039,1324433
2023-05-04 00:29,1324461,580003,511419,233039,1324461
2023-05-04 00:30,1324487,580028,511419,233040,1324487
2023-05-04 00:32,1324512,580048,511421,233043,1324512
2023-05-04 00:33,1324538,580070,511421,233047,1324538
2023-05-04 00:34,1324563,580093,511422,233048,1324563
2023-05-04 00:35,1324589,580116,511422,233051,1324589
2023-05-04 00:36,1324615,580140,511423,233052,1324615
2023-05-04 00:37,1324642,580165,511423,233054,1324642
2023-05-04 00:38,1324668,580188,511424,233056,1324668
2023-05-04 00:39,1324693,580211,511424,233058,1324693
2023-05-04 00:40,1324720,580235,511426,233059,1324720
2023-05-04 00:41,1324745,580259,511426,233060,1324745
2023-05-04 00:42,1324771,580283,511427,233061,1324771
2023-05-04 00:43,1324797,580308,511427,233062,1324797
2023-05-04 00:44,1324821,580328,511427,233066,1324821
2023-05-04 00:45,1324848,580354,511427,233067,1324848
2023-05-04 00:46,1324874,580378,511428,233068,1324874
2023-05-04 00:47,1324900,580404,511428,233068,1324900
2023-05-04 00:48,1324927,580426,511430,233071,1324927
2023-05-04 00:49,1324952,580450,511430,233072,1324952
2023-05-04 00:50,1324978,580470,511435,233073,1324978
2023-05-04 00:51,1325004,580495,511435,233074,1325004
2023-05-04 00:52,1325029,580517,511436,233076,1325029
2023-05-04 00:53,1325056,580543,511436,233077,1325056
2023-05-04 00:54,1325080,580565,511437,233078,1325080
2023-05-04 00:55,1325109,580594,511437,233078,1325109
2023-05-04 00:56,1325135,580618,511439,233078,1325135
2023-05-04 00:57,1325160,580643,511439,233078,1325160
2023-05-04 00:58,1325186,580667,511440,233079,1325186
2023-05-04 00:59,1325212,580693,511440,233079,1325212
2023-05-04 01:00,1325232,580713,511440,233079,1325232
2023-05-04 01:01,1325250,580729,511440,233081,1325250
2023-05-04 01:02,1325268,580747,511440,233081,1325268
2023-05-04 01:03,1325286,580764,511440,233082,1325286
2023-05-04 01:04,1325303,580781,511440,233082,1325303
2023-05-04 01:05,1325321,580796,511442,233083,1325321
2023-05-04 01:06,1325339,580812,511444,233083,1325339
2023-05-04 01:07,1325356,580829,511444,233083,1325356
2023-05-04 01:08,1325374,580846,511444,233084,1325374
2023-05-04 01:09,1325392,580863,511444,233085,1325392
2023-05-04 01:10,1325410,580879,511446,233085,1325410
2023-05-04 01:11,1325428,580897,511446,233085,1325428
2023-05-04 01:12,1325446,580913,511447,233086,1325446
2023-05-04 01:13,1325463,580930,511447,233086,1325463
2023-05-04 01:14,1325482,580946,511448,233088,1325482
2023-05-04 01:15,1325499,580962,511448,233089,1325499
2023-05-04 01:16,1325517,580978,511449,233090,1325517
2023-05-04 01:17,1325534,580995,511449,233090,1325534
2023-05-04 01:18,1325552,581012,511450,233090,1325552
2023-05-04 01:19,1325570,581029,511451,233090,1325570
2023-05-04 01:20,1325589,581046,511451,233092,1325589
2023-05-04 01:21,1325606,581063,511451,233092,1325606
2023-05-04 01:22,1325625,581083,511451,233091,1325625
2023-05-04 01:24,1325642,581093,511454,233095,1325642
2023-05-04 01:25,1325661,581112,511454,233095,1325661
2023-05-04 01:26,1325678,581125,511458,233095,1325678
2023-05-04 01:27,1325696,581142,511458,233096,1325696
2023-05-04 01:28,1325713,581158,511459,233096,1325713
2023-05-04 01:29,1325732,581177,511459,233096,1325732
2023-05-04 01:30,1325749,581192,511461,233096,1325749
2023-05-04 01:31,1325767,581210,511461,233096,1325767
2023-05-04 01:32,1325785,581227,511461,233097,1325785
2023-05-04 01:33,1325803,581245,511461,233097,1325803
2023-05-04 01:34,1325820,581258,511465,233097,1325820
2023-05-04 01:35,1325838,581274,511466,233098,1325838
2023-05-04 01:36,1325856,581292,511466,233098,1325856
2023-05-04 01:37,1325875,581310,511466,233099,1325875
2023-05-04 01:38,1325893,581327,511466,233100,1325893
2023-05-04 01:39,1325911,581341,511469,233101,1325911
2023-05-04 01:40,1325929,581358,511469,233102,1325929
2023-05-04 01:41,1325946,581374,511469,233103,1325946
2023-05-04 01:42,1325964,581392,511469,233103,1325964
2023-05-04 01:43,1325982,581409,511470,233103,1325982
2023-05-04 01:44,1326000,581427,511470,233103,1326000
2023-05-04 01:45,1326020,581445,511471,233104,1326020
2023-05-04 01:46,1326038,581463,511471,233104,1326038
2023-05-04 01:47,1326055,581477,511473,233105,1326055
2023-05-04 01:48,1326073,581495,511473,233105,1326073
2023-05-04 01:49,1326090,581512,511473,233105,1326090
2023-05-04 01:50,1326109,581529,511473,233107,1326109
2023-05-04 01:51,1326127,581544,511473,233110,1326127
2023-05-04 01:52,1326144,581559,511473,233112,1326144
2023-05-04 01:53,1326162,581575,511473,233114,1326162
2023-05-04 01:54,1326180,581591,511473,233116,1326180
2023-05-04 01:55,1326198,581606,511475,233117,1326198
2023-05-04 01:56,1326216,581622,511477,233117,1326216
2023-05-04 01:57,1326234,581640,511477,233117,1326234
2023-05-04 01:58,1326252,581656,511479,233117,1326252
2023-05-04 01:59,1326271,581675,511479,233117,1326271
2023-05-04 02:00,1326285,581685,511483,233117,1326285
2023-05-04 02:01,1326298,581698,511483,233117,1326298
2023-05-04 02:02,1326312,581710,511485,233117,1326312
2023-05-04 02:03,1326325,581722,511485,233118,1326325
2023-05-04 02:04,1326338,581734,511486,233118,1326338
2023-05-04 02:05,1326353,581749,511486,233118,1326353
2023-05-04 02:06,1326366,581761,511487,233118,1326366
2023-05-04 02:07,1326380,581774,511487,233119,1326380
2023-05-04 02:08,1326393,581786,511487,233120,1326393
2023-05-04 02:09,1326407,581800,511487,233120,1326407
2023-05-04 02:10,1326421,581813,511488,233120,1326421
2023-05-04 02:11,1326435,581827,511488,233120,1326435
2023-05-04 02:13,1326448,581840,511488,233120,1326448
2023-05-04 02:14,1326462,581854,511488,233120,1326462
2023-05-04 02:15,1326476,581866,511490,233120,1326476
2023-05-04 02:16,1326490,581880,511490,233120,1326490
2023-05-04 02:17,1326503,581890,511492,233121,1326503
2023-05-04 02:18,1326516,581903,511492,233121,1326516
2023-05-04 02:19,1326530,581914,511494,233122,1326530
2023-05-04 02:20,1326543,581927,511494,233122,1326543
2023-05-04 02:21,1326556,581939,511495,233122,1326556
2023-05-04 02:22,1326571,581953,511495,233123,1326571
2023-05-04 02:23,1326584,581965,511496,233123,1326584
2023-05-04 02:24,1326597,581978,511496,233123,1326597
2023-05-04 02:25,1326610,581991,511496,233123,1326610
2023-05-04 02:26,1326624,582005,511496,233123,1326624
2023-05-04 02:27,1326637,582017,511497,233123,1326637
2023-05-04 02:28,1326651,582031,511497,233123,1326651
2023-05-04 02:29,1326664,582043,511498,233123,1326664
2023-05-04 02:30,1326677,582056,511498,233123,1326677
2023-05-04 02:31,1326691,582068,511499,233124,1326691
2023-05-04 02:32,1326705,582081,511499,233125,1326705
2023-05-04 02:33,1326718,582093,511500,233125,1326718
2023-05-04 02:34,1326731,582104,511500,233127,1326731
2023-05-04 02:35,1326745,582117,511501,233127,1326745
2023-05-04 02:36,1326758,582130,511501,233127,1326758
2023-05-04 02:37,1326771,582141,511503,233127,1326771
2023-05-04 02:38,1326785,582155,511503,233127,1326785
2023-05-04 02:39,1326798,582168,511503,233127,1326798
2023-05-04 02:40,1326812,582182,511503,233127,1326812
2023-05-04 02:41,1326826,582196,511503,233127,1326826
2023-05-04 02:42,1326839,582209,511503,233127,1326839
2023-05-04 02:43,1326853,582223,511503,233127,1326853
2023-05-04 02:44,1326865,582234,511503,233128,1326865
2023-05-04 02:45,1326879,582248,511503,233128,1326879
2023-05-04 02:46,1326893,582262,511503,233128,1326893
2023-05-04 02:47,1326905,582271,511505,233129,1326905
2023-05-04 02:48,1326919,582284,511505,233130,1326919
2023-05-04 02:49,1326932,582297,511505,233130,1326932
2023-05-04 02:50,1326946,582311,511505,233130,1326946
2023-05-04 02:51,1326960,582325,511505,233130,1326960
2023-05-04 02:52,1326973,582338,511505,233130,1326973
2023-05-04 02:53,1326986,582351,511505,233130,1326986
2023-05-04 02:54,1326999,582364,511505,233130,1326999
2023-05-04 02:55,1327013,582376,511506,233131,1327013
2023-05-04 02:56,1327027,582389,511506,233132,1327027
2023-05-04 02:57,1327041,582403,511506,233132,1327041
2023-05-04 02:58,1327054,582416,511506,233132,1327054
2023-05-04 03:00,1327067,582429,511506,233132,1327067
2023-05-04 03:01,1327093,582455,511506,233132,1327093
2023-05-04 03:02,1327120,582482,511506,233132,1327120
2023-05-04 03:03,1327146,582508,511506,233132,1327146
2023-05-04 03:04,1327173,582534,511507,233132,1327173
2023-05-04 03:05,1327200,582561,511507,233132,1327200
2023-05-04 03:06,1327226,582585,511509,233132,1327226
2023-05-04 03:07,1327254,582613,511509,233132,1327254
2023-05-04 03:08,1327281,582640,511509,233132,1327281
2023-05-04 03:09,1327306,582665,511509,233132,1327306
2023-05-04 03:10,1327334,582692,511510,233132,1327334
2023-05-04 03:11,1327360,582718,511510,233132,1327360
2023-05-04 03:12,1327387,582745,511510,233132,1327387
2023-05-04 03:13,1327413,582771,511510,233132,1327413
2023-05-04 03:14,1327441,582797,511512,233132,1327441
2023-05-04 03:15,1327467,582822,511512,233133,1327467
2023-05-04 03:16,1327494,582849,511512,233133,1327494
2023-05-04 03:17,1327520,582875,511512,233133,1327520
2023-05-04 03:18,1327546,582900,511513,233133,1327546
2023-05-04 03:19,1327573,582927,511513,233133,1327573
2023-05-04 03:20,1327599,582952,511514,233133,1327599
2023-05-04 03:21,1327626,582979,511514,233133,1327626
2023-05-04 03:22,1327654,583008,511513,233133,1327654
2023-05-04 03:23,1327679,583033,511513,233133,1327679
2023-05-04 03:24,1327707,583058,511515,233134,1327707
2023-05-04 03:25,1327734,583085,511515,233134,1327734
2023-05-04 03:26,1327759,583110,511515,233134,1327759
2023-05-04 03:27,1327787,583138,511515,233134,1327787
2023-05-04 03:28,1327813,583163,511516,233134,1327813
2023-05-04 03:29,1327841,583191,511516,233134,1327841
2023-05-04 03:30,1327867,583216,511516,233135,1327867
2023-05-04 03:31,1327894,583243,511516,233135,1327894
2023-05-04 03:32,1327921,583269,511516,233136,1327921
2023-05-04 03:33,1327947,583295,511516,233136,1327947
2023-05-04 03:34,1327973,583320,511516,233137,1327973
2023-05-04 03:35,1328000,583347,511516,233137,1328000
2023-05-04 03:36,1328028,583375,511516,233137,1328028
2023-05-04 03:37,1328054,583401,511516,233137,1328054
2023-05-04 03:38,1328079,583425,511517,233137,1328079
2023-05-04 03:39,1328106,583452,511517,233137,1328106
2023-05-04 03:40,1328134,583476,511521,233137,1328134
2023-05-04 03:41,1328160,583502,511521,233137,1328160
2023-05-04 03:42,1328187,583529,511521,233137,1328187
2023-05-04 03:43,1328214,583555,511521,233138,1328214
2023-05-04 03:44,1328239,583580,511521,233138,1328239
2023-05-04 03:45,1328267,583608,511521,233138,1328267
2023-05-04 03:47,1328293,583634,511521,233138,1328293
2023-05-04 03:48,1328320,583661,511521,233138,1328320
2023-05-04 03:49,1328346,583687,511521,233138,1328346
2023-05-04 03:50,1328374,583715,511521,233138,1328374
2023-05-04 03:51,1328401,583742,511521,233138,1328401
2023-05-04 03:52,1328426,583767,511521,233138,1328426
2023-05-04 03:53,1328453,583794,511521,233138,1328453
2023-05-04 03:54,1328480,583821,511521,233138,1328480
2023-05-04 03:55,1328507,583847,511522,233138,1328507
2023-05-04 03:56,1328533,583873,511522,233138,1328533
2023-05-04 03:57,1328560,583899,511523,233138,1328560
2023-05-04 03:58,1328587,583926,511523,233138,1328587
2023-05-04 03:59,1328612,583951,511523,233138,1328612
2023-05-04 04:00,1328636,583975,511523,233138,1328636
2023-05-04 04:01,1328645,583984,511523,233138,1328645
2023-05-04 04:02,1328655,583992,511523,233140,1328655
2023-05-04 04:03,1328665,584002,511523,233140,1328665
2023-05-04 04:04,1328674,584011,511523,233140,1328674
2023-05-04 04:05,1328683,584020,511523,233140,1328683
2023-05-04 04:06,1328693,584030,511523,233140,1328693
2023-05-04 04:07,1328703,584039,511524,233140,1328703
2023-05-04 04:08,1328712,584048,511524,233140,1328712
2023-05-04 04:09,1328722,584056,511526,233140,1328722
2023-05-04 04:10,1328732,584064,511526,233142,1328732
2023-05-04 04:11,1328741,584071,511527,233143,1328741
2023-05-04 04:12,1328751,584081,511527,233143,1328751
2023-05-04 04:13,1328761,584091,511527,233143,1328761
2023-05-04 04:14,1328770,584100,511527,233143,1328770
2023-05-04 04:15,1328780,584109,511528,233143,1328780
2023-05-04 04:16,1328789,584118,511528,233143,1328789
2023-05-04 04:17,1328799,584128,511528,233143,1328799
2023-05-04 04:18,1328808,584137,511528,233143,1328808
2023-05-04 04:19,1328818,584147,511528,233143,1328818
2023-05-04 04:20,1328828,584157,511528,233143,1328828
2023-05-04 04:21,1328837,584166,511528,233143,1328837
2023-05-04 04:22,1328846,584175,511528,233143,1328846
2023-05-04 04:23,1328856,584185,511528,233143,1328856
2023-05-04 04:24,1328866,584195,511528,233143,1328866
2023-05-04 04:25,1328875,584203,511529,233143,1328875
2023-05-04 04:26,1328885,584213,511529,233143,1328885
2023-05-04 04:27,1328895,584223,511529,233143,1328895
2023-05-04 04:28,1328904,584231,511529,233144,1328904
2023-05-04 04:29,1328914,584241,511529,233144,1328914
2023-05-04 04:30,1328924,584251,511529,233144,1328924
2023-05-04 04:31,1328933,584260,511529,233144,1328933
2023-05-04 04:32,1328943,584270,511529,233144,1328943
2023-05-04 04:34,1328952,584279,511529,233144,1328952
2023-05-04 04:35,1328962,584289,511529,233144,1328962
2023-05-04 04:36,1328972,584298,511530,233144,1328972
2023-05-04 04:37,1328981,584306,511530,233145,1328981
2023-05-04 04:38,1328991,584316,511530,233145,1328991
2023-05-04 04:39,1329000,584325,511530,233145,1329000
2023-05-04 04:40,1329010,584335,511530,233145,1329010
2023-05-04 04:41,1329020,584345,511530,233145,1329020
2023-05-04 04:42,1329029,584354,511530,233145,1329029
2023-05-04 04:43,1329038,584363,511530,233145,1329038
2023-05-04 04:44,1329048,584373,511530,233145,1329048
2023-05-04 04:45,1329057,584382,511530,233145,1329057
2023-05-04 04:46,1329068,584393,511530,233145,1329068
2023-05-04 04:47,1329077,584401,511530,233146,1329077
2023-05-04 04:48,1329086,584409,511530,233147,1329086
2023-05-04 04:49,1329096,584419,511530,233147,1329096
2023-05-04 04:50,1329106,584429,511530,233147,1329106
2023-05-04 04:51,1329116,584438,511530,233148,1329116
2023-05-04 04:52,1329124,584444,511531,233149,1329124
2023-05-04 04:53,1329134,584454,511531,233149,1329134
2023-05-04 04:54,1329144,584464,511531,233149,1329144
2023-05-04 04:55,1329154,584474,511531,233149,1329154
2023-05-04 04:56,1329163,584483,511531,233149,1329163
2023-05-04 04:57,1329173,584494,511531,233148,1329173
2023-05-04 04:58,1329182,584503,511531,233148,1329182
2023-05-04 04:59,1329192,584513,511531,233148,1329192
2023-05-04 05:00,1329212,584533,511531,233148,1329212
2023-05-04 05:01,1329240,584561,511531,233148,1329240
2023-05-04 05:02,1329266,584587,511531,233148,1329266
2023-05-04 05:03,1329295,584615,511531,233149,1329295
2023-05-04 05:04,1329323,584643,511531,233149,1329323
2023-05-04 05:05,1329350,584670,511531,233149,1329350
2023-05-04 05:06,1329376,584696,511531,233149,1329376
2023-05-04 05:07,1329404,584724,511531,233149,1329404
2023-05-04 05:08,1329432,584752,511531,233149,1329432
2023-05-04 05:09,1329460,584780,511531,233149,1329460
2023-05-04 05:10,1329488,584807,511532,233149,1329488
2023-05-04 05:11,1329517,584835,511532,233150,1329517
2023-05-04 05:12,1329544,584862,511532,233150,1329544
2023-05-04 05:13,1329571,584889,511532,233150,1329571
2023-05-04 05:14,1329600,584917,511533,233150,1329600
2023-05-04 05:15,1329627,584944,511533,233150,1329627
2023-05-04 05:16,1329655,584972,511533,233150,1329655
2023-05-04 05:17,1329682,584999,511533,233150,1329682
2023-05-04 05:18,1329709,585026,511533,233150,1329709
2023-05-04 05:20,1329738,585055,511533,233150,1329738
2023-05-04 05:21,1329765,585082,511533,233150,1329765
2023-05-04 05:22,1329792,585109,511533,233150,1329792
2023-05-04 05:23,1329819,585136,511533,233150,1329819
2023-05-04 05:24,1329849,585166,511533,233150,1329849
2023-05-04 05:25,1329876,585193,511533,233150,1329876
2023-05-04 05:26,1329904,585221,511533,233150,1329904
2023-05-04 05:27,1329932,585249,511533,233150,1329932
2023-05-04 05:28,1329959,585276,511533,233150,1329959
2023-05-04 05:29,1329986,585303,511533,233150,1329986
2023-05-04 05:30,1330014,585331,511533,233150,1330014
2023-05-04 05:31,1330041,585358,511533,233150,1330041
2023-05-04 05:32,1330070,585387,511533,233150,1330070
2023-05-04 05:33,1330097,585412,511534,233151,1330097
2023-05-04 05:34,1330124,585439,511534,233151,1330124
2023-05-04 05:35,1330152,585467,511534,233151,1330152
2023-05-04 05:36,1330181,585496,511534,233151,1330181
2023-05-04 05:37,1330207,585522,511534,233151,1330207
2023-05-04 05:38,1330235,585550,511534,233151,1330235
2023-05-04 05:39,1330264,585579,511534,233151,1330264
2023-05-04 05:40,1330290,585605,511534,233151,1330290
2023-05-04 05:41,1330319,585633,511534,233152,1330319
2023-05-04 05:42,1330347,585661,511534,233152,1330347
2023-05-04 05:43,1330374,585688,511534,233152,1330374
2023-05-04 05:44,1330401,585714,511534,233153,1330401
2023-05-04 05:45,1330429,585741,511535,233153,1330429
2023-05-04 05:46,1330457,585769,511535,233153,1330457
2023-05-04 05:47,1330484,585796,511535,233153,1330484
2023-05-04 05:48,1330513,585825,511535,233153,1330513
2023-05-04 05:49,1330541,585853,511535,233153,1330541
2023-05-04 05:50,1330567,585879,511535,233153,1330567
2023-05-04 05:51,1330594,585904,511536,233154,1330594
2023-05-04 05:52,1330622,585932,511536,233154,1330622
2023-05-04 05:53,1330651,585960,511537,233154,1330651
2023-05-04 05:54,1330678,585987,511537,233154,1330678
2023-05-04 05:55,1330707,586016,511537,233154,1330707
2023-05-04 05:56,1330734,586043,511537,233154,1330734
2023-05-04 05:57,1330763,586072,511537,233154,1330763
2023-05-04 05:58,1330789,586097,511537,233155,1330789
2023-05-04 05:59,1330818,586126,511537,233155,1330818
2023-05-04 06:00,1330846,586154,511537,233155,1330846
2023-05-04 06:01,1330872,586180,511537,233155,1330872
2023-05-04 06:02,1330900,586208,511537,233155,1330900
2023-05-04 06:03,1330928,586236,511537,233155,1330928
2023-05-04 06:04,1330955,586263,511537,233155,1330955
2023-05-04 06:05,1330983,586290,511538,233155,1330983
2023-05-04 06:06,1331012,586319,511538,233155,1331012
2023-05-04 06:08,1331038,586344,511539,233155,1331038
2023-05-04 06:09,1331066,586372,511539,233155,1331066
2023-05-04 06:10,1331094,586399,511539,233156,1331094
2023-05-04 06:11,1331122,586427,511539,233156,1331122
2023-05-04 06:12,1331149,586453,511540,233156,1331149
2023-05-04 06:13,1331176,586480,511540,233156,1331176
2023-05-04 06:14,1331203,586507,511540,233156,1331203
2023-05-04 06:15,1331231,586535,511540,233156,1331231
2023-05-04 06:16,1331259,586563,511540,233156,1331259
2023-05-04 06:17,1331288,586592,511540,233156,1331288
2023-05-04 06:18,1331314,586616,511542,233156,1331314
2023-05-04 06:19,1331342,586644,511542,233156,1331342
2023-05-04 06:20,1331370,586671,511543,233156,1331370
2023-05-04 06:21,1331398,586699,511543,233156,1331398
2023-05-04 06:22,1331424,586725,511543,233156,1331424
2023-05-04 06:23,1331453,586754,511543,233156,1331453
2023-05-04 06:24,1331480,586780,511544,233156,1331480
2023-05-04 06:25,1331508,586808,511544,233156,1331508
2023-05-04 06:26,1331535,586835,511544,233156,1331535
2023-05-04 06:27,1331562,586862,511544,233156,1331562
2023-05-04 06:28,1331590,586890,511544,233156,1331590
2023-05-04 06:29,1331618,586917,511544,233157,1331618
2023-05-04 06:30,1331644,586943,511544,233157,1331644
2023-05-04 06:31,1331674,586973,511544,233157,1331674
2023-05-04 06:32,1331700,586998,511544,233158,1331700
2023-05-04 06:33,1331728,587026,511544,233158,1331728
2023-05-04 06:34,1331755,587053,511544,233158,1331755
2023-05-04 06:35,1331783,587081,511544,233158,1331783
2023-05-04 06:36,1331812,587109,511545,233158,1331812
2023-05-04 06:37,1331838,587135,511545,233158,1331838
2023-05-04 06:38,1331866,587160,511547,233159,1331866
2023-05-04 06:39,1331894,587186,511547,233161,1331894
2023-05-04 06:40,1331920,587210,511548,233162,1331920
2023-05-04 06:41,1331948,587238,511548,233162,1331948
2023-05-04 06:42,1331977,587264,511550,233163,1331977
2023-05-04 06:43,1332003,587290,511550,233163,1332003
2023-05-04 06:44,1332031,587318,511550,233163,1332031
2023-05-04 06:45,1332059,587345,511550,233164,1332059
2023-05-04 06:46,1332087,587372,511551,233164,1332087
2023-05-04 06:47,1332114,587397,511551,233166,1332114
2023-05-04 06:48,1332141,587423,511551,233167,1332141
2023-05-04 06:49,1332170,587452,511551,233167,1332170
2023-05-04 06:50,1332195,587476,511551,233168,1332195
2023-05-04 06:51,1332225,587507,511551,233167,1332225
2023-05-04 06:52,1332252,587534,511551,233167,1332252
2023-05-04 06:53,1332278,587560,511551,233167,1332278
2023-05-04 06:55,1332306,587588,511551,233167,1332306
2023-05-04 06:56,1332333,587615,511551,233167,1332333
2023-05-04 06:57,1332362,587643,511552,233167,1332362
2023-05-04 06:58,1332390,587671,511552,233167,1332390
2023-05-04 06:59,1332416,587696,511553,233167,1332416
2023-05-04 07:00,1332443,587723,511553,233167,1332443
2023-05-04 07:01,1332463,587743,511553,233167,1332463
2023-05-04 07:02,1332482,587762,511553,233167,1332482
2023-05-04 07:03,1332502,587782,511553,233167,1332502
2023-05-04 07:04,1332520,587800,511553,233167,1332520
2023-05-04 07:05,1332539,587817,511555,233167,1332539
2023-05-04 07:06,1332558,587836,511555,233167,1332558
2023-05-04 07:07,1332577,587854,511556,233167,1332577
2023-05-04 07:08,1332596,587873,511556,233167,1332596
2023-05-04 07:09,1332614,587891,511556,233167,1332614
2023-05-04 07:10,1332633,587910,511556,233167,1332633
2023-05-04 07:11,1332652,587928,511557,233167,1332652
2023-05-04 07:12,1332671,587947,511557,233167,1332671
2023-05-04 07:13,1332690,587964,511558,233168,1332690
2023-05-04 07:14,1332708,587980,511558,233170,1332708
2023-05-04 07:15,1332728,587998,511559,233171,1332728
2023-05-04 07:16,1332746,588016,511559,233171,1332746
2023-05-04 07:17,1332766,588036,511559,233171,1332766
2023-05-04 07:18,1332784,588052,511559,233173,1332784
2023-05-04 07:19,1332803,588071,511559,233173,1332803
2023-05-04 07:20,1332822,588090,511559,233173,1332822
2023-05-04 07:21,1332841,588108,511559,233174,1332841
2023-05-04 07:22,1332860,588127,511559,233174,1332860
2023-05-04 07:23,1332879,588146,511559,233174,1332879
2023-05-04 07:24,1332897,588164,511559,233174,1332897
2023-05-04 07:25,1332916,588182,511560,233174,1332916
2023-05-04 07:26,1332934,588200,511560,233174,1332934
2023-05-04 07:27,1332955,588221,511560,233174,1332955
2023-05-04 07:28,1332973,588239,511560,233174,1332973
2023-05-04 07:29,1332991,588256,511561,233174,1332991
2023-05-04 07:30,1333010,588275,511561,233174,1333010
2023-05-04 07:31,1333029,588293,511561,233175,1333029
2023-05-04 07:32,1333049,588313,511561,233175,1333049
2023-05-04 07:33,1333068,588331,511561,233176,1333068
2023-05-04 07:34,1333087,588350,511561,233176,1333087
2023-05-04 07:35,1333105,588366,511563,233176,1333105
2023-05-04 07:36,1333124,588385,511563,233176,1333124
2023-05-04 07:37,1333143,588401,511566,233176,1333143
2023-05-04 07:38,1333162,588419,511566,233177,1333162
2023-05-04 07:39,1333181,588438,511566,233177,1333181
2023-05-04 07:40,1333200,588456,511566,233178,1333200
2023-05-04 07:41,1333219,588475,511566,233178,1333219
2023-05-04 07:43,1333237,588493,511566,233178,1333237
2023-05-04 07:44,1333257,588513,511566,233178,1333257
2023-05-04 07:45,1333276,588532,511566,233178,1333276
2023-05-04 07:46,1333294,588550,511566,233178,1333294
2023-05-04 07:47,1333314,588569,511566,233179,1333314
2023-05-04 07:48,1333334,588580,511575,233179,1333334
2023-05-04 07:49,1333352,588598,511575,233179,1333352
2023-05-04 07:50,1333370,588615,511576,233179,1333370
2023-05-04 07:51,1333390,588635,511576,233179,1333390
2023-05-04 07:52,1333409,588652,511578,233179,1333409
2023-05-04 07:53,1333427,588670,511578,233179,1333427
2023-05-04 07:54,1333446,588688,511578,233180,1333446
2023-05-04 07:55,1333466,588708,511578,233180,1333466
2023-05-04 07:56,1333484,588725,511579,233180,1333484
2023-05-04 07:57,1333502,588743,511579,233180,1333502
2023-05-04 07:58,1333522,588763,511579,233180,1333522
2023-05-04 07:59,1333541,588781,511579,233181,1333541
2023-05-04 08:00,1333561,588801,511579,233181,1333561
2023-05-04 08:01,1333589,588829,511579,233181,1333589
2023-05-04 08:02,1333618,588857,511580,233181,1333618
2023-05-04 08:03,1333646,588885,511580,233181,1333646
2023-05-04 08:04,1333675,588913,511581,233181,1333675
2023-05-04 08:05,1333703,588941,511581,233181,1333703
2023-05-04 08:06,1333731,588968,511582,233181,1333731
2023-05-04 08:07,1333759,588995,511582,233182,1333759
2023-05-04 08:08,1333787,589023,511582,233182,1333787
2023-05-04 08:09,1333815,589051,511582,233182,1333815
2023-05-04 08:10,1333844,589079,511582,233183,1333844
2023-05-04 08:11,1333871,589105,511582,233184,1333871
2023-05-04 08:12,1333899,589131,511584,233184,1333899
2023-05-04 08:13,1333926,589157,511584,233185,1333926
2023-05-04 08:14,1333955,589182,511586,233187,1333955
2023-05-04 08:15,1333984,589211,511586,233187,1333984
2023-05-04 08:16,1334011,589238,511586,233187,1334011
2023-05-04 08:17,1334039,589266,511586,233187,1334039
2023-05-04 08:18,1334069,589295,511587,233187,1334069
2023-05-04 08:19,1334097,589323,511587,233187,1334097
2023-05-04 08:20,1334126,589351,511587,233188,1334126
2023-05-04 08:21,1334154,589378,511587,233189,1334154
2023-05-04 08:22,1334181,589405,511587,233189,1334181
2023-05-04 08:23,1334210,589432,511587,233191,1334210
2023-05-04 08:24,1334237,589458,511587,233192,1334237
2023-05-04 08:25,1334265,589486,511587,233192,1334265
2023-05-04 08:26,1334293,589514,511587,233192,1334293
2023-05-04 08:27,1334321,589543,511587,233191,1334321
2023-05-04 08:28,1334350,589572,511587,233191,1334350
2023-05-04 08:30,1334379,589601,511587,233191,1334379
2023-05-04 08:31,1334406,589627,511588,233191,1334406
2023-05-04 08:32,1334433,589654,511588,233191,1334433
2023-05-04 08:33,1334462,589681,511589,233192,1334462
2023-05-04 08:34,1334489,589708,511589,233192,1334489
2023-05-04 08:35,1334518,589737,511589,233192,1334518
2023-05-04 08:36,1334545,589763,511589,233193,1334545
2023-05-04 08:37,1334575,589791,511590,233194,1334575
2023-05-04 08:38,1334602,589819,511590,233193,1334602
2023-05-04 08:39,1334629,589844,511592,233193,1334629
2023-05-04 08:40,1334658,589873,511592,233193,1334658
2023-05-04 08:41,1334687,589902,511592,233193,1334687
2023-05-04 08:42,1334715,589930,511592,233193,1334715
2023-05-04 08:43,1334743,589957,511593,233193,1334743
2023-05-04 08:44,1334773,589986,511593,233194,1334773
2023-05-04 08:45,1334800,590009,511595,233196,1334800
2023-05-04 08:46,1334827,590036,511595,233196,1334827
2023-05-04 08:47,1334856,590064,511596,233196,1334856
2023-05-04 08:48,1334885,590093,511596,233196,1334885
2023-05-04 08:49,1334913,590121,511596,233196,1334913
2023-05-04 08:50,1334941,590147,511598,233196,1334941
2023-05-04 08:51,1334970,590174,511598,233198,1334970
2023-05-04 08:52,1334998,590199,511601,233198,1334998
2023-05-04 08:53,1335025,590226,511601,233198,1335025
2023-05-04 08:54,1335053,590254,511601,233198,1335053
2023-05-04 08:55,1335082,590283,511601,233198,1335082
2023-05-04 08:56,1335111,590312,511601,233198,1335111
2023-05-04 08:57,1335137,590337,511601,233199,1335137
2023-05-04 08:58,1335167,590364,511602,233201,1335167
2023-05-04 08:59,1335195,590391,511602,233202,1335195
2023-05-04 09:00,1335214,590408,511603,233203,1335214
2023-05-04 09:01,1335231,590425,511603,233203,1335231
2023-05-04 09:02,1335245,590437,511605,233203,1335245
2023-05-04 09:03,1335259,590451,511605,233203,1335259
2023-05-04 09:04,1335273,590465,511605,233203,1335273
2023-05-04 09:05,1335289,590481,511605,233203,1335289
2023-05-04 09:06,1335303,590494,511605,233204,1335303
2023-05-04 09:07,1335318,590509,511605,233204,1335318
2023-05-04 09:08,1335332,590522,511606,233204,1335332
2023-05-04 09:09,1335347,590537,511606,233204,1335347
2023-05-04 09:10,1335362,590548,511608,233206,1335362
2023-05-04 09:11,1335376,590561,511608,233207,1335376
2023-05-04 09:12,1335390,590573,511609,233208,1335390
2023-05-04 09:13,1335404,590587,511609,233208,1335404
2023-05-04 09:14,1335419,590600,511611,233208,1335419
2023-05-04 09:15,1335434,590614,511611,233209,1335434
2023-05-04 09:16,1335447,590626,511612,233209,1335447
2023-05-04 09:18,1335462,590641,511612,233209,1335462
2023-05-04 09:19,1335477,590655,511611,233211,1335477
2023-05-04 09:20,1335492,590670,511611,233211,1335492
2023-05-04 09:21,1335506,590684,511611,233211,1335506
2023-05-04 09:22,1335522,590700,511611,233211,1335522
2023-05-04 09:23,1335536,590714,511611,233211,1335536
2023-05-04 09:24,1335550,590728,511611,233211,1335550
2023-05-04 09:25,1335564,590737,511615,233212,1335564
2023-05-04 09:26,1335579,590750,511615,233214,1335579
2023-05-04 09:27,1335593,590763,511615,233215,1335593
2023-05-04 09:28,1335609,590779,511615,233215,1335609
2023-05-04 09:29,1335623,590789,511618,233216,1335623
2023-05-04 09:30,1335638,590804,511618,233216,1335638
2023-05-04 09:31,1335652,590818,511618,233216,1335652
2023-05-04 09:32,1335667,590833,511618,233216,1335667
2023-05-04 09:33,1335682,590846,511620,233216,1335682
2023-05-04 09:34,1335697,590861,511620,233216,1335697
2023-05-04 09:35,1335712,590875,511621,233216,1335712
2023-05-04 09:36,1335728,590891,511621,233216,1335728
2023-05-04 09:37,1335741,590902,511622,233217,1335741
2023-05-04 09:38,1335756,590915,511622,233219,1335756
2023-05-04 09:39,1335771,590926,511624,233221,1335771
2023-05-04 09:40,1335784,590938,511624,233222,1335784
2023-05-04 09:41,1335800,590954,511624,233222,1335800
2023-05-04 09:42,1335815,590968,511624,233223,1335815
2023-05-04 09:43,1335829,590982,511624,233223,1335829
2023-05-04 09:44,1335844,590996,511625,233223,1335844
2023-05-04 09:45,1335859,591011,511625,233223,1335859
2023-05-04 09:46,1335873,591024,511625,233224,1335873
2023-05-04 09:47,1335887,591037,511625,233225,1335887
2023-05-04 09:48,1335901,591050,511625,233226,1335901
2023-05-04 09:49,1335916,591064,511625,233227,1335916
2023-05-04 09:50,1335931,591078,511625,233228,1335931
2023-05-04 09:51,1335945,591092,511625,233228,1335945
2023-05-04 09:52,1335960,591106,511625,233229,1335960
2023-05-04 09:53,1335975,591120,511625,233230,1335975
2023-05-04 09:54,1335989,591134,511625,233230,1335989
2023-05-04 09:55,1336003,591147,511625,233231,1336003
2023-05-04 09:56,1336017,591159,511627,233231,1336017
2023-05-04 09:57,1336032,591172,511627,233233,1336032
2023-05-04 09:58,1336047,591186,511628,233233,1336047
2023-05-04 09:59,1336061,591199,511628,233234,1336061
2023-05-04 10:00,1336075,591211,511630,233234,1336075
2023-05-04 10:01,1336089,591224,511630,233235,1336089
2023-05-04 10:02,1336103,591237,511630,233236,1336103
2023-05-04 10:03,1336117,591250,511630,233237,1336117
2023-05-04 10:05,1336132,591264,511631,233237,1336132
2023-05-04 10:06,1336146,591278,511631,233237,1336146
2023-05-04 10:07,1336160,591291,511632,233237,1336160
2023-05-04 10:08,1336173,591303,511632,233238,1336173
2023-05-04 10:09,1336187,591317,511632,233238,1336187
2023-05-04 10:10,1336202,591332,511632,233238,1336202
2023-05-04 10:11,1336216,591343,511634,233239,1336216
2023-05-04 10:12,1336230,591355,511636,233239,1336230
2023-05-04 10:13,1336244,591367,511638,233239,1336244
2023-05-04 10:14,1336258,591379,511638,233241,1336258
2023-05-04 10:15,1336273,591394,511638,233241,1336273
2023-05-04 10:16,1336288,591409,511638,233241,1336288
2023-05-04 10:17,1336302,591422,511638,233242,1336302
2023-05-04 10:18,1336316,591436,511638,233242,1336316
2023-05-04 10:19,1336330,591449,511638,233243,1336330
2023-05-04 10:20,1336344,591462,511638,233244,1336344
2023-05-04 10:21,1336358,591476,511638,233244,1336358
2023-05-04 10:22,1336372,591489,511638,233245,1336372
2023-05-04 10:23,1336386,591501,511640,233245,1336386
2023-05-04 10:24,1336400,591514,511640,233246,1336400
2023-05-04 10:25,1336414,591524,511643,233247,1336414
2023-05-04 10:26,1336428,591538,511643,233247,1336428
2023-05-04 10:27,1336442,591552,511643,233247,1336442
2023-05-04 10:28,1336455,591565,511643,233247,1336455
2023-05-04 10:29,1336471,591580,511644,233247,1336471
2023-05-04 10:30,1336484,591593,511644,233247,1336484
2023-05-04 10:31,1336499,591606,511646,233247,1336499
2023-05-04 10:32,1336512,591618,511646,233248,1336512
2023-05-04 10:33,1336527,591631,511647,233249,1336527
2023-05-04 10:34,1336543,591645,511647,233251,1336543
2023-05-04 10:35,1336556,591655,511649,233252,1336556
2023-05-04 10:36,1336571,591670,511649,233252,1336571
2023-05-04 10:37,1336584,591682,511649,233253,1336584
2023-05-04 10:38,1336599,591697,511649,233253,1336599
2023-05-04 10:39,1336612,591706,511651,233255,1336612
2023-05-04 10:40,1336626,591720,511651,233255,1336626
2023-05-04 10:41,1336642,591732,511653,233257,1336642
2023-05-04 10:42,1336656,591746,511653,233257,1336656
2023-05-04 10:43,1336669,591757,511654,233258,1336669
2023-05-04 10:44,1336683,591771,511654,233258,1336683
2023-05-04 10:45,1336697,591784,511655,233258,1336697
2023-05-04 10:46,1336712,591799,511655,233258,1336712
2023-05-04 10:47,1336725,591811,511655,233259,1336725
2023-05-04 10:48,1336739,591826,511655,233258,1336739
2023-05-04 10:49,1336753,591835,511657,233261,1336753
2023-05-04 10:50,1336767,591849,511657,233261,1336767
2023-05-04 10:52,1336781,591863,511657,233261,1336781
2023-05-04 10:53,1336795,591877,511657,233261,1336795
2023-05-04 10:54,1336811,591893,511657,233261,1336811
2023-05-04 10:55,1336825,591907,511657,233261,1336825
2023-05-04 10:56,1336839,591921,511658,233260,1336839
2023-05-04 10:57,1336854,591936,511658,233260,1336854
2023-05-04 10:58,1336868,591944,511661,233263,1336868
2023-05-04 10:59,1336881,591956,511661,233264,1336881
2023-05-04 11:00,1336896,591967,511664,233265,1336896
2023-05-04 11:01,1336906,591975,511664,233267,1336906
2023-05-04 11:02,1336916,591984,511665,233267,1336916
2023-05-04 11:03,1336926,591994,511665,233267,1336926
2023-05-04 11:04,1336936,591999,511669,233268,1336936
2023-05-04 11:05,1336946,592009,511669,233268,1336946
2023-05-04 11:06,1336957,592018,511670,233269,1336957
2023-05-04 11:07,1336967,592028,511670,233269,1336967
2023-05-04 11:08,1336977,592036,511671,233270,1336977
2023-05-04 11:09,1336986,592044,511671,233271,1336986
2023-05-04 11:10,1336996,592053,511671,233272,1336996
2023-05-04 11:11,1337007,592063,511671,233273,1337007
2023-05-04 11:12,1337017,592070,511674,233273,1337017
2023-05-04 11:13,1337026,592077,511674,233275,1337026
2023-05-04 11:14,1337037,592085,511677,233275,1337037
2023-05-04 11:15,1337047,592093,511677,233277,1337047
2023-05-04 11:16,1337057,592102,511678,233277,1337057
2023-05-04 11:17,1337067,592110,511678,233279,1337067
2023-05-04 11:18,1337077,592120,511678,233279,1337077
2023-05-04 11:19,1337087,592129,511679,233279,1337087
2023-05-04 11:20,1337097,592138,511679,233280,1337097
2023-05-04 11:21,1337107,592143,511683,233281,1337107
2023-05-04 11:22,1337117,592153,511683,233281,1337117
2023-05-04 11:23,1337128,592164,511683,233281,1337128
2023-05-04 11:24,1337138,592174,511683,233281,1337138
2023-05-04 11:25,1337148,592180,511687,233281,1337148
2023-05-04 11:26,1337158,592190,511687,233281,1337158
2023-05-04 11:27,1337168,592199,511688,233281,1337168
2023-05-04 11:28,1337178,592209,511688,233281,1337178
2023-05-04 11:29,1337188,592219,511688,233281,1337188
2023-05-04 11:30,1337199,592229,511688,233282,1337199
2023-05-04 11:31,1337209,592237,511690,233282,1337209
2023-05-04 11:32,1337219,592246,511690,233283,1337219
2023-05-04 11:33,1337229,592256,511690,233283,1337229
2023-05-04 11:34,1337239,592266,511690,233283,1337239
2023-05-04 11:35,1337249,592275,511691,233283,1337249
2023-05-04 11:36,1337259,592283,511693,233283,1337259
2023-05-04 11:37,1337271,592294,511693,233284,1337271
2023-05-04 11:38,1337281,592302,511694,233285,1337281
2023-05-04 11:40,1337291,592311,511694,233286,1337291
2023-05-04 11:41,1337301,592318,511696,233287,1337301
2023-05-04 11:42,1337311,592327,511696,233288,1337311
2023-05-04 11:43,1337321,592334,511698,233289,1337321
2023-05-04 11:44,1337331,592343,511698,233290,1337331
2023-05-04 11:45,1337341,592350,511701,233290,1337341
2023-05-04 11:46,1337351,592359,511701,233291,1337351
2023-05-04 11:47,1337361,592369,511701,233291,1337361
2023-05-04 11:48,1337372,592380,511701,233291,1337372
2023-05-04 11:49,1337382,592385,511705,233292,1337382
2023-05-04 11:50,1337392,592393,511705,233294,1337392
2023-05-04 11:51,1337403,592398,511710,233295,1337403
2023-05-04 11:52,1337413,592407,511710,233296,1337413
2023-05-04 11:53,1337423,592413,511713,233297,1337423
2023-05-04 11:54,1337433,592423,511713,233297,1337433
2023-05-04 11:55,1337443,592433,511713,233297,1337443
2023-05-04 11:56,1337453,592442,511713,233298,1337453
2023-05-04 11:57,1337463,592449,511716,233298,1337463
2023-05-04 11:58,1337473,592458,511716,233299,1337473
2023-05-04 11:59,1337485,592465,511718,233302,1337485
2023-05-04 12:00,1337502,592481,511718,233303,1337502
2023-05-04 12:01,1337534,592512,511719,233303,1337534
2023-05-04 12:02,1337564,592540,511719,233305,1337564
2023-05-04 12:03,1337594,592568,511721,233305,1337594
2023-05-04 12:04,1337624,592595,511721,233308,1337624
2023-05-04 12:05,1337655,592624,511722,233309,1337655
2023-05-04 12:06,1337686,592656,511722,233308,1337686
2023-05-04 12:07,1337716,592683,511725,233308,1337716
2023-05-04 12:08,1337746,592712,511725,233309,1337746
2023-05-04 12:09,1337777,592740,511728,233309,1337777
2023-05-04 12:10,1337806,592768,511728,233310,1337806
2023-05-04 12:11,1337836,592797,511729,233310,1337836
2023-05-04 12:12,1337867,592828,511729,233310,1337867
2023-05-04 12:13,1337898,592858,511730,233310,1337898
2023-05-04 12:14,1337929,592889,511730,233310,1337929
2023-05-04 12:15,1337958,592916,511730,233312,1337958
2023-05-04 12:16,1337988,592946,511730,233312,1337988
2023-05-04 12:17,1338019,592974,511733,233312,1338019
2023-05-04 12:18,1338048,593000,511736,233312,1338048
2023-05-04 12:19,1338078,593031,511736,233311,1338078
2023-05-04 12:20,1338111,593062,511738,233311,1338111
2023-05-04 12:21,1338140,593091,511738,233311,1338140
2023-05-04 12:22,1338170,593120,511737,233313,1338170
2023-05-04 12:23,1338202,593150,511737,233315,1338202
2023-05-04 12:24,1338232,593176,511740,233316,1338232
2023-05-04 12:25,1338261,593202,511742,233317,1338261
2023-05-04 12:27,1338293,593230,511746,233317,1338293
2023-05-04 12:28,1338323,593258,511746,233319,1338323
2023-05-04 12:29,1338354,593284,511750,233320,1338354
2023-05-04 12:30,1338382,593310,511750,233322,1338382
2023-05-04 12:31,1338413,593340,511752,233321,1338413
2023-05-04 12:32,1338444,593371,511752,233321,1338444
2023-05-04 12:33,1338475,593399,511753,233323,1338475
2023-05-04 12:34,1338504,593429,511753,233322,1338504
2023-05-04 12:35,1338535,593460,511753,233322,1338535
2023-05-04 12:36,1338564,593489,511753,233322,1338564
2023-05-04 12:37,1338596,593517,511756,233323,1338596
2023-05-04 12:38,1338626,593544,511756,233326,1338626
2023-05-04 12:39,1338657,593571,511759,233327,1338657
2023-05-04 12:40,1338687,593599,511759,233329,1338687
2023-05-04 12:41,1338717,593629,511759,233329,1338717
2023-05-04 12:42,1338748,593656,511762,233330,1338748
2023-05-04 12:43,1338781,593689,511762,233330,1338781
2023-05-04 12:44,1338809,593716,511762,233331,1338809
2023-05-04 12:45,1338840,593747,511762,233331,1338840
2023-05-04 12:46,1338870,593774,511764,233332,1338870
2023-05-04 12:47,1338902,593804,511764,233334,1338902
2023-05-04 12:48,1338933,593833,511766,233334,1338933
2023-05-04 12:49,1338963,593863,511766,233334,1338963
2023-05-04 12:50,1338993,593892,511767,233334,1338993
2023-05-04 12:51,1339025,593923,511767,233335,1339025
2023-05-04 12:52,1339055,593952,511768,233335,1339055
2023-05-04 12:53,1339084,593981,511768,233335,1339084
2023-05-04 12:54,1339115,594007,511771,233337,1339115
2023-05-04 12:55,1339145,594035,511771,233339,1339145
2023-05-04 12:56,1339177,594064,511774,233339,1339177
2023-05-04 12:57,1339206,594094,511774,233338,1339206
2023-05-04 12:58,1339237,594124,511775,233338,1339237
2023-05-04 12:59,1339266,594150,511776,233340,1339266
2023-05-04 13:00,1339286,594168,511777,233341,1339286
2023-05-04 13:01,1339298,594180,511777,233341,1339298
2023-05-04 13:02,1339310,594193,511777,233340,1339310
2023-05-04 13:03,1339321,594204,511777,233340,1339321
2023-05-04 13:04,1339332,594213,511779,233340,1339332
2023-05-04 13:05,1339343,594224,511779,233340,1339343
2023-05-04 13:06,1339355,594235,511781,233339,1339355
2023-05-04 13:07,1339366,594245,511781,233340,1339366
2023-05-04 13:08,1339378,594254,511783,233341,1339378
2023-05-04 13:09,1339389,594264,511783,233342,1339389
2023-05-04 13:10,1339401,594274,511784,233343,1339401
2023-05-04 13:11,1339412,594285,511784,233343,1339412
2023-05-04 13:12,1339423,594292,511788,233343,1339423
2023-05-04 13:14,1339434,594301,511790,233343,1339434
2023-05-04 13:15,1339445,594310,511790,233345,1339445
2023-05-04 13:16,1339458,594322,511790,233346,1339458
2023-05-04 13:17,1339469,594332,511790,233347,1339469
2023-05-04 13:18,1339481,594344,511790,233347,1339481
2023-05-04 13:19,1339492,594355,511790,233347,1339492
2023-05-04 13:20,1339503,594366,511790,233347,1339503
2023-05-04 13:21,1339515,594373,511792,233350,1339515
2023-05-04 13:22,1339526,594383,511792,233351,1339526
2023-05-04 13:23,1339537,594391,511795,233351,1339537
2023-05-04 13:24,1339551,594404,511795,233352,1339551
2023-05-04 13:25,1339563,594416,511795,233352,1339563
2023-05-04 13:26,1339574,594425,511796,233353,1339574
2023-05-04 13:27,1339588,594439,511796,233353,1339588
2023-05-04 13:28,1339599,594449,511796,233354,1339599
2023-05-04 13:29,1339610,594459,511796,233355,1339610
2023-05-04 13:30,1339622,594468,511798,233356,1339622
2023-05-04 13:31,1339634,594480,511798,233356,1339634
2023-05-04 13:32,1339646,594490,511799,233357,1339646
2023-05-04 13:33,1339657,594500,511799,233358,1339657
2023-05-04 13:34,1339668,594511,511799,233358,1339668
2023-05-04 13:35,1339680,594522,511799,233359,1339680
2023-05-04 13:36,1339691,594532,511800,233359,1339691
2023-05-04 13:37,1339702,594542,511800,233360,1339702
2023-05-04 13:38,1339714,594551,511802,233361,1339714
2023-05-04 13:39,1339725,594560,511802,233363,1339725
2023-05-04 13:40,1339736,594567,511804,233365,1339736
2023-05-04 13:41,1339748,594578,511804,233366,1339748
2023-05-04 13:42,1339761,594586,511809,233366,1339761
2023-05-04 13:43,1339772,594597,511809,233366,1339772
2023-05-04 13:44,1339784,594609,511809,233366,1339784
2023-05-04 13:45,1339794,594618,511809,233367,1339794
2023-05-04 13:46,1339806,594627,511812,233367,1339806
2023-05-04 13:47,1339819,594640,511812,233367,1339819
2023-05-04 13:48,1339831,594651,511813,233367,1339831
2023-05-04 13:49,1339842,594663,511813,233366,1339842
2023-05-04 13:50,1339853,594672,511815,233366,1339853
2023-05-04 13:51,1339865,594681,511817,233367,1339865
2023-05-04 13:52,1339876,594692,511817,233367,1339876
2023-05-04 13:53,1339887,594700,511820,233367,1339887
2023-05-04 13:54,1339899,594711,511820,233368,1339899
2023-05-04 13:55,1339911,594721,511822,233368,1339911
2023-05-04 13:56,1339921,594730,511822,233369,1339921
2023-05-04 13:57,1339933,594740,511823,233370,1339933
2023-05-04 13:58,1339944,594749,511823,233372,1339944
2023-05-04 13:59,1339956,594758,511826,233372,1339956
2023-05-04 14:00,1339967,594767,511828,233372,1339967
2023-05-04 14:02,1339980,594780,511828,233372,1339980
2023-05-04 14:03,1339992,594791,511829,233372,1339992
2023-05-04 14:04,1340004,594804,511829,233371,1340004
2023-05-04 14:05,1340015,594813,511831,233371,1340015
2023-05-04 14:06,1340027,594825,511831,233371,1340027
2023-05-04 14:07,1340039,594837,511831,233371,1340039
2023-05-04 14:08,1340050,594847,511831,233372,1340050
2023-05-04 14:09,1340062,594856,511835,233371,1340062
2023-05-04 14:10,1340073,594867,511835,233371,1340073
2023-05-04 14:11,1340086,594875,511837,233374,1340086
2023-05-04 14:12,1340097,594886,511837,233374,1340097
2023-05-04 14:13,1340109,594897,511838,233374,1340109
2023-05-04 14:14,1340121,594910,511838,233373,1340121
2023-05-04 14:15,1340133,594922,511838,233373,1340133
2023-05-04 14:16,1340144,594933,511838,233373,1340144
2023-05-04 14:17,1340156,594940,511842,233374,1340156
2023-05-04 14:18,1340167,594950,511842,233375,1340167
2023-05-04 14:19,1340179,594959,511845,233375,1340179
2023-05-04 14:20,1340191,594971,511845,233375,1340191
2023-05-04 14:21,1340203,594982,511845,233376,1340203
2023-05-04 14:22,1340214,594992,511845,233377,1340214
2023-05-04 14:23,1340226,595004,511845,233377,1340226
2023-05-04 14:24,1340238,595015,511845,233378,1340238
2023-05-04 14:25,1340251,595028,511845,233378,1340251
2023-05-04 14:26,1340263,595039,511845,233379,1340263
2023-05-04 14:27,1340274,595048,511846,233380,1340274
2023-05-04 14:28,1340286,595059,511846,233381,1340286
2023-05-04 14:29,1340297,595069,511846,233382,1340297
2023-05-04 14:30,1340310,595080,511846,233384,1340310
2023-05-04 14:31,1340321,595089,511847,233385,1340321
2023-05-04 14:32,1340333,595101,511847,233385,1340333
2023-05-04 14:33,1340345,595109,511849,233387,1340345
2023-05-04 14:34,1340357,595121,511849,233387,1340357
2023-05-04 14:35,1340369,595131,511850,233388,1340369
2023-05-04 14:36,1340380,595141,511850,233389,1340380
2023-05-04 14:37,1340392,595151,511852,233389,1340392
2023-05-04 14:38,1340404,595163,511852,233389,1340404
2023-05-04 14:39,1340416,595171,511855,233390,1340416
2023-05-04 14:40,1340429,595183,511855,233391,1340429
2023-05-04 14:41,1340440,595194,511855,233391,1340440
2023-05-04 14:42,1340454,595208,511855,233391,1340454
2023-05-04 14:43,1340465,595218,511856,233391,1340465
2023-05-04 14:44,1340477,595230,511856,233391,1340477
2023-05-04 14:45,1340489,595241,511857,233391,1340489
2023-05-04 14:46,1340500,595252,511857,233391,1340500
2023-05-04 14:47,1340512,595262,511858,233392,1340512
2023-05-04 14:49,1340524,595274,511858,233392,1340524
2023-05-04 14:50,1340535,595283,511860,233392,1340535
2023-05-04 14:51,1340547,595295,511860,233392,1340547
2023-05-04 14:52,1340559,595308,511859,233392,1340559
2023-05-04 14:53,1340570,595319,511859,233392,1340570
2023-05-04 14:54,1340582,595330,511860,233392,1340582
2023-05-04 14:55,1340594,595342,511860,233392,1340594
2023-05-04 14:56,1340606,595351,511862,233393,1340606
2023-05-04 14:57,1340617,595361,511862,233394,1340617
2023-05-04 14:58,1340629,595370,511863,233396,1340629
2023-05-04 14:59,1340641,595382,511863,233396,1340641
2023-05-04 15:00,1340653,595391,511864,233398,1340653
2023-05-04 15:01,1340665,595403,511864,233398,1340665
2023-05-04 15:02,1340678,595415,511864,233399,1340678
2023-05-04 15:03,1340692,595429,511864,233399,1340692
2023-05-04 15:04,1340704,595437,511867,233400,1340704
2023-05-04 15:05,1340719,595452,511867,233400,1340719
2023-05-04 15:06,1340731,595461,511869,233401,1340731
2023-05-04 15:07,1340744,595474,511869,233401,1340744
2023-05-04 15:08,1340757,595485,511871,233401,1340757
2023-05-04 15:09,1340769,595497,511871,233401,1340769
2023-05-04 15:10,1340782,595507,511872,233403,1340782
2023-05-04 15:11,1340796,595521,511872,233403,1340796
2023-05-04 15:12,1340808,595532,511873,233403,1340808
2023-05-04 15:13,1340821,595544,511874,233403,1340821
2023-05-04 15:14,1340834,595557,511874,233403,1340834
2023-05-04 15:15,1340847,595569,511874,233404,1340847
2023-05-04 15:16,1340859,595581,511874,233404,1340859
2023-05-04 15:17,1340872,595593,511874,233405,1340872
2023-05-04 15:18,1340886,595607,511874,233405,1340886
2023-05-04 15:19,1340898,595619,511874,233405,1340898
2023-05-04 15:20,1340911,595630,511874,233407,1340911
2023-05-04 15:21,1340924,595644,511874,233406,1340924
2023-05-04 15:22,1340937,595657,511874,233406,1340937
2023-05-04 15:23,1340950,595662,511880,233408,1340950
2023-05-04 15:24,1340963,595675,511880,233408,1340963
2023-05-04 15:25,1340975,595686,511880,233409,1340975
2023-05-04 15:26,1340988,595699,511880,233409,1340988
2023-05-04 15:27,1341001,595710,511880,233411,1341001
2023-05-04 15:28,1341014,595723,511880,233411,1341014
2023-05-04 15:29,1341028,595737,511880,233411,1341028
2023-05-04 15:30,1341041,595749,511880,233412,1341041
2023-05-04 15:31,1341054,595762,511880,233412,1341054
2023-05-04 15:32,1341067,595770,511884,233413,1341067
2023-05-04 15:33,1341079,595781,511884,233414,1341079
2023-05-04 15:34,1341092,595794,511884,233414,1341092
2023-05-04 15:36,1341104,595806,511884,233414,1341104
2023-05-04 15:37,1341118,595819,511884,233415,1341118
2023-05-04 15:38,1341131,595831,511884,233416,1341131
2023-05-04 15:39,1341144,595845,511884,233415,1341144
2023-05-04 15:40,1341157,595858,511884,233415,1341157
2023-05-04 15:41,1341170,595870,511884,233416,1341170
2023-05-04 15:42,1341183,595883,511884,233416,1341183
2023-05-04 15:43,1341196,595887,511889,233420,1341196
2023-05-04 15:44,1341208,595898,511889,233421,1341208
2023-05-04 15:45,1341221,595911,511889,233421,1341221
2023-05-04 15:46,1341234,595922,511889,233423,1341234
2023-05-04 15:47,1341247,595934,511889,233424,1341247
2023-05-04 15:48,1341260,595945,511889,233426,1341260
2023-05-04 15:49,1341273,595958,511889,233426,1341273
2023-05-04 15:50,1341285,595969,511889,233427,1341285
2023-05-04 15:51,1341298,595981,511889,233428,1341298
2023-05-04 15:52,1341311,595993,511889,233429,1341311
2023-05-04 15:53,1341325,595999,511895,233431,1341325
2023-05-04 15:54,1341338,596011,511895,233432,1341338
2023-05-04 15:55,1341351,596024,511895,233432,1341351
2023-05-04 15:56,1341364,596037,511895,233432,1341364
2023-05-04 15:57,1341376,596049,511895,233432,1341376
2023-05-04 15:58,1341389,596060,511895,233434,1341389
2023-05-04 15:59,1341402,596072,511895,233435,1341402
2023-05-04 16:00,1341422,596091,511895,233436,1341422
2023-05-04 16:01,1341449,596118,511895,233436,1341449
2023-05-04 16:02,1341477,596145,511895,233437,1341477
2023-05-04 16:03,1341503,596157,511907,233439,1341503
2023-05-04 16:04,1341530,596184,511907,233439,1341530
2023-05-04 16:05,1341557,596211,511907,233439,1341557
2023-05-04 16:06,1341585,596239,511907,233439,1341585
2023-05-04 16:07,1341611,596264,511907,233440,1341611
2023-05-04 16:08,1341640,596293,511907,233440,1341640
2023-05-04 16:09,1341665,596318,511907,233440,1341665
2023-05-04 16:10,1341692,596345,511907,233440,1341692
2023-05-04 16:11,1341721,596374,511907,233440,1341721
2023-05-04 16:12,1341748,596399,511907,233442,1341748
2023-05-04 16:13,1341775,596421,511911,233443,1341775
2023-05-04 16:14,1341804,596449,511911,233444,1341804
2023-05-04 16:15,1341831,596476,511911,233444,1341831
2023-05-04 16:16,1341858,596497,511916,233445,1341858
2023-05-04 16:17,1341885,596523,511916,233446,1341885
2023-05-04 16:18,1341913,596550,511916,233447,1341913
2023-05-04 16:19,1341940,596577,511916,233447,1341940
2023-05-04 16:20,1341965,596599,511918,233448,1341965
2023-05-04 16:21,1341992,596625,511918,233449,1341992
2023-05-04 16:22,1342021,596653,511919,233449,1342021
2023-05-04 16:24,1342049,596681,511919,233449,1342049
2023-05-04 16:25,1342075,596707,511919,233449,1342075
2023-05-04 16:26,1342102,596731,511919,233452,1342102
2023-05-04 16:27,1342130,596759,511919,233452,1342130
2023-05-04 16:28,1342156,596785,511919,233452,1342156
2023-05-04 16:29,1342183,596810,511919,233454,1342183
2023-05-04 16:30,1342210,596837,511919,233454,1342210
2023-05-04 16:31,1342236,596858,511923,233455,1342236
2023-05-04 16:32,1342265,596886,511923,233456,1342265
2023-05-04 16:33,1342291,596909,511925,233457,1342291
2023-05-04 16:34,1342318,596933,511927,233458,1342318
2023-05-04 16:35,1342346,596961,511927,233458,1342346
2023-05-04 16:36,1342371,596986,511927,233458,1342371
2023-05-04 16:37,1342398,597013,511927,233458,1342398
2023-05-04 16:38,1342427,597040,511928,233459,1342427
2023-05-04 16:39,1342453,597064,511928,233461,1342453
2023-05-04 16:40,1342481,597091,511928,233462,1342481
2023-05-04 16:41,1342509,597118,511928,233463,1342509
2023-05-04 16:42,1342537,597145,511929,233463,1342537
2023-05-04 16:43,1342564,597170,511930,233464,1342564
2023-05-04 16:44,1342589,597193,511930,233466,1342589
2023-05-04 16:45,1342617,597220,511930,233467,1342617
2023-05-04 16:46,1342645,597248,511930,233467,1342645
2023-05-04 16:47,1342671,597274,511930,233467,1342671
2023-05-04 16:48,1342698,597299,511930,233469,1342698
2023-05-04 16:49,1342726,597327,511930,233469,1342726
2023-05-04 16:50,1342752,597351,511930,233471,1342752
2023-05-04 16:51,1342779,597374,511934,233471,1342779
2023-05-04 16:52,1342806,597401,511934,233471,1342806
2023-05-04 16:53,1342836,597429,511935,233472,1342836
2023-05-04 16:54,1342861,597453,511935,233473,1342861
2023-05-04 16:55,1342888,597479,511936,233473,1342888
2023-05-04 16:56,1342915,597507,511936,233472,1342915
2023-05-04 16:57,1342944,597534,511938,233472,1342944
2023-05-04 16:58,1342974,597560,511938,233476,1342974
2023-05-04 16:59,1343001,597582,511942,233477,1343001
2023-05-04 17:00,1343023,597605,511941,233477,1343023
2023-05-04 17:01,1343044,597625,511941,233478,1343044
2023-05-04 17:02,1343063,597642,511942,233479,1343063
2023-05-04 17:03,1343083,597662,511942,233479,1343083
2023-05-04 17:04,1343103,597678,511946,233479,1343103
2023-05-04 17:05,1343122,597696,511946,233480,1343122
2023-05-04 17:06,1343142,597715,511947,233480,1343142
2023-05-04 17:07,1343162,597734,511947,233481,1343162
2023-05-04 17:08,1343182,597751,511949,233482,1343182
2023-05-04 17:09,1343203,597772,511949,233482,1343203
2023-05-04 17:11,1343221,597790,511949,233482,1343221
2023-05-04 17:12,1343243,597811,511950,233482,1343243
2023-05-04 17:13,1343263,597831,511950,233482,1343263
2023-05-04 17:14,1343282,597845,511955,233482,1343282
2023-05-04 17:15,1343302,597864,511955,233483,1343302
2023-05-04 17:16,1343322,597882,511956,233484,1343322
2023-05-04 17:17,1343342,597902,511956,233484,1343342
2023-05-04 17:18,1343363,597923,511956,233484,1343363
2023-05-04 17:19,1343382,597941,511956,233485,1343382
2023-05-04 17:20,1343402,597960,511955,233487,1343402
2023-05-04 17:21,1343421,597979,511955,233487,1343421
2023-05-04 17:22,1343441,597995,511959,233487,1343441
2023-05-04 17:23,1343461,598014,511959,233488,1343461
2023-05-04 17:24,1343481,598032,511961,233488,1343481
2023-05-04 17:25,1343501,598052,511961,233488,1343501
2023-05-04 17:26,1343520,598070,511962,233488,1343520
2023-05-04 17:27,1343540,598090,511962,233488,1343540
2023-05-04 17:28,1343560,598107,511964,233489,1343560
2023-05-04 17:29,1343579,598126,511964,233489,1343579
2023-05-04 17:30,1343600,598145,511965,233490,1343600
2023-05-04 17:31,1343619,598163,511965,233491,1343619
2023-05-04 17:32,1343639,598181,511966,233492,1343639
2023-05-04 17:33,1343660,598202,511966,233492,1343660
2023-05-04 17:34,1343679,598219,511967,233493,1343679
2023-05-04 17:35,1343698,598238,511967,233493,1343698
2023-05-04 17:36,1343718,598255,511968,233495,1343718
2023-05-04 17:37,1343739,598275,511968,233496,1343739
2023-05-04 17:38,1343758,598292,511970,233496,1343758
2023-05-04 17:39,1343779,598313,511970,233496,1343779
2023-05-04 17:40,1343799,598331,511971,233497,1343799
2023-05-04 17:41,1343819,598351,511971,233497,1343819
2023-05-04 17:42,1343839,598369,511972,233498,1343839
2023-05-04 17:43,1343860,598389,511972,233499,1343860
2023-05-04 17:44,1343879,598406,511974,233499,1343879
2023-05-04 17:45,1343899,598426,511974,233499,1343899
2023-05-04 17:46,1343919,598444,511975,233500,1343919
2023-05-04 17:47,1343939,598462,511975,233502,1343939
2023-05-04 17:48,1343960,598479,511977,233504,1343960
2023-05-04 17:49,1343979,598498,511977,233504,1343979
2023-05-04 17:50,1344000,598517,511978,233505,1344000
2023-05-04 17:51,1344018,598534,511978,233506,1344018
2023-05-04 17:52,1344038,598553,511979,233506,1344038
2023-05-04 17:53,1344059,598574,511979,233506,1344059
2023-05-04 17:54,1344078,598590,511982,233506,1344078
2023-05-04 17:55,1344098,598610,511982,233506,1344098
2023-05-04 17:56,1344118,598625,511984,233509,1344118
2023-05-04 17:57,1344138,598642,511986,233510,1344138
2023-05-04 17:59,1344156,598659,511986,233511,1344156
2023-05-04 18:00,1344177,598679,511987,233511,1344177
2023-05-04 18:01,1344190,598692,511987,233511,1344190
2023-05-04 18:02,1344204,598702,511991,233511,1344204
2023-05-04 18:03,1344218,598715,511991,233512,1344218
2023-05-04 18:04,1344231,598728,511991,233512,1344231
2023-05-04 18:05,1344244,598741,511991,233512,1344244
2023-05-04 18:06,1344258,598750,511995,233513,1344258
2023-05-04 18:07,1344271,598763,511995,233513,1344271
2023-05-04 18:08,1344284,598773,511998,233513,1344284
2023-05-04 18:09,1344298,598787,511998,233513,1344298
2023-05-04 18:10,1344311,598801,511997,233513,1344311
2023-05-04 18:11,1344325,598815,511997,233513,1344325
2023-05-04 18:12,1344338,598823,512002,233513,1344338
2023-05-04 18:13,1344352,598837,512002,233513,1344352
2023-05-04 18:14,1344365,598847,512003,233515,1344365
2023-05-04 18:15,1344378,598860,512003,233515,1344378
2023-05-04 18:16,1344393,598874,512004,233515,1344393
2023-05-04 18:17,1344406,598884,512004,233518,1344406
2023-05-04 18:18,1344420,598896,512006,233518,1344420
2023-05-04 18:19,1344433,598908,512006,233519,1344433
2023-05-04 18:20,1344446,598915,512009,233522,1344446
2023-05-04 18:21,1344460,598929,512009,233522,1344460
2023-05-04 18:22,1344474,598944,512009,233521,1344474
2023-05-04 18:23,1344488,598957,512009,233522,1344488
2023-05-04 18:24,1344500,598968,512010,233522,1344500
2023-05-04 18:25,1344514,598982,512010,233522,1344514
2023-05-04 18:26,1344528,598996,512010,233522,1344528
2023-05-04 18:27,1344541,599008,512010,233523,1344541
2023-05-04 18:28,1344554,599018,512013,233523,1344554
2023-05-04 18:29,1344568,599031,512013,233524,1344568
2023-05-04 18:30,1344581,599040,512016,233525,1344581
2023-05-04 18:31,1344594,599053,512016,233525,1344594
2023-05-04 18:32,1344608,599064,512018,233526,1344608
2023-05-04 18:33,1344621,599077,512018,233526,1344621
2023-05-04 18:34,1344635,599089,512019,233527,1344635
2023-05-04 18:35,1344648,599101,512019,233528,1344648
2023-05-04 18:36,1344661,599114,512019,233528,1344661
2023-05-04 18:37,1344676,599128,512019,233529,1344676
2023-05-04 18:38,1344688,599136,512022,233530,1344688
2023-05-04 18:39,1344702,599149,512023,233530,1344702
2023-05-04 18:40,1344716,599161,512023,233532,1344716
2023-05-04 18:41,1344729,599170,512025,233534,1344729
2023-05-04 18:42,1344743,599184,512025,233534,1344743
2023-05-04 18:43,1344757,599196,512025,233536,1344757
2023-05-04 18:44,1344770,599208,512025,233537,1344770
2023-05-04 18:46,1344784,599216,512026,233542,1344784
2023-05-04 18:47,1344797,599229,512026,233542,1344797
2023-05-04 18:48,1344811,599242,512027,233542,1344811
2023-05-04 18:49,1344825,599255,512027,233543,1344825
2023-05-04 18:50,1344838,599263,512031,233544,1344838
2023-05-04 18:51,1344852,599277,512031,233544,1344852
2023-05-04 18:52,1344866,599288,512032,233546,1344866
2023-05-04 18:53,1344880,599301,512033,233546,1344880
2023-05-04 18:54,1344894,599315,512033,233546,1344894
2023-05-04 18:55,1344907,599324,512036,233547,1344907
2023-05-04 18:56,1344921,599336,512036,233549,1344921
2023-05-04 18:57,1344934,599348,512037,233549,1344934
2023-05-04 18:58,1344948,599362,512037,233549,1344948
2023-05-04 18:59,1344961,599369,512040,233552,1344961
2023-05-04 19:00,1344973,599380,512040,233553,1344973
2023-05-04 19:01,1344979,599383,512043,233553,1344979
2023-05-04 19:02,1344985,599389,512043,233553,1344985
2023-05-04 19:03,1344992,599391,512048,233553,1344992
2023-05-04 19:04,1344998,599396,512048,233554,1344998
2023-05-04 19:05,1345005,599398,512051,233556,1345005
2023-05-04 19:06,1345011,599403,512051,233557,1345011
2023-05-04 19:07,1345019,599406,512055,233558,1345019
2023-05-04 19:08,1345024,599411,512055,233558,1345024
2023-05-04 19:09,1345032,599417,512057,233558,1345032
2023-05-04 19:10,1345038,599420,512057,233561,1345038
2023-05-04 19:11,1345045,599425,512059,233561,1345045
2023-05-04 19:12,1345051,599428,512062,233561,1345051
2023-05-04 19:13,1345057,599434,512062,233561,1345057
2023-05-04 19:14,1345064,599438,512064,233562,1345064
2023-05-04 19:15,1345071,599445,512064,233562,1345071
2023-05-04 19:16,1345077,599450,512065,233562,1345077
2023-05-04 19:17,1345083,599454,512065,233564,1345083
2023-05-04 19:18,1345090,599459,512066,233565,1345090
2023-05-04 19:19,1345096,599465,512066,233565,1345096
2023-05-04 19:20,1345102,599468,512069,233565,1345102
2023-05-04 19:21,1345111,599475,512069,233567,1345111
2023-05-04 19:22,1345117,599481,512069,233567,1345117
2023-05-04 19:23,1345123,599487,512069,233567,1345123
2023-05-04 19:24,1345130,599491,512070,233569,1345130
2023-05-04 19:25,1345136,599497,512070,233569,1345136
2023-05-04 19:26,1345143,599499,512075,233569,1345143
2023-05-04 19:27,1345149,599504,512076,233569,1345149
2023-05-04 19:28,1345157,599511,512076,233570,1345157
2023-05-04 19:29,1345163,599514,512079,233570,1345163
2023-05-04 19:30,1345170,599521,512079,233570,1345170
2023-05-04 19:31,1345176,599526,512080,233570,1345176
2023-05-04 19:32,1345182,599533,512080,233569,1345182
2023-05-04 19:34,1345188,599535,512081,233572,1345188
2023-05-04 19:35,1345195,599542,512081,233572,1345195
2023-05-04 19:36,1345201,599545,512083,233573,1345201
2023-05-04 19:37,1345208,599551,512083,233574,1345208
2023-05-04 19:38,1345215,599558,512083,233574,1345215
2023-05-04 19:39,1345221,599564,512083,233574,1345221
2023-05-04 19:40,1345227,599567,512085,233575,1345227
2023-05-04 19:41,1345234,599572,512085,233577,1345234
2023-05-04 19:42,1345240,599573,512088,233579,1345240
2023-05-04 19:43,1345247,599580,512088,233579,1345247
2023-05-04 19:44,1345254,599582,512093,233579,1345254
2023-05-04 19:45,1345260,599588,512093,233579,1345260
2023-05-04 19:46,1345266,599590,512096,233580,1345266
2023-05-04 19:47,1345273,599596,512097,233580,1345273
2023-05-04 19:48,1345280,599603,512097,233580,1345280
2023-05-04 19:49,1345287,599608,512099,233580,1345287
2023-05-04 19:50,1345295,599612,512102,233581,1345295
2023-05-04 19:51,1345301,599616,512102,233583,1345301
2023-05-04 19:52,1345307,599620,512103,233584,1345307
2023-05-04 19:53,1345313,599625,512103,233585,1345313
2023-05-04 19:54,1345322,599631,512106,233585,1345322
2023-05-04 19:55,1345328,599637,512106,233585,1345328
2023-05-04 19:56,1345335,599641,512109,233585,1345335
2023-05-04 19:57,1345342,599647,512109,233586,1345342
2023-05-04 19:58,1345348,599650,512112,233586,1345348
2023-05-04 19:59,1345354,599656,512112,233586,1345354
2023-05-04 20:00,1345364,599664,512113,233587,1345364
2023-05-04 20:01,1345376,599676,512113,233587,1345376
2023-05-04 20:02,1345389,599685,512117,233587,1345389
2023-05-04 20:03,1345402,599698,512117,233587,1345402
2023-05-04 20:04,1345414,599707,512119,233588,1345414
2023-05-04 20:05,1345426,599719,512119,233588,1345426
2023-05-04 20:06,1345440,599731,512121,233588,1345440
2023-05-04 20:07,1345451,599742,512121,233588,1345451
2023-05-04 20:08,1345465,599754,512123,233588,1345465
2023-05-04 20:09,1345477,599765,512123,233589,1345477
2023-05-04 20:10,1345490,599774,512125,233591,1345490
2023-05-04 20:11,1345502,599785,512125,233592,1345502
2023-05-04 20:12,1345516,599797,512127,233592,1345516
2023-05-04 20:13,1345528,599809,512127,233592,1345528
2023-05-04 20:14,1345540,599818,512130,233592,1345540
2023-05-04 20:15,1345554,599832,512130,233592,1345554
2023-05-04 20:16,1345567,599842,512133,233592,1345567
2023-05-04 20:17,1345579,599853,512134,233592,1345579
2023-05-04 20:18,1345592,599867,512134,233591,1345592
2023-05-04 20:19,1345606,599879,512135,233592,1345606
2023-05-04 20:21,1345619,599890,512135,233594,1345619
2023-05-04 20:22,1345635,599903,512138,233594,1345635
2023-05-04 20:23,1345648,599915,512138,233595,1345648
2023-05-04 20:24,1345661,599924,512141,233596,1345661
2023-05-04 20:25,1345673,599932,512143,233598,1345673
2023-05-04 20:26,1345686,599945,512143,233598,1345686
2023-05-04 20:27,1345698,599957,512143,233598,1345698
2023-05-04 20:28,1345711,599968,512143,233600,1345711
2023-05-04 20:29,1345725,599979,512145,233601,1345725
2023-05-04 20:30,1345736,599990,512145,233601,1345736
2023-05-04 20:31,1345749,600000,512148,233601,1345749
2023-05-04 20:32,1345762,600012,512148,233602,1345762
2023-05-04 20:33,1345776,600025,512149,233602,1345776
2023-05-04 20:34,1345789,600038,512149,233602,1345789
2023-05-04 20:35,1345802,600050,512150,233602,1345802
2023-05-04 20:36,1345814,600062,512150,233602,1345814
2023-05-04 20:37,1345827,600072,512153,233602,1345827
2023-05-04 20:38,1345839,600084,512153,233602,1345839
2023-05-04 20:39,1345851,600095,512154,233602,1345851
2023-05-04 20:40,1345864,600107,512155,233602,1345864
2023-05-04 20:41,1345878,600121,512155,233602,1345878
2023-05-04 20:42,1345890,600133,512155,233602,1345890
2023-05-04 20:43,1345902,600142,512155,233605,1345902
2023-05-04 20:44,1345916,600155,512156,233605,1345916
2023-05-04 20:45,1345929,600168,512156,233605,1345929
2023-05-04 20:46,1345942,600175,512161,233606,1345942
2023-05-04 20:47,1345956,600189,512161,233606,1345956
2023-05-04 20:48,1345970,600199,512165,233606,1345970
2023-05-04 20:49,1345982,600211,512165,233606,1345982
2023-05-04 20:50,1345995,600223,512167,233605,1345995
2023-05-04 20:51,1346007,600235,512167,233605,1346007
2023-05-04 20:52,1346021,600248,512166,233607,1346021
2023-05-04 20:53,1346034,600261,512166,233607,1346034
2023-05-04 20:54,1346047,600269,512169,233609,1346047
2023-05-04 20:55,1346061,600280,512171,233610,1346061
2023-05-04 20:56,1346073,600290,512171,233612,1346073
2023-05-04 20:57,1346086,600299,512175,233612,1346086
2023-05-04 20:58,1346098,600309,512175,233614,1346098
2023-05-04 20:59,1346111,600319,512178,233614,1346111
2023-05-04 21:00,1346131,600339,512178,233614,1346131
2023-05-04 21:01,1346152,600358,512180,233614,1346152
2023-05-04 21:02,1346173,600378,512180,233615,1346173
2023-05-04 21:03,1346194,600399,512180,233615,1346194
2023-05-04 21:04,1346215,600420,512180,233615,1346215
2023-05-04 21:05,1346237,600440,512182,233615,1346237
2023-05-04 21:06,1346257,600460,512182,233615,1346257
2023-05-04 21:07,1346277,600480,512182,233615,1346277
2023-05-04 21:09,1346299,600500,512182,233617,1346299
2023-05-04 21:10,1346320,600519,512184,233617,1346320
2023-05-04 21:11,1346340,600538,512184,233618,1346340
2023-05-04 21:12,1346363,600559,512185,233619,1346363
2023-05-04 21:13,1346383,600579,512185,233619,1346383
2023-05-04 21:14,1346403,600594,512187,233622,1346403
2023-05-04 21:15,1346424,600614,512187,233623,1346424
2023-05-04 21:16,1346445,600634,512187,233624,1346445
2023-05-04 21:17,1346467,600655,512187,233625,1346467
2023-05-04 21:18,1346487,600671,512190,233626,1346487
2023-05-04 21:19,1346508,600691,512190,233627,1346508
2023-05-04 21:20,1346529,600706,512195,233628,1346529
2023-05-04 21:21,1346550,600725,512195,233630,1346550
2023-05-04 21:22,1346570,600743,512197,233630,1346570
2023-05-04 21:23,1346592,600760,512200,233632,1346592
2023-05-04 21:24,1346612,600780,512200,233632,1346612
2023-05-04 21:25,1346633,600796,512204,233633,1346633
2023-05-04 21:26,1346653,600815,512204,233634,1346653
2023-05-04 21:27,1346674,600833,512204,233637,1346674
2023-05-04 21:28,1346694,600850,512206,233638,1346694
2023-05-04 21:29,1346714,600870,512206,233638,1346714
2023-05-04 21:30,1346735,600888,512206,233641,1346735
2023-05-04 21:31,1346757,600909,512206,233642,1346757
2023-05-04 21:32,1346778,600928,512208,233642,1346778
2023-05-04 21:33,1346799,600948,512208,233643,1346799
2023-05-04 21:34,1346819,600968,512208,233643,1346819
2023-05-04 21:35,1346840,600987,512208,233645,1346840
2023-05-04 21:36,1346862,601003,512213,233646,1346862
2023-05-04 21:37,1346882,601023,512213,233646,1346882
2023-05-04 21:38,1346903,601036,512219,233648,1346903
2023-05-04 21:39,1346924,601056,512219,233649,1346924
2023-05-04 21:40,1346943,601073,512221,233649,1346943
2023-05-04 21:41,1346965,601094,512221,233650,1346965
2023-05-04 21:42,1346987,601111,512226,233650,1346987
2023-05-04 21:43,1347009,601130,512228,233651,1347009
2023-05-04 21:44,1347030,601151,512228,233651,1347030
2023-05-04 21:45,1347050,601169,512230,233651,1347050
2023-05-04 21:46,1347072,601190,512231,233651,1347072
2023-05-04 21:47,1347093,601209,512231,233653,1347093
2023-05-04 21:48,1347114,601224,512237,233653,1347114
2023-05-04 21:49,1347135,601242,512237,233656,1347135
2023-05-04 21:50,1347156,601261,512238,233657,1347156
2023-05-04 21:51,1347175,601280,512238,233657,1347175
2023-05-04 21:52,1347197,601295,512244,233658,1347197
2023-05-04 21:53,1347218,601315,512244,233659,1347218
2023-05-04 21:54,1347239,601335,512244,233660,1347239
2023-05-04 21:56,1347260,601355,512244,233661,1347260
2023-05-04 21:57,1347281,601368,512249,233664,1347281
2023-05-04 21:58,1347302,601388,512249,233665,1347302
2023-05-04 21:59,1347323,601406,512252,233665,1347323
2023-05-04 22:00,1347343,601425,512252,233666,1347343
2023-05-04 22:01,1347351,601429,512254,233668,1347351
2023-05-04 22:02,1347359,601437,512254,233668,1347359
2023-05-04 22:03,1347366,601438,512258,233670,1347366
2023-05-04 22:04,1347373,601444,512258,233671,1347373
2023-05-04 22:05,1347380,601449,512259,233672,1347380
2023-05-04 22:06,1347389,601459,512259,233671,1347389
2023-05-04 22:07,1347396,601464,512260,233672,1347396
2023-05-04 22:08,1347404,601472,512260,233672,1347404
2023-05-04 22:09,1347412,601472,512265,233675,1347412
2023-05-04 22:10,1347421,601479,512266,233676,1347421
2023-05-04 22:11,1347431,601487,512266,233678,1347431
2023-05-04 22:12,1347438,601488,512270,233680,1347438
2023-05-04 22:13,1347447,601497,512270,233680,1347447
2023-05-04 22:14,1347454,601502,512271,233681,1347454
2023-05-04 22:15,1347461,601508,512271,233682,1347461
2023-05-04 22:16,1347469,601509,512276,233684,1347469
2023-05-04 22:17,1347476,601514,512276,233686,1347476
2023-05-04 22:18,1347483,601520,512277,233686,1347483
2023-05-04 22:19,1347492,601529,512277,233686,1347492
2023-05-04 22:20,1347499,601536,512277,233686,1347499
2023-05-04 22:21,1347506,601543,512277,233686,1347506
2023-05-04 22:22,1347514,601548,512279,233687,1347514
2023-05-04 22:23,1347521,601553,512279,233689,1347521
2023-05-04 22:24,1347528,601558,512279,233691,1347528
2023-05-04 22:25,1347536,601564,512279,233693,1347536
2023-05-04 22:26,1347543,601567,512283,233693,1347543
2023-05-04 22:27,1347550,601574,512283,233693,1347550
2023-05-04 22:28,1347559,601582,512284,233693,1347559
2023-05-04 22:29,1347566,601586,512287,233693,1347566
2023-05-04 22:30,1347573,601592,512287,233694,1347573
2023-05-04 22:31,1347581,601599,512287,233695,1347581
2023-05-04 22:32,1347588,601604,512287,233697,1347588
2023-05-04 22:33,1347595,601609,512289,233697,1347595
2023-05-04 22:34,1347603,601616,512289,233698,1347603
2023-05-04 22:35,1347611,601620,512293,233698,1347611
2023-05-04 22:36,1347618,601627,512293,233698,1347618
2023-05-04 22:37,1347626,601631,512296,233699,1347626
2023-05-04 22:38,1347633,601637,512296,233700,1347633
2023-05-04 22:39,1347641,601641,512299,233701,1347641
2023-05-04 22:40,1347648,601648,512299,233701,1347648
2023-05-04 22:41,1347655,601651,512303,233701,1347655
2023-05-04 22:42,1347663,601659,512303,233701,1347663
2023-05-04 22:44,1347670,601663,512306,233701,1347670
2023-05-04 22:45,1347677,601669,512306,233702,1347677
2023-05-04 22:46,1347685,601675,512307,233703,1347685
2023-05-04 22:47,1347692,601682,512307,233703,1347692
2023-05-04 22:48,1347699,601688,512307,233704,1347699
2023-05-04 22:49,1347707,601695,512307,233705,1347707
2023-05-04 22:50,1347715,601703,512307,233705,1347715
2023-05-04 22:51,1347723,601703,512314,233706,1347723
2023-05-04 22:52,1347730,601710,512314,233706,1347730
2023-05-04 22:53,1347737,601714,512316,233707,1347737
2023-05-04 22:54,1347744,601719,512316,233709,1347744
2023-05-04 22:55,1347752,601724,512319,233709,1347752
2023-05-04 22:56,1347759,601725,512325,233709,1347759
2023-05-04 22:57,1347767,601733,512325,233709,1347767
2023-05-04 22:58,1347774,601737,512327,233710,1347774
2023-05-04 22:59,1347781,601743,512327,233711,1347781
2023-05-04 23:00,1347792,601751,512330,233711,1347792
2023-05-04 23:01,1347811,601766,512332,233713,1347811
2023-05-04 23:02,1347830,601784,512332,233714,1347830
2023-05-04 23:03,1347849,601797,512338,233714,1347849
2023-05-04 23:04,1347867,601815,512338,233714,1347867
2023-05-04 23:05,1347886,601831,512338,233717,1347886
2023-05-04 23:06,1347905,601849,512338,233718,1347905
2023-05-04 23:07,1347924,601867,512338,233719,1347924
2023-05-04 23:08,1347942,601881,512338,233723,1347942
2023-05-04 23:09,1347961,601900,512338,233723,1347961
2023-05-04 23:10,1347980,601919,512338,233723,1347980
2023-05-04 23:11,1347998,601936,512338,233724,1347998
2023-05-04 23:12,1348017,601953,512338,233726,1348017
2023-05-04 23:13,1348035,601949,512357,233729,1348035
2023-05-04 23:14,1348054,601968,512357,233729,1348054
2023-05-04 23:15,1348073,601987,512357,233729,1348073
2023-05-04 23:16,1348091,602003,512357,233731,1348091
2023-05-04 23:17,1348110,602019,512357,233734,1348110
2023-05-04 23:18,1348129,602037,512357,233735,1348129
2023-05-04 23:19,1348147,602055,512357,233735,1348147
2023-05-04 23:20,1348166,602074,512357,233735,1348166
2023-05-04 23:21,1348184,602091,512357,233736,1348184
2023-05-04 23:22,1348203,602109,512357,233737,1348203
2023-05-04 23:23,1348221,602115,512367,233739,1348221
2023-05-04 23:24,1348240,602133,512367,233740,1348240
2023-05-04 23:25,1348259,602149,512368,233742,1348259
2023-05-04 23:26,1348276,602163,512370,233743,1348276
2023-05-04 23:27,1348296,602181,512370,233745,1348296
2023-05-04 23:28,1348314,602194,512371,233749,1348314
2023-05-04 23:29,1348333,602212,512371,233750,1348333
2023-05-04 23:31,1348352,602223,512376,233753,1348352
2023-05-04 23:32,1348371,602241,512376,233754,1348371
2023-05-04 23:33,1348390,602251,512383,233756,1348390
2023-05-04 23:34,1348408,602269,512383,233756,1348408
2023-05-04 23:35,1348428,602289,512383,233756,1348428
2023-05-04 23:36,1348446,602307,512383,233756,1348446
2023-05-04 23:37,1348464,602323,512385,233756,1348464
2023-05-04 23:38,1348483,602340,512385,233758,1348483
2023-05-04 23:39,1348502,602358,512386,233758,1348502
2023-05-04 23:40,1348520,602375,512386,233759,1348520
2023-05-04 23:41,1348538,602389,512389,233760,1348538
2023-05-04 23:42,1348557,602406,512389,233762,1348557
2023-05-04 23:43,1348575,602421,512392,233762,1348575
2023-05-04 23:44,1348594,602440,512392,233762,1348594
2023-05-04 23:45,1348613,602458,512392,233763,1348613
2023-05-04 23:46,1348632,602476,512392,233764,1348632
2023-05-04 23:47,1348651,602493,512392,233766,1348651
2023-05-04 23:48,1348669,602510,512392,233767,1348669
2023-05-04 23:49,1348687,602520,512400,233767,1348687
2023-05-04 23:50,1348705,602536,512400,233769,1348705
2023-05-04 23:51,1348725,602554,512402,233769,1348725
2023-05-04 23:52,1348743,602570,512402,233771,1348743
2023-05-04 23:53,1348762,602586,512402,233774,1348762
2023-05-04 23:54,1348780,602602,512402,233776,1348780
2023-05-04 23:55,1348800,602618,512406,233776,1348800
2023-05-04 23:56,1348818,602633,512408,233777,1348818
2023-05-04 23:57,1348836,602651,512408,233777,1348836
2023-05-04 23:58,1348855,602668,512409,233778,1348855
2023-05-04 23:59,1348873,602686,512409,233778,1348873
2023-05-05 00:00,1348901,602710,512412,233779,1348901
2023-05-05 00:01,1348934,602741,512412,233781,1348934
2023-05-05 00:02,1348969,602773,512415,233781,1348969
2023-05-05 00:03,1349003,602806,512415,233782,1349003
2023-05-05 00:04,1349037,602835,512419,233783,1349037
2023-05-05 00:05,1349073,602871,512419,233783,1349073
2023-05-05 00:06,1349105,602901,512420,233784,1349105
2023-05-05 00:07,1349140,602936,512420,233784,1349140
2023-05-05 00:08,1349173,602964,512423,233786,1349173
2023-05-05 00:09,1349208,602998,512423,233787,1349208
2023-05-05 00:10,1349242,603027,512426,233789,1349242
2023-05-05 00:11,1349276,603056,512427,233793,1349276
2023-05-05 00:12,1349309,603089,512427,233793,1349309
2023-05-05 00:13,1349344,603122,512428,233794,1349344
2023-05-05 00:14,1349378,603156,512428,233794,1349378
2023-05-05 00:16,1349414,603187,512431,233796,1349414
2023-05-05 00:17,1349449,603221,512432,233796,1349449
2023-05-05 00:18,1349481,603251,512434,233796,1349481
2023-05-05 00:19,1349517,603284,512434,233799,1349517
2023-05-05 00:20,1349551,603315,512436,233800,1349551
2023-05-05 00:21,1349585,603346,512436,233803,1349585
2023-05-05 00:22,1349619,603377,512438,233804,1349619
2023-05-05 00:23,1349654,603411,512438,233805,1349654
2023-05-05 00:24,1349686,603437,512441,233808,1349686
2023-05-05 00:25,1349720,603470,512441,233809,1349720
2023-05-05 00:26,1349755,603501,512445,233809,1349755
2023-05-05 00:27,1349790,603536,512445,233809,1349790
2023-05-05 00:28,1349824,603568,512447,233809,1349824
2023-05-05 00:29,1349857,603601,512447,233809,1349857
2023-05-05 00:30,1349891,603633,512448,233810,1349891
2023-05-05 00:31,1349924,603665,512448,233811,1349924
2023-05-05 00:32,1349957,603695,512450,233812,1349957
2023-05-05 00:33,1349991,603729,512450,233812,1349991
2023-05-05 00:34,1350025,603761,512452,233812,1350025
2023-05-05 00:35,1350060,603796,512452,233812,1350060
2023-05-05 00:36,1350094,603828,512452,233814,1350094
2023-05-05 00:37,1350129,603863,512452,233814,1350129
2023-05-05 00:38,1350162,603893,512455,233814,1350162
2023-05-05 00:39,1350196,603927,512455,233814,1350196
2023-05-05 00:40,1350229,603958,512457,233814,1350229
2023-05-05 00:41,1350263,603991,512457,233815,1350263
2023-05-05 00:42,1350298,604024,512459,233815,1350298
2023-05-05 00:43,1350332,604057,512459,233816,1350332
2023-05-05 00:44,1350364,604087,512460,233817,1350364
2023-05-05 00:45,1350398,604120,512460,233818,1350398
2023-05-05 00:46,1350431,604151,512461,233819,1350431
2023-05-05 00:47,1350467,604186,512461,233820,1350467
2023-05-05 00:48,1350500,604217,512462,233821,1350500
2023-05-05 00:49,1350533,604250,512462,233821,1350533
2023-05-05 00:50,1350567,604281,512464,233822,1350567
2023-05-05 00:51,1350602,604316,512464,233822,1350602
2023-05-05 00:52,1350635,604346,512466,233823,1350635
2023-05-05 00:53,1350670,604380,512466,233824,1350670
2023-05-05 00:54,1350703,604411,512468,233824,1350703
2023-05-05 00:55,1350737,604445,512468,233824,1350737
2023-05-05 00:56,1350771,604477,512470,233824,1350771
2023-05-05 00:57,1350804,604510,512470,233824,1350804
2023-05-05 00:58,1350837,604541,512470,233826,1350837
2023-05-05 00:59,1350873,604577,512470,233826,1350873
2023-05-05 01:00,1350902,604604,512472,233826,1350902
2023-05-05 01:01,1350929,604631,512472,233826,1350929
2023-05-05 01:03,1350957,604655,512475,233827,1350957
2023-05-05 01:04,1350984,604682,512475,233827,1350984
2023-05-05 01:05,1351012,604705,512478,233829,1351012
2023-05-05 01:06,1351039,604731,512478,233830,1351039
2023-05-05 01:07,1351067,604759,512478,233830,1351067
2023-05-05 01:08,1351097,604789,512478,233830,1351097
2023-05-05 01:09,1351124,604815,512478,233831,1351124
2023-05-05 01:10,1351152,604842,512478,233832,1351152
2023-05-05 01:11,1351178,604865,512479,233834,1351178
2023-05-05 01:12,1351207,604894,512479,233834,1351207
2023-05-05 01:13,1351235,604920,512480,233835,1351235
2023-05-05 01:14,1351261,604945,512480,233836,1351261
2023-05-05 01:15,1351289,604972,512481,233836,1351289
2023-05-05 01:16,1351318,605001,512481,233836,1351318
2023-05-05 01:17,1351345,605027,512482,233836,1351345
2023-05-05 01:18,1351373,605055,512482,233836,1351373
2023-05-05 01:19,1351401,605080,512485,233836,1351401
2023-05-05 01:20,1351429,605103,512487,233839,1351429
2023-05-05 01:21,1351456,605129,512487,233840,1351456
2023-05-05 01:22,1351484,605156,512488,233840,1351484
2023-05-05 01:23,1351511,605183,512488,233840,1351511
2023-05-05 01:24,1351541,605211,512490,233840,1351541
2023-05-05 01:25,1351569,605238,512490,233841,1351569
2023-05-05 01:26,1351596,605263,512491,233842,1351596
2023-05-05 01:27,1351625,605291,512491,233843,1351625
2023-05-05 01:28,1351651,605316,512492,233843,1351651
2023-05-05 01:29,1351679,605344,512492,233843,1351679
2023-05-05 01:30,1351706,605370,512493,233843,1351706
2023-05-05 01:31,1351736,605400,512493,233843,1351736
2023-05-05 01:32,1351764,605427,512494,233843,1351764
2023-05-05 01:33,1351790,605453,512494,233843,1351790
2023-05-05 01:34,1351820,605481,512495,233844,1351820
2023-05-05 01:35,1351847,605508,512495,233844,1351847
2023-05-05 01:36,1351875,605532,512498,233845,1351875
2023-05-05 01:37,1351903,605560,512498,233845,1351903
2023-05-05 01:38,1351930,605582,512502,233846,1351930
2023-05-05 01:39,1351959,605611,512502,233846,1351959
2023-05-05 01:40,1351986,605638,512502,233846,1351986
2023-05-05 01:41,1352014,605666,512502,233846,1352014
2023-05-05 01:42,1352041,605690,512504,233847,1352041
2023-05-05 01:43,1352070,605719,512504,233847,1352070
2023-05-05 01:44,1352099,605747,512505,233847,1352099
2023-05-05 01:45,1352126,605773,512505,233848,1352126
2023-05-05 01:46,1352155,605801,512506,233848,1352155
2023-05-05 01:47,1352182,605828,512506,233848,1352182
2023-05-05 01:48,1352210,605855,512506,233849,1352210
2023-05-05 01:49,1352238,605882,512506,233850,1352238
2023-05-05 01:50,1352264,605908,512506,233850,1352264
2023-05-05 01:52,1352292,605936,512506,233850,1352292
2023-05-05 01:53,1352321,605962,512507,233852,1352321
2023-05-05 01:54,1352349,605990,512507,233852,1352349
2023-05-05 01:55,1352378,606019,512506,233853,1352378
2023-05-05 01:56,1352406,606047,512506,233853,1352406
2023-05-05 01:57,1352434,606073,512508,233853,1352434
2023-05-05 01:58,1352462,606101,512508,233853,1352462
2023-05-05 01:59,1352490,606129,512508,233853,1352490
2023-05-05 02:00,1352517,606156,512508,233853,1352517
2023-05-05 02:01,1352551,606188,512510,233853,1352551
2023-05-05 02:02,1352588,606223,512512,233853,1352588
2023-05-05 02:03,1352621,606255,512512,233854,1352621
2023-05-05 02:04,1352655,606288,512512,233855,1352655
2023-05-05 02:05,1352689,606321,512512,233856,1352689
2023-05-05 02:06,1352724,606356,512512,233856,1352724
2023-05-05 02:07,1352756,606388,512512,233856,1352756
2023-05-05 02:08,1352791,606423,512512,233856,1352791
2023-05-05 02:09,1352827,606459,512512,233856,1352827
2023-05-05 02:10,1352859,606491,512512,233856,1352859
2023-05-05 02:11,1352894,606526,512512,233856,1352894
2023-05-05 02:12,1352929,606558,512514,233857,1352929
2023-05-05 02:13,1352962,606590,512514,233858,1352962
2023-05-05 02:14,1352996,606624,512514,233858,1352996
2023-05-05 02:15,1353033,606660,512514,233859,1353033
2023-05-05 02:16,1353066,606691,512515,233860,1353066
2023-05-05 02:17,1353099,606724,512515,233860,1353099
2023-05-05 02:18,1353133,606757,512515,233861,1353133
2023-05-05 02:19,1353168,606792,512515,233861,1353168
2023-05-05 02:20,1353203,606826,512516,233861,1353203
2023-05-05 02:21,1353237,606860,512516,233861,1353237
2023-05-05 02:22,1353271,606894,512516,233861,1353271
2023-05-05 02:23,1353307,606930,512516,233861,1353307
2023-05-05 02:24,1353340,606962,512517,233861,1353340
2023-05-05 02:25,1353374,606994,512517,233863,1353374
2023-05-05 02:26,1353408,607022,512523,233863,1353408
2023-05-05 02:27,1353441,607053,512524,233864,1353441
2023-05-05 02:28,1353478,607090,512524,233864,1353478
2023-05-05 02:29,1353512,607122,512526,233864,1353512
2023-05-05 02:30,1353545,607155,512526,233864,1353545
2023-05-05 02:31,1353579,607188,512527,233864,1353579
2023-05-05 02:32,1353614,607223,512527,233864,1353614
2023-05-05 02:33,1353647,607254,512528,233865,1353647
2023-05-05 02:34,1353684,607291,512528,233865,1353684
2023-05-05 02:35,1353716,607323,512528,233865,1353716
2023-05-05 02:36,1353751,607358,512528,233865,1353751
2023-05-05 02:37,1353786,607392,512529,233865,1353786
2023-05-05 02:39,1353820,607426,512529,233865,1353820
2023-05-05 02:40,1353855,607460,512530,233865,1353855
2023-05-05 02:41,1353889,607494,512530,233865,1353889
2023-05-05 02:42,1353921,607526,512530,233865,1353921
2023-05-05 02:43,1353957,607562,512530,233865,1353957
2023-05-05 02:44,1353990,607595,512530,233865,1353990
2023-05-05 02:45,1354025,607630,512530,233865,1354025
2023-05-05 02:46,1354060,607665,512530,233865,1354060
2023-05-05 02:47,1354095,607700,512530,233865,1354095
2023-05-05 02:48,1354127,607732,512530,233865,1354127
2023-05-05 02:49,1354162,607767,512530,233865,1354162
2023-05-05 02:50,1354195,607795,512533,233867,1354195
2023-05-05 02:51,1354232,607831,512533,233868,1354232
2023-05-05 02:52,1354264,607862,512533,233869,1354264
2023-05-05 02:53,1354299,607897,512533,233869,1354299
2023-05-05 02:54,1354335,607933,512533,233869,1354335
2023-05-05 02:55,1354367,607963,512533,233871,1354367
2023-05-05 02:56,1354403,607999,512533,233871,1354403
2023-05-05 02:57,1354435,608031,512533,233871,1354435
2023-05-05 02:58,1354469,608064,512533,233872,1354469
2023-05-05 02:59,1354506,608101,512533,233872,1354506
2023-05-05 03:00,1354529,608122,512535,233872,1354529
2023-05-05 03:01,1354538,608130,512535,233873,1354538
2023-05-05 03:02,1354546,608138,512535,233873,1354546
2023-05-05 03:03,1354556,608148,512535,233873,1354556
2023-05-05 03:04,1354564,608154,512537,233873,1354564
2023-05-05 03:05,1354573,608162,512537,233874,1354573
2023-05-05 03:06,1354582,608170,512538,233874,1354582
2023-05-05 03:07,1354591,608179,512538,233874,1354591
2023-05-05 03:08,1354600,608187,512539,233874,1354600
2023-05-05 03:09,1354608,608195,512539,233874,1354608
2023-05-05 03:10,1354617,608204,512539,233874,1354617
2023-05-05 03:11,1354626,608213,512539,233874,1354626
2023-05-05 03:12,1354635,608222,512539,233874,1354635
2023-05-05 03:13,1354644,608231,512539,233874,1354644
2023-05-05 03:14,1354653,608239,512540,233874,1354653
2023-05-05 03:15,1354662,608248,512540,233874,1354662
2023-05-05 03:16,1354670,608256,512540,233874,1354670
2023-05-05 03:17,1354679,608265,512540,233874,1354679
2023-05-05 03:18,1354688,608274,512540,233874,1354688
2023-05-05 03:19,1354698,608284,512540,233874,1354698
2023-05-05 03:20,1354707,608291,512541,233875,1354707
2023-05-05 03:21,1354715,608298,512542,233875,1354715
2023-05-05 03:22,1354725,608308,512542,233875,1354725
2023-05-05 03:23,1354734,608316,512542,233876,1354734
2023-05-05 03:25,1354742,608324,512542,233876,1354742
2023-05-05 03:26,1354751,608332,512542,233877,1354751
2023-05-05 03:27,1354760,608341,512542,233877,1354760
2023-05-05 03:28,1354769,608349,512543,233877,1354769
2023-05-05 03:29,1354778,608358,512543,233877,1354778
2023-05-05 03:30,1354787,608367,512543,233877,1354787
2023-05-05 03:31,1354795,608375,512543,233877,1354795
2023-05-05 03:32,1354804,608384,512543,233877,1354804
2023-05-05 03:33,1354813,608393,512543,233877,1354813
2023-05-05 03:34,1354822,608401,512543,233878,1354822
2023-05-05 03:35,1354831,608410,512543,233878,1354831
2023-05-05 03:36,1354839,608417,512543,233879,1354839
2023-05-05 03:37,1354849,608427,512543,233879,1354849
2023-05-05 03:38,1354858,608436,512543,233879,1354858
2023-05-05 03:39,1354867,608445,512543,233879,1354867
2023-05-05 03:40,1354876,608454,512543,233879,1354876
2023-05-05 03:41,1354884,608462,512543,233879,1354884
2023-05-05 03:42,1354893,608471,512543,233879,1354893
2023-05-05 03:43,1354902,608480,512543,233879,1354902
2023-05-05 03:44,1354911,608488,512544,233879,1354911
2023-05-05 03:45,1354920,608496,512544,233880,1354920
2023-05-05 03:46,1354929,608505,512544,233880,1354929
2023-05-05 03:47,1354938,608514,512544,233880,1354938
2023-05-05 03:48,1354946,608522,512544,233880,1354946
2023-05-05 03:49,1354955,608531,512544,233880,1354955
2023-05-05 03:50,1354964,608539,512545,233880,1354964
2023-05-05 03:51,1354973,608548,512545,233880,1354973
2023-05-05 03:52,1354982,608556,512546,233880,1354982
2023-05-05 03:53,1354990,608564,512546,233880,1354990
2023-05-05 03:54,1355000,608573,512547,233880,1355000
2023-05-05 03:55,1355008,608581,512547,233880,1355008
2023-05-05 03:56,1355017,608590,512547,233880,1355017
2023-05-05 03:57,1355026,608599,512547,233880,1355026
2023-05-05 03:58,1355035,608608,512547,233880,1355035
2023-05-05 03:59,1355044,608616,512547,233881,1355044
2023-05-05 04:00,1355059,608631,512547,233881,1355059
2023-05-05 04:01,1355077,608649,512547,233881,1355077
2023-05-05 04:02,1355094,608666,512547,233881,1355094
2023-05-05 04:03,1355112,608684,512547,233881,1355112
2023-05-05 04:04,1355130,608701,512548,233881,1355130
2023-05-05 04:05,1355149,608720,512548,233881,1355149
2023-05-05 04:06,1355167,608737,512548,233882,1355167
2023-05-05 04:07,1355185,608755,512548,233882,1355185
2023-05-05 04:08,1355202,608772,512548,233882,1355202
2023-05-05 04:09,1355220,608790,512548,233882,1355220
2023-05-05 04:10,1355239,608809,512548,233882,1355239
2023-05-05 04:12,1355256,608826,512548,233882,1355256
2023-05-05 04:13,1355275,608845,512548,233882,1355275
2023-05-05 04:14,1355292,608862,512548,233882,1355292
2023-05-05 04:15,1355310,608878,512550,233882,1355310
2023-05-05 04:16,1355328,608895,512550,233883,1355328
2023-05-05 04:17,1355346,608913,512550,233883,1355346
2023-05-05 04:18,1355365,608932,512550,233883,1355365
2023-05-05 04:19,1355381,608948,512550,233883,1355381
2023-05-05 04:20,1355400,608967,512550,233883,1355400
2023-05-05 04:21,1355418,608985,512550,233883,1355418
2023-05-05 04:22,1355436,609003,512550,233883,1355436
2023-05-05 04:23,1355454,609021,512550,233883,1355454
2023-05-05 04:24,1355472,609039,512550,233883,1355472
2023-05-05 04:25,1355490,609057,512550,233883,1355490
2023-05-05 04:26,1355508,609075,512550,233883,1355508
2023-05-05 04:27,1355525,609092,512550,233883,1355525
2023-05-05 04:28,1355544,609111,512550,233883,1355544
2023-05-05 04:29,1355562,609129,512550,233883,1355562
2023-05-05 04:30,1355579,609146,512550,233883,1355579
2023-05-05 04:31,1355597,609162,512552,233883,1355597
2023-05-05 04:32,1355615,609180,512552,233883,1355615
2023-05-05 04:33,1355632,609197,512552,233883,1355632
2023-05-05 04:34,1355651,609216,512552,233883,1355651
2023-05-05 04:35,1355668,609232,512553,233883,1355668
2023-05-05 04:36,1355688,609252,512553,233883,1355688
2023-05-05 04:37,1355705,609269,512553,233883,1355705
2023-05-05 04:38,1355724,609288,512553,233883,1355724
2023-05-05 04:39,1355742,609306,512553,233883,1355742
2023-05-05 04:40,1355760,609324,512553,233883,1355760
2023-05-05 04:41,1355777,609337,512556,233884,1355777
2023-05-05 04:42,1355795,609354,512557,233884,1355795
2023-05-05 04:43,1355813,609372,512557,233884,1355813
2023-05-05 04:44,1355830,609389,512557,233884,1355830
2023-05-05 04:45,1355849,609407,512557,233885,1355849
2023-05-05 04:46,1355867,609425,512557,233885,1355867
2023-05-05 04:47,1355885,609442,512557,233886,1355885
2023-05-05 04:48,1355903,609460,512557,233886,1355903
2023-05-05 04:49,1355920,609477,512557,233886,1355920
2023-05-05 04:50,1355938,609495,512557,233886,1355938
2023-05-05 04:51,1355957,609514,512557,233886,1355957
2023-05-05 04:52,1355975,609532,512557,233886,1355975
2023-05-05 04:53,1355993,609550,512557,233886,1355993
2023-05-05 04:54,1356011,609567,512558,233886,1356011
2023-05-05 04:55,1356028,609584,512558,233886,1356028
2023-05-05 04:56,1356047,609603,512558,233886,1356047
2023-05-05 04:57,1356064,609620,512558,233886,1356064
2023-05-05 04:59,1356082,609638,512558,233886,1356082
2023-05-05 05:00,1356100,609656,512558,233886,1356100
2023-05-05 05:01,1356111,609667,512558,233886,1356111
2023-05-05 05:02,1356122,609678,512558,233886,1356122
2023-05-05 05:03,1356133,609689,512558,233886,1356133
2023-05-05 05:04,1356143,609698,512558,233887,1356143
2023-05-05 05:05,1356155,609708,512559,233888,1356155
2023-05-05 05:06,1356165,609718,512559,233888,1356165
2023-05-05 05:07,1356176,609729,512559,233888,1356176
2023-05-05 05:08,1356188,609741,512559,233888,1356188
2023-05-05 05:09,1356198,609750,512560,233888,1356198
2023-05-05 05:10,1356209,609761,512560,233888,1356209
2023-05-05 05:11,1356220,609772,512560,233888,1356220
2023-05-05 05:12,1356231,609783,512560,233888,1356231
2023-05-05 05:13,1356241,609794,512559,233888,1356241
2023-05-05 05:14,1356253,609806,512559,233888,1356253
2023-05-05 05:15,1356264,609815,512560,233889,1356264
2023-05-05 05:16,1356274,609825,512560,233889,1356274
2023-05-05 05:17,1356286,609837,512560,233889,1356286
2023-05-05 05:18,1356296,609847,512560,233889,1356296
2023-05-05 05:19,1356307,609858,512560,233889,1356307
2023-05-05 05:20,1356318,609869,512560,233889,1356318
2023-05-05 05:21,1356329,609880,512560,233889,1356329
2023-05-05 05:22,1356340,609891,512560,233889,1356340
2023-05-05 05:23,1356351,609902,512560,233889,1356351
2023-05-05 05:24,1356362,609913,512560,233889,1356362
2023-05-05 05:25,1356373,609924,512560,233889,1356373
2023-05-05 05:26,1356384,609935,512560,233889,1356384
2023-05-05 05:27,1356395,609945,512561,233889,1356395
2023-05-05 05:28,1356406,609955,512561,233890,1356406
2023-05-05 05:29,1356417,609966,512561,233890,1356417
2023-05-05 05:30,1356427,609976,512561,233890,1356427
2023-05-05 05:31,1356438,609986,512562,233890,1356438
2023-05-05 05:32,1356450,609998,512562,233890,1356450
2023-05-05 05:33,1356460,610008,512562,233890,1356460
2023-05-05 05:34,1356471,610019,512562,233890,1356471
2023-05-05 05:35,1356482,610029,512563,233890,1356482
2023-05-05 05:36,1356493,610039,512563,233891,1356493
2023-05-05 05:37,1356504,610050,512563,233891,1356504
2023-05-05 05:38,1356515,610061,512563,233891,1356515
2023-05-05 05:39,1356526,610070,512564,233892,1356526
2023-05-05 05:40,1356536,610080,512564,233892,1356536
2023-05-05 05:41,1356547,610089,512566,233892,1356547
2023-05-05 05:42,1356559,610101,512566,233892,1356559
2023-05-05 05:43,1356569,610111,512566,233892,1356569
2023-05-05 05:44,1356580,610122,512566,233892,1356580
2023-05-05 05:46,1356591,610132,512567,233892,1356591
2023-05-05 05:47,1356602,610141,512569,233892,1356602
2023-05-05 05:48,1356612,610151,512569,233892,1356612
2023-05-05 05:49,1356623,610162,512569,233892,1356623
2023-05-05 05:50,1356635,610174,512569,233892,1356635
2023-05-05 05:51,1356645,610184,512569,233892,1356645
2023-05-05 05:52,1356656,610194,512570,233892,1356656
2023-05-05 05:53,1356667,610205,512570,233892,1356667
2023-05-05 05:54,1356678,610216,512570,233892,1356678
2023-05-05 05:55,1356689,610227,512570,233892,1356689
2023-05-05 05:56,1356700,610238,512570,233892,1356700
2023-05-05 05:57,1356711,610249,512570,233892,1356711
2023-05-05 05:58,1356721,610259,512570,233892,1356721
2023-05-05 05:59,1356732,610269,512570,233893,1356732
2023-05-05 06:00,1356743,610280,512570,233893,1356743
2023-05-05 06:01,1356753,610290,512570,233893,1356753
2023-05-05 06:02,1356762,610299,512570,233893,1356762
2023-05-05 06:03,1356772,610309,512570,233893,1356772
2023-05-05 06:04,1356783,610319,512571,233893,1356783
2023-05-05 06:05,1356792,610328,512571,233893,1356792
2023-05-05 06:06,1356802,610336,512572,233894,1356802
2023-05-05 06:07,1356812,610346,512572,233894,1356812
2023-05-05 06:08,1356823,610357,512572,233894,1356823
2023-05-05 06:09,1356833,610368,512572,233893,1356833
2023-05-05 06:10,1356843,610377,512573,233893,1356843
2023-05-05 06:11,1356853,610387,512573,233893,1356853
2023-05-05 06:12,1356862,610396,512573,233893,1356862
2023-05-05 06:13,1356873,610406,512573,233894,1356873
2023-05-05 06:14,1356883,610416,512573,233894,1356883
2023-05-05 06:15,1356893,610426,512573,233894,1356893
2023-05-05 06:16,1356902,610434,512574,233894,1356902
2023-05-05 06:17,1356912,610444,512574,233894,1356912
2023-05-05 06:18,1356922,610454,512575,233893,1356922
2023-05-05 06:19,1356932,610464,512575,233893,1356932
2023-05-05 06:20,1356941,610472,512576,233893,1356941
2023-05-05 06:21,1356951,610480,512577,233894,1356951
2023-05-05 06:22,1356962,610491,512577,233894,1356962
2023-05-05 06:23,1356972,610501,512577,233894,1356972
2023-05-05 06:24,1356982,610511,512577,233894,1356982
2023-05-05 06:25,1356991,610520,512577,233894,1356991
2023-05-05 06:26,1357001,610530,512577,233894,1357001
2023-05-05 06:27,1357011,610538,512579,233894,1357011
2023-05-05 06:28,1357021,610548,512579,233894,1357021
2023-05-05 06:29,1357031,610558,512579,233894,1357031
2023-05-05 06:30,1357040,610565,512579,233896,1357040
2023-05-05 06:31,1357050,610574,512580,233896,1357050
2023-05-05 06:32,1357060,610584,512580,233896,1357060
2023-05-05 06:34,1357071,610594,512581,233896,1357071
2023-05-05 06:35,1357081,610604,512581,233896,1357081
2023-05-05 06:36,1357092,610615,512581,233896,1357092
2023-05-05 06:37,1357102,610624,512581,233897,1357102
2023-05-05 06:38,1357112,610633,512582,233897,1357112
2023-05-05 06:39,1357122,610643,512582,233897,1357122
2023-05-05 06:40,1357132,610651,512583,233898,1357132
2023-05-05 06:41,1357141,610659,512583,233899,1357141
2023-05-05 06:42,1357152,610669,512584,233899,1357152
2023-05-05 06:43,1357162,610678,512584,233900,1357162
2023-05-05 06:44,1357172,610686,512585,233901,1357172
2023-05-05 06:45,1357181,610695,512585,233901,1357181
2023-05-05 06:46,1357191,610702,512586,233903,1357191
2023-05-05 06:47,1357201,610711,512586,233904,1357201
2023-05-05 06:48,1357211,610721,512586,233904,1357211
2023-05-05 06:49,1357221,610731,512586,233904,1357221
2023-05-05 06:50,1357231,610740,512586,233905,1357231
2023-05-05 06:51,1357240,610748,512586,233906,1357240
2023-05-05 06:52,1357251,610758,512586,233907,1357251
2023-05-05 06:53,1357260,610767,512586,233907,1357260
2023-05-05 06:54,1357270,610776,512587,233907,1357270
2023-05-05 06:55,1357280,610786,512587,233907,1357280
2023-05-05 06:56,1357290,610795,512588,233907,1357290
2023-05-05 06:57,1357299,610804,512588,233907,1357299
2023-05-05 06:58,1357310,610815,512588,233907,1357310
2023-05-05 06:59,1357320,610825,512588,233907,1357320
2023-05-05 07:00,1357342,610844,512590,233908,1357342
2023-05-05 07:01,1357376,610878,512590,233908,1357376
2023-05-05 07:02,1357411,610912,512591,233908,1357411
2023-05-05 07:03,1357445,610946,512591,233908,1357445
2023-05-05 07:04,1357479,610980,512591,233908,1357479
2023-05-05 07:05,1357512,611013,512591,233908,1357512
2023-05-05 07:06,1357548,611048,512592,233908,1357548
2023-05-05 07:07,1357582,611082,512592,233908,1357582
2023-05-05 07:08,1357617,611115,512594,233908,1357617
2023-05-05 07:09,1357649,611147,512594,233908,1357649
2023-05-05 07:10,1357685,611182,512595,233908,1357685
2023-05-05 07:11,1357718,611215,512595,233908,1357718
2023-05-05 07:12,1357752,611248,512596,233908,1357752
2023-05-05 07:13,1357787,611282,512596,233909,1357787
2023-05-05 07:14,1357822,611316,512597,233909,1357822
2023-05-05 07:15,1357856,611350,512597,233909,1357856
2023-05-05 07:16,1357890,611383,512597,233910,1357890
2023-05-05 07:17,1357923,611416,512597,233910,1357923
2023-05-05 07:18,1357958,611451,512597,233910,1357958
2023-05-05 07:19,1357993,611485,512597,233911,1357993
2023-05-05 07:21,1358027,611518,512598,233911,1358027
2023-05-05 07:22,1358061,611551,512598,233912,1358061
2023-05-05 07:23,1358096,611585,512598,233913,1358096
2023-05-05 07:24,1358128,611616,512598,233914,1358128
2023-05-05 07:25,1358164,611651,512599,233914,1358164
2023-05-05 07:26,1358199,611686,512599,233914,1358199
2023-05-05 07:27,1358233,611719,512600,233914,1358233
2023-05-05 07:28,1358267,611753,512600,233914,1358267
2023-05-05 07:29,1358301,611787,512600,233914,1358301
2023-05-05 07:30,1358338,611824,512600,233914,1358338
2023-05-05 07:31,1358372,611858,512600,233914,1358372
2023-05-05 07:32,1358406,611892,512600,233914,1358406
2023-05-05 07:33,1358439,611925,512600,233914,1358439
2023-05-05 07:34,1358473,611959,512600,233914,1358473
2023-05-05 07:35,1358510,611996,512600,233914,1358510
2023-05-05 07:36,1358543,612028,512600,233915,1358543
2023-05-05 07:37,1358579,612063,512601,233915,1358579
2023-05-05 07:38,1358615,612099,512601,233915,1358615
2023-05-05 07:39,1358648,612132,512601,233915,1358648
2023-05-05 07:40,1358683,612166,512601,233916,1358683
2023-05-05 07:41,1358717,612199,512602,233916,1358717
2023-05-05 07:42,1358751,612233,512602,233916,1358751
2023-05-05 07:43,1358784,612264,512603,233917,1358784
2023-05-05 07:44,1358820,612300,512603,233917,1358820
2023-05-05 07:45,1358854,612333,512603,233918,1358854
2023-05-05 07:46,1358887,612366,512603,233918,1358887
2023-05-05 07:47,1358922,612398,512605,233919,1358922
2023-05-05 07:48,1358955,612431,512605,233919,1358955
2023-05-05 07:49,1358990,612465,512606,233919,1358990
2023-05-05 07:50,1359027,612502,512606,233919,1359027
2023-05-05 07:51,1359060,612535,512606,233919,1359060
2023-05-05 07:52,1359094,612569,512606,233919,1359094
2023-05-05 07:53,1359128,612603,512606,233919,1359128
2023-05-05 07:54,1359162,612637,512606,233919,1359162
2023-05-05 07:55,1359197,612670,512607,233920,1359197
2023-05-05 07:56,1359230,612703,512607,233920,1359230
2023-05-05 07:57,1359265,612738,512607,233920,1359265
2023-05-05 07:58,1359299,612771,512607,233921,1359299
2023-05-05 07:59,1359333,612805,512607,233921,1359333
2023-05-05 08:00,1359349,612821,512607,233921,1359349
2023-05-05 08:01,1359360,612830,512608,233922,1359360
2023-05-05 08:02,1359370,612839,512608,233923,1359370
2023-05-05 08:03,1359380,612848,512608,233924,1359380
2023-05-05 08:04,1359390,612857,512608,233925,1359390
2023-05-05 08:05,1359401,612866,512610,233925,1359401
2023-05-05 08:06,1359411,612875,512610,233926,1359411
2023-05-05 08:07,1359421,612884,512610,233927,1359421
2023-05-05 08:09,1359432,612894,512610,233928,1359432
2023-05-05 08:10,1359442,612901,512611,233930,1359442
2023-05-05 08:11,1359452,612911,512611,233930,1359452
2023-05-05 08:12,1359462,612920,512612,233930,1359462
2023-05-05 08:13,1359473,612931,512612,233930,1359473
2023-05-05 08:14,1359483,612939,512613,233931,1359483
2023-05-05 08:15,1359493,612946,512614,233933,1359493
2023-05-05 08:16,1359503,612956,512614,233933,1359503
2023-05-05 08:17,1359514,612966,512615,233933,1359514
2023-05-05 08:18,1359525,612977,512615,233933,1359525
2023-05-05 08:19,1359535,612986,512615,233934,1359535
2023-05-05 08:20,1359545,612996,512615,233934,1359545
2023-05-05 08:21,1359556,613004,512618,233934,1359556
2023-05-05 08:22,1359567,613015,512618,233934,1359567
2023-05-05 08:23,1359577,613024,512619,233934,1359577
2023-05-05 08:24,1359587,613034,512619,233934,1359587
2023-05-05 08:25,1359598,613042,512621,233935,1359598
2023-05-05 08:26,1359608,613051,512621,233936,1359608
2023-05-05 08:27,1359618,613059,512623,233936,1359618
2023-05-05 08:28,1359628,613067,512623,233938,1359628
2023-05-05 08:29,1359639,613077,512624,233938,1359639
2023-05-05 08:30,1359648,613086,512624,233938,1359648
2023-05-05 08:31,1359659,613097,512624,233938,1359659
2023-05-05 08:32,1359669,613106,512624,233939,1359669
2023-05-05 08:33,1359680,613116,512625,233939,1359680
2023-05-05 08:34,1359690,613126,512625,233939,1359690
2023-05-05 08:35,1359700,613136,512625,233939,1359700
2023-05-05 08:36,1359710,613145,512625,233940,1359710
2023-05-05 08:37,1359720,613154,512625,233941,1359720
2023-05-05 08:38,1359731,613165,512625,233941,1359731
2023-05-05 08:39,1359741,613175,512625,233941,1359741
2023-05-05 08:40,1359752,613186,512625,233941,1359752
2023-05-05 08:41,1359763,613197,512625,233941,1359763
2023-05-05 08:42,1359774,613207,512625,233942,1359774
2023-05-05 08:43,1359784,613214,512627,233943,1359784
2023-05-05 08:44,1359795,613225,512627,233943,1359795
2023-05-05 08:45,1359805,613235,512626,233944,1359805
2023-05-05 08:46,1359815,613245,512626,233944,1359815
2023-05-05 08:47,1359825,613255,512626,233944,1359825
2023-05-05 08:48,1359836,613266,512626,233944,1359836
2023-05-05 08:49,1359846,613275,512627,233944,1359846
2023-05-05 08:50,1359857,613286,512627,233944,1359857
2023-05-05 08:51,1359867,613296,512627,233944,1359867
2023-05-05 08:52,1359877,613306,512627,233944,1359877
2023-05-05 08:53,1359888,613316,512628,233944,1359888
2023-05-05 08:54,1359898,613325,512628,233945,1359898
2023-05-05 08:56,1359908,613334,512629,233945,1359908
2023-05-05 08:57,1359918,613343,512629,233946,1359918
2023-05-05 08:58,1359929,613352,512631,233946,1359929
2023-05-05 08:59,1359939,613361,512631,233947,1359939
2023-05-05 09:00,1359949,613371,512631,233947,1359949
2023-05-05 09:01,1359968,613390,512631,233947,1359968
2023-05-05 09:02,1359989,613408,512634,233947,1359989
2023-05-05 09:03,1360009,613428,512634,233947,1360009
2023-05-05 09:04,1360028,613441,512638,233949,1360028
2023-05-05 09:05,1360049,613462,512638,233949,1360049
2023-05-05 09:06,1360069,613483,512637,233949,1360069
2023-05-05 09:07,1360091,613504,512637,233950,1360091
2023-05-05 09:08,1360110,613523,512637,233950,1360110
2023-05-05 09:09,1360131,613541,512637,233953,1360131
2023-05-05 09:10,1360152,613557,512642,233953,1360152
2023-05-05 09:11,1360170,613575,512642,233953,1360170
2023-05-05 09:12,1360191,613595,512643,233953,1360191
2023-05-05 09:13,1360211,613614,512643,233954,1360211
2023-05-05 09:14,1360230,613630,512645,233955,1360230
2023-05-05 09:15,1360250,613649,512645,233956,1360250
2023-05-05 09:16,1360270,613666,512647,233957,1360270
2023-05-05 09:17,1360289,613685,512647,233957,1360289
2023-05-05 09:18,1360309,613703,512648,233958,1360309
2023-05-05 09:19,1360329,613723,512648,233958,1360329
2023-05-05 09:20,1360349,613740,512651,233958,1360349
2023-05-05 09:21,1360370,613761,512651,233958,1360370
2023-05-05 09:22,1360389,613779,512651,233959,1360389
2023-05-05 09:23,1360409,613799,512651,233959,1360409
2023-05-05 09:24,1360429,613814,512655,233960,1360429
2023-05-05 09:25,1360449,613833,512655,233961,1360449
2023-05-05 09:26,1360469,613852,512656,233961,1360469
2023-05-05 09:27,1360489,613871,512656,233962,1360489
2023-05-05 09:28,1360508,613889,512657,233962,1360508
2023-05-05 09:29,1360528,613909,512657,233962,1360528
2023-05-05 09:30,1360548,613927,512658,233963,1360548
2023-05-05 09:31,1360567,613946,512658,233963,1360567
2023-05-05 09:32,1360587,613964,512660,233963,1360587
2023-05-05 09:33,1360607,613982,512660,233965,1360607
2023-05-05 09:34,1360627,613998,512662,233967,1360627
2023-05-05 09:35,1360648,614017,512662,233969,1360648
2023-05-05 09:36,1360668,614037,512662,233969,1360668
2023-05-05 09:37,1360688,614055,512662,233971,1360688
2023-05-05 09:38,1360707,614074,512662,233971,1360707
2023-05-05 09:39,1360727,614093,512662,233972,1360727
2023-05-05 09:40,1360746,614111,512663,233972,1360746
2023-05-05 09:41,1360767,614132,512663,233972,1360767
2023-05-05 09:43,1360786,614151,512664,233971,1360786
2023-05-05 09:44,1360807,614172,512664,233971,1360807
2023-05-05 09:45,1360826,614188,512667,233971,1360826
2023-05-05 09:46,1360846,614207,512667,233972,1360846
2023-05-05 09:47,1360865,614226,512667,233972,1360865
2023-05-05 09:48,1360886,614246,512667,233973,1360886
2023-05-05 09:49,1360906,614266,512667,233973,1360906
2023-05-05 09:50,1360926,614286,512667,233973,1360926
2023-05-05 09:51,1360945,614302,512670,233973,1360945
2023-05-05 09:52,1360966,614323,512670,233973,1360966
2023-05-05 09:53,1360986,614342,512671,233973,1360986
2023-05-05 09:54,1361007,614363,512671,233973,1361007
2023-05-05 09:55,1361027,614381,512673,233973,1361027
2023-05-05 09:56,1361047,614400,512673,233974,1361047
2023-05-05 09:57,1361067,614418,512673,233976,1361067
2023-05-05 09:58,1361087,614438,512673,233976,1361087
2023-05-05 09:59,1361107,614456,512675,233976,1361107
2023-05-05 10:00,1361126,614474,512675,233977,1361126
2023-05-05 10:01,1361143,614487,512677,233979,1361143
2023-05-05 10:02,1361158,614501,512677,233980,1361158
2023-05-05 10:03,1361174,614516,512678,233980,1361174
2023-05-05 10:04,1361190,614531,512678,233981,1361190
2023-05-05 10:05,1361208,614546,512681,233981,1361208
2023-05-05 10:06,1361224,614562,512681,233981,1361224
2023-05-05 10:07,1361239,614575,512683,233981,1361239
2023-05-05 10:08,1361255,614590,512683,233982,1361255
2023-05-05 10:09,1361272,614606,512684,233982,1361272
2023-05-05 10:10,1361287,614620,512684,233983,1361287
2023-05-05 10:11,1361303,614634,512685,233984,1361303
2023-05-05 10:12,1361320,614651,512685,233984,1361320
2023-05-05 10:13,1361335,614663,512687,233985,1361335
2023-05-05 10:14,1361351,614678,512687,233986,1361351
2023-05-05 10:15,1361368,614693,512688,233987,1361368
2023-05-05 10:16,1361384,614708,512688,233988,1361384
2023-05-05 10:17,1361400,614723,512689,233988,1361400
2023-05-05 10:18,1361415,614737,512689,233989,1361415
2023-05-05 10:19,1361431,614749,512692,233990,1361431
2023-05-05 10:20,1361448,614764,512692,233992,1361448
2023-05-05 10:21,1361464,614778,512693,233993,1361464
2023-05-05 10:22,1361480,614794,512693,233993,1361480
2023-05-05 10:23,1361498,614810,512695,233993,1361498
2023-05-05 10:24,1361514,614826,512695,233993,1361514
2023-05-05 10:25,1361530,614840,512696,233994,1361530
2023-05-05 10:26,1361545,614853,512697,233995,1361545
2023-05-05 10:27,1361562,614870,512697,233995,1361562
2023-05-05 10:28,1361578,614884,512698,233996,1361578
2023-05-05 10:30,1361594,614899,512698,233997,1361594
2023-05-05 10:31,1361610,614915,512699,233996,1361610
2023-05-05 10:32,1361627,614932,512699,233996,1361627
2023-05-05 10:33,1361643,614947,512699,233997,1361643
2023-05-05 10:34,1361660,614963,512699,233998,1361660
2023-05-05 10:35,1361676,614973,512702,234001,1361676
2023-05-05 10:36,1361692,614988,512702,234002,1361692
2023-05-05 10:37,1361708,615004,512702,234002,1361708
2023-05-05 10:38,1361724,615020,512702,234002,1361724
2023-05-05 10:39,1361740,615035,512703,234002,1361740
2023-05-05 10:40,1361756,615051,512703,234002,1361756
2023-05-05 10:41,1361772,615066,512704,234002,1361772
2023-05-05 10:42,1361788,615081,512704,234003,1361788
2023-05-05 10:43,1361804,615096,512705,234003,1361804
2023-05-05 10:44,1361820,615111,512705,234004,1361820
2023-05-05 10:45,1361837,615123,512706,234008,1361837
2023-05-05 10:46,1361852,615137,512706,234009,1361852
2023-05-05 10:47,1361869,615153,512706,234010,1361869
2023-05-05 10:48,1361884,615168,512706,234010,1361884
2023-05-05 10:49,1361903,615185,512707,234011,1361903
2023-05-05 10:50,1361918,615199,512707,234012,1361918
2023-05-05 10:51,1361935,615214,512709,234012,1361935
2023-05-05 10:52,1361950,615229,512709,234012,1361950
2023-05-05 10:53,1361967,615243,512711,234013,1361967
2023-05-05 10:54,1361983,615258,512711,234014,1361983
2023-05-05 10:55,1361999,615270,512714,234015,1361999
2023-05-05 10:56,1362015,615286,512714,234015,1362015
2023-05-05 10:57,1362031,615300,512715,234016,1362031
2023-05-05 10:58,1362047,615315,512715,234017,1362047
2023-05-05 10:59,1362063,615330,512716,234017,1362063
2023-05-05 11:00,1362083,615350,512716,234017,1362083
2023-05-05 11:01,1362105,615368,512719,234018,1362105
2023-05-05 11:02,1362129,615389,512719,234021,1362129
2023-05-05 11:03,1362151,615404,512724,234023,1362151
2023-05-05 11:04,1362172,615425,512724,234023,1362172
2023-05-05 11:05,1362194,615446,512724,234024,1362194
2023-05-05 11:06,1362215,615465,512726,234024,1362215
2023-05-05 11:07,1362237,615486,512726,234025,1362237
2023-05-05 11:08,1362259,615508,512726,234025,1362259
2023-05-05 11:09,1362280,615529,512726,234025,1362280
2023-05-05 11:10,1362302,615550,512727,234025,1362302
2023-05-05 11:11,1362325,615573,512727,234025,1362325
2023-05-05 11:12,1362346,615593,512728,234025,1362346
2023-05-05 11:13,1362368,615615,512728,234025,1362368
2023-05-05 11:14,1362390,615635,512728,234027,1362390
2023-05-05 11:15,1362413,615658,512728,234027,1362413
2023-05-05 11:16,1362433,615677,512728,234028,1362433
2023-05-05 11:18,1362456,615699,512728,234029,1362456
2023-05-05 11:19,1362477,615719,512729,234029,1362477
2023-05-05 11:20,1362499,615740,512729,234030,1362499
2023-05-05 11:21,1362520,615755,512735,234030,1362520
2023-05-05 11:22,1362541,615774,512735,234032,1362541
2023-05-05 11:23,1362563,615795,512736,234032,1362563
2023-05-05 11:24,1362586,615817,512736,234033,1362586
2023-05-05 11:25,1362606,615832,512741,234033,1362606
2023-05-05 11:26,1362627,615851,512742,234034,1362627
2023-05-05 11:27,1362649,615872,512742,234035,1362649
2023-05-05 11:28,1362671,615892,512744,234035,1362671
2023-05-05 11:29,1362693,615914,512744,234035,1362693
2023-05-05 11:30,1362715,615935,512745,234035,1362715
2023-05-05 11:31,1362736,615956,512745,234035,1362736
2023-05-05 11:32,1362759,615977,512746,234036,1362759
2023-05-05 11:33,1362780,615996,512746,234038,1362780
2023-05-05 11:34,1362801,616016,512747,234038,1362801
2023-05-05 11:35,1362823,616036,512747,234040,1362823
2023-05-05 11:36,1362844,616055,512749,234040,1362844
2023-05-05 11:37,1362866,616076,512749,234041,1362866
2023-05-05 11:38,1362888,616098,512748,234042,1362888
2023-05-05 11:39,1362909,616119,512748,234042,1362909
2023-05-05 11:40,1362931,616141,512748,234042,1362931
2023-05-05 11:41,1362953,616163,512748,234042,1362953
2023-05-05 11:42,1362974,616183,512749,234042,1362974
2023-05-05 11:43,1362996,616205,512749,234042,1362996
2023-05-05 11:44,1363017,616224,512751,234042,1363017
2023-05-05 11:45,1363038,616244,512751,234043,1363038
2023-05-05 11:46,1363061,616267,512751,234043,1363061
2023-05-05 11:47,1363082,616287,512751,234044,1363082
2023-05-05 11:48,1363104,616309,512750,234045,1363104
2023-05-05 11:49,1363125,616330,512750,234045,1363125
2023-05-05 11:50,1363147,616347,512755,234045,1363147
2023-05-05 11:51,1363169,616369,512755,234045,1363169
2023-05-05 11:52,1363190,616386,512758,234046,1363190
2023-05-05 11:53,1363211,616407,512758,234046,1363211
2023-05-05 11:54,1363232,616425,512761,234046,1363232
2023-05-05 11:55,1363255,616448,512761,234046,1363255
2023-05-05 11:56,1363277,616467,512761,234049,1363277
2023-05-05 11:57,1363297,616488,512761,234048,1363297
2023-05-05 11:58,1363319,616508,512761,234050,1363319
2023-05-05 11:59,1363341,616529,512761,234051,1363341
2023-05-05 12:00,1363355,616542,512762,234051,1363355
2023-05-05 12:01,1363367,616553,512762,234052,1363367
2023-05-05 12:02,1363380,616563,512765,234052,1363380
2023-05-05 12:03,1363392,616574,512765,234053,1363392
2023-05-05 12:05,1363405,616582,512769,234054,1363405
2023-05-05 12:06,1363417,616594,512769,234054,1363417
2023-05-05 12:07,1363430,616603,512772,234055,1363430
2023-05-05 12:08,1363443,616615,512773,234055,1363443
2023-05-05 12:09,1363456,616626,512773,234057,1363456
2023-05-05 12:10,1363468,616636,512775,234057,1363468
2023-05-05 12:11,1363480,616646,512775,234059,1363480
2023-05-05 12:12,1363493,616653,512781,234059,1363493
2023-05-05 12:13,1363506,616665,512781,234060,1363506
2023-05-05 12:14,1363518,616674,512784,234060,1363518
2023-05-05 12:15,1363530,616686,512784,234060,1363530
2023-05-05 12:16,1363544,616698,512785,234061,1363544
2023-05-05 12:17,1363557,616711,512785,234061,1363557
2023-05-05 12:18,1363569,616721,512787,234061,1363569
2023-05-05 12:19,1363584,616736,512787,234061,1363584
2023-05-05 12:20,1363597,616746,512789,234062,1363597
2023-05-05 12:21,1363609,616757,512789,234063,1363609
2023-05-05 12:22,1363621,616764,512794,234063,1363621
2023-05-05 12:23,1363634,616777,512794,234063,1363634
2023-05-05 12:24,1363646,616787,512796,234063,1363646
2023-05-05 12:25,1363659,616800,512796,234063,1363659
2023-05-05 12:26,1363672,616807,512802,234063,1363672
2023-05-05 12:27,1363685,616819,512802,234064,1363685
2023-05-05 12:28,1363698,616828,512806,234064,1363698
2023-05-05 12:29,1363710,616840,512806,234064,1363710
2023-05-05 12:30,1363722,616852,512806,234064,1363722
2023-05-05 12:31,1363736,616865,512806,234065,1363736
2023-05-05 12:32,1363748,616874,512809,234065,1363748
2023-05-05 12:33,1363761,616884,512809,234068,1363761
2023-05-05 12:34,1363773,616893,512812,234068,1363773
2023-05-05 12:35,1363786,616904,512812,234070,1363786
2023-05-05 12:36,1363798,616909,512817,234072,1363798
2023-05-05 12:37,1363811,616918,512821,234072,1363811
2023-05-05 12:38,1363824,616929,512821,234074,1363824
2023-05-05 12:39,1363836,616938,512823,234075,1363836
2023-05-05 12:40,1363849,616950,512823,234076,1363849
2023-05-05 12:41,1363860,616958,512826,234076,1363860
2023-05-05 12:42,1363875,616972,512826,234077,1363875
2023-05-05 12:43,1363888,616983,512828,234077,1363888
2023-05-05 12:44,1363901,616996,512828,234077,1363901
2023-05-05 12:45,1363914,617004,512831,234079,1363914
2023-05-05 12:46,1363927,617015,512833,234079,1363927
2023-05-05 12:47,1363939,617026,512834,234079,1363939
2023-05-05 12:48,1363952,617039,512834,234079,1363952
2023-05-05 12:49,1363964,617050,512835,234079,1363964
2023-05-05 12:50,1363977,617063,512835,234079,1363977
2023-05-05 12:51,1363990,617075,512835,234080,1363990
2023-05-05 12:53,1364003,617088,512835,234080,1364003
2023-05-05 12:54,1364015,617100,512835,234080,1364015
2023-05-05 12:55,1364029,617113,512835,234081,1364029
2023-05-05 12:56,1364041,617123,512835,234083,1364041
2023-05-05 12:57,1364054,617134,512835,234085,1364054
2023-05-05 12:58,1364066,617145,512835,234086,1364066
2023-05-05 12:59,1364080,617157,512835,234088,1364080
2023-05-05 13:00,1364092,617154,512850,234088,1364092
2023-05-05 13:01,1364104,617164,512850,234090,1364104
2023-05-05 13:02,1364116,617172,512854,234090,1364116
2023-05-05 13:03,1364127,617181,512854,234092,1364127
2023-05-05 13:04,1364140,617190,512857,234093,1364140
2023-05-05 13:05,1364152,617201,512857,234094,1364152
2023-05-05 13:06,1364163,617209,512860,234094,1364163
2023-05-05 13:07,1364176,617222,512860,234094,1364176
2023-05-05 13:08,1364188,617229,512864,234095,1364188
2023-05-05 13:09,1364201,617241,512864,234096,1364201
2023-05-05 13:10,1364213,617248,512868,234097,1364213
2023-05-05 13:11,1364226,617257,512871,234098,1364226
2023-05-05 13:12,1364238,617268,512871,234099,1364238
2023-05-05 13:13,1364249,617275,512876,234098,1364249
2023-05-05 13:14,1364261,617284,512876,234101,1364261
2023-05-05 13:15,1364274,617297,512876,234101,1364274
2023-05-05 13:16,1364286,617308,512876,234102,1364286
2023-05-05 13:17,1364298,617313,512881,234104,1364298
2023-05-05 13:18,1364309,617324,512881,234104,1364309
2023-05-05 13:19,1364322,617336,512882,234104,1364322
2023-05-05 13:20,1364334,617348,512882,234104,1364334
2023-05-05 13:21,1364346,617359,512883,234104,1364346
2023-05-05 13:22,1364359,617370,512883,234106,1364359
2023-05-05 13:23,1364370,617377,512887,234106,1364370
2023-05-05 13:24,1364383,617390,512887,234106,1364383
2023-05-05 13:25,1364394,617400,512888,234106,1364394
2023-05-05 13:26,1364407,617413,512888,234106,1364407
2023-05-05 13:27,1364419,617419,512891,234109,1364419
2023-05-05 13:28,1364431,617431,512891,234109,1364431
2023-05-05 13:29,1364443,617439,512894,234110,1364443
2023-05-05 13:30,1364457,617451,512894,234112,1364457
2023-05-05 13:31,1364469,617456,512900,234113,1364469
2023-05-05 13:32,1364481,617468,512900,234113,1364481
2023-05-05 13:33,1364493,617476,512904,234113,1364493
2023-05-05 13:34,1364505,617486,512904,234115,1364505
2023-05-05 13:35,1364520,617499,512904,234117,1364520
2023-05-05 13:36,1364531,617509,512904,234118,1364531
2023-05-05 13:37,1364545,617519,512906,234120,1364545
2023-05-05 13:38,1364557,617531,512906,234120,1364557
2023-05-05 13:39,1364568,617538,512910,234120,1364568
2023-05-05 13:41,1364580,617550,512910,234120,1364580
2023-05-05 13:42,1364592,617560,512912,234120,1364592
2023-05-05 13:43,1364605,617573,512912,234120,1364605
2023-05-05 13:44,1364617,617581,512914,234122,1364617
2023-05-05 13:45,1364630,617593,512914,234123,1364630
2023-05-05 13:46,1364641,617600,512916,234125,1364641
2023-05-05 13:47,1364653,617611,512916,234126,1364653
2023-05-05 13:48,1364665,617623,512916,234126,1364665
2023-05-05 13:49,1364678,617636,512916,234126,1364678
2023-05-05 13:50,1364690,617644,512919,234127,1364690
2023-05-05 13:51,1364702,617656,512919,234127,1364702
2023-05-05 13:52,1364714,617663,512924,234127,1364714
2023-05-05 13:53,1364726,617675,512924,234127,1364726
2023-05-05 13:54,1364737,617683,512926,234128,1364737
2023-05-05 13:55,1364750,617696,512926,234128,1364750
2023-05-05 13:56,1364762,617704,512929,234129,1364762
2023-05-05 13:57,1364775,617717,512929,234129,1364775
2023-05-05 13:58,1364786,617722,512933,234131,1364786
2023-05-05 13:59,1364798,617734,512933,234131,1364798
2023-05-05 14:00,1364816,617751,512935,234130,1364816
2023-05-05 14:01,1364844,617777,512935,234132,1364844
2023-05-05 14:02,1364872,617801,512939,234132,1364872
2023-05-05 14:03,1364900,617829,512939,234132,1364900
2023-05-05 14:04,1364928,617852,512943,234133,1364928
2023-05-05 14:05,1364955,617876,512943,234136,1364955
2023-05-05 14:06,1364984,617902,512945,234137,1364984
2023-05-05 14:07,1365010,617924,512946,234140,1365010
2023-05-05 14:08,1365038,617952,512946,234140,1365038
2023-05-05 14:09,1365066,617974,512951,234141,1365066
2023-05-05 14:10,1365094,618001,512952,234141,1365094
2023-05-05 14:11,1365123,618029,512952,234142,1365123
2023-05-05 14:12,1365150,618051,512957,234142,1365150
2023-05-05 14:13,1365177,618077,512957,234143,1365177
2023-05-05 14:14,1365205,618104,512957,234144,1365205
2023-05-05 14:15,1365235,618133,512957,234145,1365235
2023-05-05 14:16,1365262,618158,512959,234145,1365262
2023-05-05 14:17,1365290,618185,512959,234146,1365290
2023-05-05 14:18,1365319,618208,512962,234149,1365319
2023-05-05 14:19,1365348,618237,512962,234149,1365348
2023-05-05 14:20,1365377,618264,512963,234150,1365377
2023-05-05 14:21,1365405,618292,512963,234150,1365405
2023-05-05 14:22,1365433,618318,512965,234150,1365433
2023-05-05 14:23,1365461,618346,512965,234150,1365461
2023-05-05 14:24,1365489,618372,512967,234150,1365489
2023-05-05 14:25,1365518,618400,512967,234151,1365518
2023-05-05 14:26,1365544,618425,512968,234151,1365544
2023-05-05 14:28,1365573,618454,512968,234151,1365573
2023-05-05 14:29,1365601,618477,512971,234153,1365601
2023-05-05 14:30,1365628,618502,512971,234155,1365628
2023-05-05 14:31,1365656,618530,512971,234155,1365656
2023-05-05 14:32,1365684,618558,512971,234155,1365684
2023-05-05 14:33,1365711,618582,512973,234156,1365711
2023-05-05 14:34,1365739,618608,512973,234158,1365739
2023-05-05 14:35,1365768,618635,512974,234159,1365768
2023-05-05 14:36,1365797,618663,512974,234160,1365797
2023-05-05 14:37,1365824,618687,512976,234161,1365824
2023-05-05 14:38,1365851,618713,512976,234162,1365851
2023-05-05 14:39,1365880,618740,512978,234162,1365880
2023-05-05 14:40,1365906,618766,512978,234162,1365906
2023-05-05 14:41,1365935,618791,512981,234163,1365935
2023-05-05 14:42,1365962,618818,512981,234163,1365962
2023-05-05 14:43,1365991,618844,512983,234164,1365991
2023-05-05 14:44,1366019,618870,512984,234165,1366019
2023-05-05 14:45,1366045,618892,512987,234166,1366045
2023-05-05 14:46,1366075,618921,512987,234167,1366075
2023-05-05 14:47,1366101,618947,512986,234168,1366101
2023-05-05 14:48,1366131,618975,512986,234170,1366131
2023-05-05 14:49,1366159,619002,512987,234170,1366159
2023-05-05 14:50,1366188,619029,512987,234172,1366188
2023-05-05 14:51,1366216,619057,512987,234172,1366216
2023-05-05 14:52,1366243,619075,512996,234172,1366243
2023-05-05 14:53,1366270,619102,512996,234172,1366270
2023-05-05 14:54,1366299,619129,512998,234172,1366299
2023-05-05 14:55,1366327,619157,512998,234172,1366327
2023-05-05 14:56,1366354,619177,513003,234174,1366354
2023-05-05 14:57,1366383,619204,513003,234176,1366383
2023-05-05 14:58,1366411,619229,513005,234177,1366411
2023-05-05 14:59,1366438,619256,513005,234177,1366438
2023-05-05 15:00,1366455,619272,513006,234177,1366455
2023-05-05 15:01,1366463,619280,513006,234177,1366463
2023-05-05 15:02,1366471,619286,513007,234178,1366471
2023-05-05 15:03,1366481,619295,513007,234179,1366481
2023-05-05 15:04,1366489,619299,513011,234179,1366489
2023-05-05 15:05,1366497,619304,513011,234182,1366497
2023-05-05 15:06,1366506,619312,513012,234182,1366506
2023-05-05 15:07,1366514,619319,513012,234183,1366514
2023-05-05 15:08,1366522,619325,513014,234183,1366522
2023-05-05 15:09,1366530,619333,513014,234183,1366530
2023-05-05 15:10,1366540,619341,513016,234183,1366540
2023-05-05 15:11,1366548,619348,513016,234184,1366548
2023-05-05 15:12,1366557,619356,513017,234184,1366557
2023-05-05 15:13,1366564,619362,513017,234185,1366564
2023-05-05 15:14,1366573,619370,513018,234185,1366573
2023-05-05 15:16,1366581,619378,513018,234185,1366581
2023-05-05 15:17,1366589,619383,513020,234186,1366589
2023-05-05 15:18,1366598,619391,513020,234187,1366598
2023-05-05 15:19,1366606,619397,513021,234188,1366606
2023-05-05 15:20,1366614,619405,513021,234188,1366614
2023-05-05 15:21,1366623,619411,513024,234188,1366623
2023-05-05 15:22,1366631,619418,513024,234189,1366631
2023-05-05 15:23,1366640,619425,513026,234189,1366640
2023-05-05 15:24,1366648,619433,513026,234189,1366648
2023-05-05 15:25,1366656,619440,513027,234189,1366656
2023-05-05 15:26,1366664,619448,513027,234189,1366664
2023-05-05 15:27,1366673,619449,513033,234191,1366673
2023-05-05 15:28,1366682,619458,513033,234191,1366682
2023-05-05 15:29,1366690,619464,513035,234191,1366690
2023-05-05 15:30,1366699,619473,513035,234191,1366699
2023-05-05 15:31,1366707,619481,513035,234191,1366707
2023-05-05 15:32,1366715,619489,513035,234191,1366715
2023-05-05 15:33,1366724,619496,513037,234191,1366724
2023-05-05 15:34,1366733,619506,513037,234190,1366733
2023-05-05 15:35,1366742,619512,513040,234190,1366742
2023-05-05 15:36,1366751,619518,513043,234190,1366751
2023-05-05 15:37,1366758,619524,513043,234191,1366758
2023-05-05 15:38,1366768,619533,513044,234191,1366768
2023-05-05 15:39,1366777,619542,513044,234191,1366777
2023-05-05 15:40,1366786,619550,513045,234191,1366786
2023-05-05 15:41,1366795,619559,513045,234191,1366795
2023-05-05 15:42,1366803,619567,513044,234192,1366803
2023-05-05 15:43,1366812,619575,513044,234193,1366812
2023-05-05 15:44,1366820,619581,513044,234195,1366820
2023-05-05 15:45,1366828,619589,513044,234195,1366828
2023-05-05 15:46,1366836,619596,513045,234195,1366836
2023-05-05 15:47,1366845,619605,513045,234195,1366845
2023-05-05 15:48,1366853,619608,513048,234197,1366853
2023-05-05 15:49,1366862,619617,513048,234197,1366862
2023-05-05 15:50,1366871,619624,513050,234197,1366871
2023-05-05 15:51,1366879,619632,513050,234197,1366879
2023-05-05 15:52,1366888,619639,513051,234198,1366888
2023-05-05 15:53,1366897,619648,513051,234198,1366897
2023-05-05 15:54,1366905,619654,513053,234198,1366905
2023-05-05 15:55,1366913,619661,513053,234199,1366913
2023-05-05 15:56,1366921,619666,513055,234200,1366921
2023-05-05 15:57,1366931,619676,513055,234200,1366931
2023-05-05 15:58,1366939,619681,513058,234200,1366939
2023-05-05 15:59,1366949,619691,513058,234200,1366949
2023-05-05 16:00,1366972,619712,513059,234201,1366972
2023-05-05 16:01,1366999,619738,513059,234202,1366999
2023-05-05 16:03,1367027,619764,513061,234202,1367027
2023-05-05 16:04,1367054,619790,513062,234202,1367054
2023-05-05 16:05,1367080,619815,513062,234203,1367080
2023-05-05 16:06,1367107,619841,513062,234204,1367107
2023-05-05 16:07,1367134,619868,513062,234204,1367134
2023-05-05 16:08,1367161,619894,513062,234205,1367161
2023-05-05 16:09,1367190,619923,513062,234205,1367190
2023-05-05 16:10,1367217,619940,513071,234206,1367217
2023-05-05 16:11,1367262,619985,513071,234206,1367262
2023-05-05 16:12,1367291,620011,513073,234207,1367291
2023-05-05 16:15,1367317,620034,513073,234210,1367317
2023-05-05 16:16,1367379,620090,513076,234213,1367379
2023-05-05 16:17,1367407,620115,513078,234214,1367407
2023-05-05 16:18,1367434,620141,513079,234214,1367434
2023-05-05 16:19,1367461,620167,513079,234215,1367461
2023-05-05 16:20,1367489,620193,513080,234216,1367489
2023-05-05 16:21,1367517,620221,513080,234216,1367517
2023-05-05 16:22,1367544,620247,513081,234216,1367544
2023-05-05 16:23,1367569,620270,513081,234218,1367569
2023-05-05 16:24,1367597,620297,513082,234218,1367597
2023-05-05 16:25,1367623,620322,513082,234219,1367623
2023-05-05 16:26,1367649,620346,513084,234219,1367649
2023-05-05 16:27,1367677,620373,513085,234219,1367677
2023-05-05 16:28,1367704,620400,513085,234219,1367704
2023-05-05 16:29,1367730,620420,513090,234220,1367730
2023-05-05 16:30,1367758,620447,513090,234221,1367758
2023-05-05 16:31,1367784,620473,513090,234221,1367784
2023-05-05 16:32,1367812,620500,513090,234222,1367812
2023-05-05 16:33,1367837,620523,513092,234222,1367837
2023-05-05 16:34,1367864,620549,513092,234223,1367864
2023-05-05 16:35,1367892,620574,513093,234225,1367892
2023-05-05 16:36,1367919,620600,513093,234226,1367919
2023-05-05 16:37,1367946,620623,513095,234228,1367946
2023-05-05 16:38,1367971,620648,513095,234228,1367971
2023-05-05 16:39,1368000,620674,513097,234229,1368000
2023-05-05 16:40,1368026,620700,513097,234229,1368026
2023-05-05 16:41,1368052,620725,513098,234229,1368052
2023-05-05 16:42,1368080,620752,513098,234230,1368080
2023-05-05 16:43,1368107,620775,513099,234233,1368107
2023-05-05 16:44,1368133,620801,513099,234233,1368133
2023-05-05 16:45,1368159,620825,513101,234233,1368159
2023-05-05 16:46,1368186,620851,513101,234234,1368186
2023-05-05 16:48,1368214,620876,513102,234236,1368214
2023-05-05 16:49,1368240,620902,513102,234236,1368240
2023-05-05 16:50,1368267,620929,513102,234236,1368267
2023-05-05 16:51,1368295,620957,513102,234236,1368295
2023-05-05 16:52,1368322,620982,513103,234237,1368322
2023-05-05 16:53,1368347,621006,513103,234238,1368347
2023-05-05 16:54,1368374,621031,513105,234238,1368374
2023-05-05 16:55,1368403,621059,513105,234239,1368403
2023-05-05 16:56,1368428,621081,513107,234240,1368428
2023-05-05 16:57,1368455,621107,513107,234241,1368455
2023-05-05 16:58,1368482,621132,513108,234242,1368482
2023-05-05 16:59,1368510,621159,513108,234243,1368510
2023-05-05 17:00,1368533,621179,513111,234243,1368533
2023-05-05 17:01,1368544,621189,513111,234244,1368544
2023-05-05 17:02,1368554,621196,513113,234245,1368554
2023-05-05 17:03,1368565,621206,513113,234246,1368565
2023-05-05 17:04,1368576,621211,513119,234246,1368576
2023-05-05 17:05,1368586,621219,513119,234248,1368586
2023-05-05 17:06,1368597,621228,513121,234248,1368597
2023-05-05 17:07,1368610,621241,513121,234248,1368610
2023-05-05 17:08,1368620,621245,513126,234249,1368620
2023-05-05 17:09,1368631,621255,513127,234249,1368631
2023-05-05 17:10,1368642,621266,513127,234249,1368642
2023-05-05 17:11,1368652,621274,513129,234249,1368652
2023-05-05 17:12,1368664,621284,513130,234250,1368664
2023-05-05 17:13,1368675,621296,513130,234249,1368675
2023-05-05 17:14,1368686,621307,513130,234249,1368686
2023-05-05 17:15,1368697,621312,513134,234251,1368697
2023-05-05 17:16,1368708,621323,513134,234251,1368708
2023-05-05 17:17,1368719,621333,513135,234251,1368719
2023-05-05 17:18,1368729,621340,513136,234253,1368729
2023-05-05 17:19,1368740,621351,513136,234253,1368740
2023-05-05 17:20,1368751,621358,513139,234254,1368751
2023-05-05 17:21,1368763,621364,513143,234256,1368763
2023-05-05 17:22,1368774,621373,513143,234258,1368774
2023-05-05 17:23,1368784,621382,513144,234258,1368784
2023-05-05 17:24,1368795,621390,513147,234258,1368795
2023-05-05 17:25,1368806,621400,513147,234259,1368806
2023-05-05 17:26,1368816,621408,513149,234259,1368816
2023-05-05 17:27,1368827,621416,513151,234260,1368827
2023-05-05 17:28,1368838,621426,513151,234261,1368838
2023-05-05 17:29,1368849,621437,513151,234261,1368849
2023-05-05 17:30,1368861,621446,513154,234261,1368861
2023-05-05 17:31,1368872,621457,513154,234261,1368872
2023-05-05 17:32,1368883,621463,513158,234262,1368883
2023-05-05 17:33,1368893,621473,513158,234262,1368893
2023-05-05 17:35,1368905,621482,513161,234262,1368905
2023-05-05 17:36,1368915,621490,513161,234264,1368915
2023-05-05 17:37,1368927,621496,513165,234266,1368927
2023-05-05 17:38,1368937,621505,513165,234267,1368937
2023-05-05 17:39,1368949,621514,513166,234269,1368949
2023-05-05 17:40,1368959,621523,513166,234270,1368959
2023-05-05 17:41,1368970,621529,513170,234271,1368970
2023-05-05 17:42,1368982,621540,513170,234272,1368982
2023-05-05 17:43,1368993,621548,513172,234273,1368993
2023-05-05 17:44,1369003,621558,513172,234273,1369003
2023-05-05 17:45,1369014,621564,513176,234274,1369014
2023-05-05 17:46,1369026,621575,513176,234275,1369026
2023-05-05 17:47,1369037,621584,513177,234276,1369037
2023-05-05 17:48,1369048,621594,513177,234277,1369048
2023-05-05 17:49,1369059,621604,513177,234278,1369059
2023-05-05 17:50,1369069,621613,513177,234279,1369069
2023-05-05 17:51,1369080,621619,513182,234279,1369080
2023-05-05 17:52,1369091,621629,513182,234280,1369091
2023-05-05 17:53,1369102,621635,513187,234280,1369102
2023-05-05 17:54,1369113,621645,513187,234281,1369113
2023-05-05 17:55,1369125,621655,513189,234281,1369125
2023-05-05 17:56,1369135,621665,513189,234281,1369135
2023-05-05 17:57,1369146,621670,513193,234283,1369146
2023-05-05 17:58,1369157,621679,513196,234282,1369157
2023-05-05 17:59,1369168,621689,513196,234283,1369168
2023-05-05 18:00,1369185,621701,513200,234284,1369185
2023-05-05 18:01,1369207,621722,513200,234285,1369207
2023-05-05 18:02,1369233,621746,513202,234285,1369233
2023-05-05 18:03,1369256,621769,513202,234285,1369256
2023-05-05 18:04,1369279,621788,513205,234286,1369279
2023-05-05 18:05,1369302,621810,513206,234286,1369302
2023-05-05 18:06,1369326,621834,513206,234286,1369326
2023-05-05 18:07,1369350,621856,513208,234286,1369350
2023-05-05 18:08,1369373,621875,513210,234288,1369373
2023-05-05 18:09,1369398,621899,513210,234289,1369398
2023-05-05 18:10,1369422,621920,513213,234289,1369422
2023-05-05 18:11,1369444,621941,513213,234290,1369444
2023-05-05 18:12,1369468,621959,513218,234291,1369468
2023-05-05 18:13,1369492,621983,513218,234291,1369492
2023-05-05 18:14,1369516,622002,513221,234293,1369516
2023-05-05 18:15,1369540,622026,513221,234293,1369540
2023-05-05 18:16,1369563,622045,513224,234294,1369563
2023-05-05 18:17,1369586,622068,513224,234294,1369586
2023-05-05 18:18,1369610,622088,513227,234295,1369610
2023-05-05 18:19,1369634,622112,513227,234295,1369634
2023-05-05 18:20,1369657,622134,513227,234296,1369657
2023-05-05 18:21,1369681,622158,513227,234296,1369681
2023-05-05 18:23,1369705,622181,513227,234297,1369705
2023-05-05 18:24,1369728,622203,513227,234298,1369728
2023-05-05 18:25,1369752,622227,513227,234298,1369752
2023-05-05 18:26,1369776,622250,513227,234299,1369776
2023-05-05 18:27,1369800,622274,513227,234299,1369800
2023-05-05 18:28,1369824,622297,513227,234300,1369824
2023-05-05 18:29,1369847,622305,513242,234300,1369847
2023-05-05 18:30,1369871,622329,513242,234300,1369871
2023-05-05 18:31,1369895,622353,513242,234300,1369895
2023-05-05 18:32,1369918,622376,513242,234300,1369918
2023-05-05 18:33,1369942,622397,513242,234303,1369942
2023-05-05 18:34,1369966,622420,513242,234304,1369966
2023-05-05 18:35,1369990,622443,513242,234305,1369990
2023-05-05 18:36,1370013,622466,513242,234305,1370013
2023-05-05 18:37,1370036,622488,513242,234306,1370036
2023-05-05 18:38,1370060,622510,513242,234308,1370060
2023-05-05 18:39,1370084,622508,513267,234309,1370084
2023-05-05 18:40,1370108,622532,513267,234309,1370108
2023-05-05 18:41,1370132,622556,513267,234309,1370132
2023-05-05 18:42,1370157,622579,513267,234311,1370157
2023-05-05 18:43,1370180,622596,513273,234311,1370180
2023-05-05 18:44,1370204,622618,513273,234313,1370204
2023-05-05 18:45,1370227,622633,513281,234313,1370227
2023-05-05 18:46,1370250,622655,513281,234314,1370250
2023-05-05 18:47,1370275,622674,513286,234315,1370275
2023-05-05 18:48,1370299,622695,513288,234316,1370299
2023-05-05 18:49,1370323,622718,513288,234317,1370323
2023-05-05 18:50,1370347,622739,513291,234317,1370347
2023-05-05 18:51,1370370,622761,513291,234318,1370370
2023-05-05 18:52,1370394,622781,513293,234320,1370394
2023-05-05 18:53,1370419,622806,513293,234320,1370419
2023-05-05 18:54,1370442,622827,513295,234320,1370442
2023-05-05 18:55,1370465,622846,513297,234322,1370465
2023-05-05 18:56,1370488,622866,513300,234322,1370488
2023-05-05 18:57,1370513,622885,513304,234324,1370513
2023-05-05 18:58,1370538,622908,513305,234325,1370538
2023-05-05 18:59,1370562,622932,513305,234325,1370562
2023-05-05 19:00,1370579,622941,513311,234327,1370579
2023-05-05 19:01,1370595,622956,513311,234328,1370595
2023-05-05 19:02,1370609,622964,513316,234329,1370609
2023-05-05 19:03,1370625,622978,513318,234329,1370625
2023-05-05 19:04,1370641,622989,513322,234330,1370641
2023-05-05 19:05,1370655,623002,513322,234331,1370655
2023-05-05 19:06,1370671,623014,513326,234331,1370671
2023-05-05 19:07,1370688,623031,513326,234331,1370688
2023-05-05 19:08,1370703,623039,513331,234333,1370703
2023-05-05 19:09,1370717,623053,513331,234333,1370717
2023-05-05 19:11,1370733,623069,513331,234333,1370733
2023-05-05 19:12,1370746,623081,513332,234333,1370746
2023-05-05 19:13,1370762,623097,513332,234333,1370762
2023-05-05 19:14,1370778,623108,513337,234333,1370778
2023-05-05 19:15,1370793,623122,513338,234333,1370793
2023-05-05 19:16,1370808,623136,513338,234334,1370808
2023-05-05 19:17,1370822,623145,513340,234337,1370822
2023-05-05 19:19,1370837,623158,513341,234338,1370837
2023-05-05 19:20,1370878,623197,513341,234340,1370878
2023-05-05 19:21,1370893,623208,513345,234340,1370893
2023-05-05 19:22,1370908,623221,513345,234342,1370908
2023-05-05 19:25,1370923,623229,513351,234343,1370923
2023-05-05 19:27,1370963,623256,513361,234346,1370963
2023-05-05 19:28,1370988,623278,513364,234346,1370988
2023-05-05 19:29,1371003,623288,513367,234348,1371003
2023-05-05 19:30,1371017,623301,513367,234349,1371017
2023-05-05 19:31,1371032,623315,513368,234349,1371032
2023-05-05 19:32,1371047,623329,513368,234350,1371047
2023-05-05 19:35,1371061,623338,513371,234352,1371061
2023-05-05 19:36,1371097,623367,513374,234356,1371097
2023-05-05 19:37,1371121,623391,513374,234356,1371121
2023-05-05 19:38,1371136,623402,513378,234356,1371136
2023-05-05 19:39,1371152,623418,513378,234356,1371152
2023-05-05 19:40,1371166,623425,513382,234359,1371166
2023-05-05 19:41,1371180,623438,513382,234360,1371180
2023-05-05 19:42,1371196,623452,513383,234361,1371196
2023-05-05 19:43,1371211,623466,513383,234362,1371211
2023-05-05 19:44,1371228,623480,513386,234362,1371228
2023-05-05 19:45,1371243,623492,513389,234362,1371243
2023-05-05 19:46,1371258,623507,513389,234362,1371258
2023-05-05 19:47,1371273,623519,513391,234363,1371273
2023-05-05 19:48,1371289,623535,513391,234363,1371289
2023-05-05 19:50,1371302,623547,513392,234363,1371302
2023-05-05 19:51,1371318,623561,513392,234365,1371318
2023-05-05 19:52,1371332,623572,513394,234366,1371332
2023-05-05 19:53,1371348,623583,513399,234366,1371348
2023-05-05 19:54,1371362,623597,513399,234366,1371362
2023-05-05 19:55,1371377,623610,513401,234366,1371377
2023-05-05 19:56,1371391,623624,513401,234366,1371391
2023-05-05 19:57,1371405,623636,513403,234366,1371405
2023-05-05 19:58,1371421,623652,513403,234366,1371421
2023-05-05 19:59,1371435,623662,513407,234366,1371435
2023-05-05 20:00,1371451,623675,513409,234367,1371451
2023-05-05 20:01,1371475,623699,513409,234367,1371475
2023-05-05 20:02,1371496,623717,513411,234368,1371496
2023-05-05 20:03,1371520,623741,513411,234368,1371520
2023-05-05 20:04,1371543,623764,513411,234368,1371543
2023-05-05 20:05,1371565,623786,513411,234368,1371565
2023-05-05 20:06,1371588,623805,513414,234369,1371588
2023-05-05 20:07,1371611,623827,513414,234370,1371611
2023-05-05 20:08,1371634,623848,513416,234370,1371634
2023-05-05 20:09,1371656,623869,513416,234371,1371656
2023-05-05 20:10,1371680,623891,513418,234371,1371680
2023-05-05 20:11,1371702,623912,513418,234372,1371702
2023-05-05 20:12,1371724,623932,513420,234372,1371724
2023-05-05 20:13,1371748,623954,513420,234374,1371748
2023-05-05 20:14,1371771,623976,513421,234374,1371771
2023-05-05 20:15,1371792,623996,513421,234375,1371792
2023-05-05 20:16,1371816,624018,513422,234376,1371816
2023-05-05 20:17,1371838,624039,513422,234377,1371838
2023-05-05 20:18,1371862,624058,513427,234377,1371862
2023-05-05 20:19,1371886,624078,513431,234377,1371886
2023-05-05 20:20,1371908,624099,513431,234378,1371908
2023-05-05 20:21,1371932,624123,513431,234378,1371932
2023-05-05 20:22,1371955,624143,513431,234381,1371955
2023-05-05 20:23,1371976,624156,513437,234383,1371976
2023-05-05 20:24,1371999,624179,513437,234383,1371999
2023-05-05 20:25,1372022,624204,513435,234383,1372022
2023-05-05 20:26,1372045,624226,513435,234384,1372045
2023-05-05 20:27,1372068,624242,513440,234386,1372068
2023-05-05 20:28,1372089,624261,513440,234388,1372089
2023-05-05 20:29,1372111,624279,513443,234389,1372111
2023-05-05 20:30,1372134,624302,513443,234389,1372134
2023-05-05 20:31,1372158,624323,513446,234389,1372158
2023-05-05 20:32,1372180,624344,513446,234390,1372180
2023-05-05 20:33,1372205,624368,513446,234391,1372205
2023-05-05 20:34,1372227,624390,513446,234391,1372227
2023-05-05 20:35,1372249,624409,513449,234391,1372249
2023-05-05 20:36,1372272,624429,513451,234392,1372272
2023-05-05 20:38,1372295,624452,513451,234392,1372295
2023-05-05 20:39,1372318,624473,513452,234393,1372318
2023-05-05 20:40,1372340,624494,513453,234393,1372340
2023-05-05 20:41,1372363,624517,513453,234393,1372363
2023-05-05 20:42,1372386,624534,513458,234394,1372386
2023-05-05 20:43,1372410,624556,513458,234396,1372410
2023-05-05 20:44,1372433,624575,513462,234396,1372433
2023-05-05 20:45,1372456,624595,513462,234399,1372456
2023-05-05 20:46,1372479,624616,513462,234401,1372479
2023-05-05 20:47,1372501,624638,513462,234401,1372501
2023-05-05 20:48,1372523,624657,513464,234402,1372523
2023-05-05 20:49,1372547,624681,513464,234402,1372547
2023-05-05 20:50,1372571,624701,513467,234403,1372571
2023-05-05 20:51,1372593,624722,513467,234404,1372593
2023-05-05 20:52,1372617,624745,513468,234404,1372617
2023-05-05 20:53,1372640,624767,513468,234405,1372640
2023-05-05 20:54,1372662,624786,513471,234405,1372662
2023-05-05 20:55,1372684,624806,513471,234407,1372684
2023-05-05 20:56,1372707,624825,513475,234407,1372707
2023-05-05 20:57,1372729,624847,513475,234407,1372729
2023-05-05 20:58,1372752,624868,513477,234407,1372752
2023-05-05 20:59,1372774,624887,513479,234408,1372774
2023-05-05 21:00,1372790,624902,513479,234409,1372790
2023-05-05 21:01,1372798,624908,513479,234411,1372798
2023-05-05 21:02,1372806,624915,513479,234412,1372806
2023-05-05 21:03,1372814,624920,513482,234412,1372814
2023-05-05 21:04,1372822,624928,513482,234412,1372822
2023-05-05 21:05,1372830,624933,513483,234414,1372830
2023-05-05 21:06,1372837,624938,513483,234416,1372837
2023-05-05 21:07,1372845,624939,513490,234416,1372845
2023-05-05 21:08,1372854,624948,513490,234416,1372854
2023-05-05 21:09,1372861,624949,513493,234419,1372861
2023-05-05 21:10,1372869,624956,513493,234420,1372869
2023-05-05 21:11,1372877,624958,513499,234420,1372877
2023-05-05 21:12,1372885,624966,513499,234420,1372885
2023-05-05 21:13,1372893,624970,513503,234420,1372893
2023-05-05 21:14,1372900,624974,513506,234420,1372900
2023-05-05 21:15,1372908,624979,513506,234423,1372908
2023-05-05 21:16,1372917,624983,513511,234423,1372917
2023-05-05 21:17,1372926,624990,513511,234425,1372926
2023-05-05 21:18,1372933,624994,513514,234425,1372933
2023-05-05 21:19,1372942,625002,513514,234426,1372942
2023-05-05 21:20,1372950,625006,513518,234426,1372950
2023-05-05 21:21,1372958,625014,513518,234426,1372958
2023-05-05 21:22,1372967,625020,513519,234428,1372967
2023-05-05 21:23,1372976,625030,513519,234427,1372976
2023-05-05 21:25,1372984,625032,513523,234429,1372984
2023-05-05 21:26,1372991,625037,513523,234431,1372991
2023-05-05 21:27,1372999,625042,513525,234432,1372999
2023-05-05 21:28,1373007,625050,513525,234432,1373007
2023-05-05 21:29,1373014,625054,513528,234432,1373014
2023-05-05 21:30,1373022,625061,513528,234433,1373022
2023-05-05 21:31,1373030,625065,513532,234433,1373030
2023-05-05 21:32,1373038,625073,513532,234433,1373038
2023-05-05 21:33,1373046,625076,513537,234433,1373046
2023-05-05 21:34,1373054,625083,513537,234434,1373054
2023-05-05 21:35,1373061,625088,513539,234434,1373061
2023-05-05 21:36,1373069,625095,513539,234435,1373069
2023-05-05 21:37,1373077,625100,513542,234435,1373077
2023-05-05 21:38,1373085,625106,513542,234437,1373085
2023-05-05 21:39,1373093,625110,513545,234438,1373093
2023-05-05 21:40,1373101,625117,513545,234439,1373101
2023-05-05 21:41,1373108,625121,513545,234442,1373108
2023-05-05 21:42,1373116,625125,513550,234441,1373116
2023-05-05 21:43,1373125,625130,513550,234445,1373125
2023-05-05 21:44,1373133,625135,513553,234445,1373133
2023-05-05 21:45,1373141,625142,513553,234446,1373141
2023-05-05 21:46,1373148,625147,513555,234446,1373148
2023-05-05 21:47,1373156,625152,513555,234449,1373156
2023-05-05 21:48,1373164,625154,513558,234452,1373164
2023-05-05 21:49,1373172,625162,513558,234452,1373172
2023-05-05 21:50,1373180,625162,513565,234453,1373180
2023-05-05 21:51,1373187,625167,513565,234455,1373187
2023-05-05 21:52,1373197,625173,513569,234455,1373197
2023-05-05 21:53,1373206,625181,513569,234456,1373206
2023-05-05 21:54,1373214,625189,513568,234457,1373214
2023-05-05 21:55,1373223,625198,513568,234457,1373223
2023-05-05 21:56,1373230,625204,513569,234457,1373230
2023-05-05 21:57,1373239,625212,513569,234458,1373239
2023-05-05 21:58,1373247,625213,513574,234460,1373247
2023-05-05 21:59,1373255,625221,513574,234460,1373255
2023-05-05 22:00,1373276,625236,513579,234461,1373276
2023-05-05 22:01,1373304,625263,513579,234462,1373304
2023-05-05 22:02,1373330,625283,513582,234465,1373330
2023-05-05 22:03,1373359,625309,513583,234467,1373359
2023-05-05 22:04,1373384,625332,513583,234469,1373384
2023-05-05 22:05,1373410,625354,513586,234470,1373410
2023-05-05 22:06,1373438,625378,513586,234474,1373438
2023-05-05 22:07,1373463,625396,513592,234475,1373463
2023-05-05 22:08,1373492,625423,513594,234475,1373492
2023-05-05 22:09,1373518,625446,513594,234478,1373518
2023-05-05 22:10,1373546,625468,513598,234480,1373546
2023-05-05 22:11,1373571,625491,513598,234482,1373571
2023-05-05 22:13,1373599,625513,513603,234483,1373599
2023-05-05 22:14,1373624,625538,513603,234483,1373624
2023-05-05 22:15,1373654,625558,513610,234486,1373654
2023-05-05 22:16,1373680,625583,513610,234487,1373680
2023-05-05 22:17,1373709,625606,513614,234489,1373709
2023-05-05 22:18,1373735,625631,513614,234490,1373735
2023-05-05 22:19,1373762,625647,513624,234491,1373762
2023-05-05 22:20,1373788,625668,513626,234494,1373788
2023-05-05 22:21,1373814,625691,513626,234497,1373814
2023-05-05 22:22,1373842,625709,513632,234501,1373842
2023-05-05 22:23,1373868,625735,513632,234501,1373868
2023-05-05 22:24,1373895,625759,513635,234501,1373895
2023-05-05 22:25,1373923,625786,513635,234502,1373923
2023-05-05 22:26,1373951,625807,513641,234503,1373951
2023-05-05 22:27,1373976,625832,513641,234503,1373976
2023-05-05 22:28,1374003,625855,513643,234505,1374003
2023-05-05 22:29,1374030,625880,513643,234507,1374030
2023-05-05 22:30,1374056,625901,513646,234509,1374056
2023-05-05 22:31,1374084,625929,513646,234509,1374084
2023-05-05 22:32,1374109,625951,513646,234512,1374109
2023-05-05 22:33,1374137,625978,513646,234513,1374137
2023-05-05 22:34,1374163,625994,513656,234513,1374163
2023-05-05 22:35,1374191,626018,513659,234514,1374191
2023-05-05 22:36,1374219,626044,513659,234516,1374219
2023-05-05 22:37,1374245,626062,513667,234516,1374245
2023-05-05 22:38,1374271,626088,513667,234516,1374271
2023-05-05 22:39,1374298,626110,513671,234517,1374298
2023-05-05 22:40,1374324,626134,513671,234519,1374324
2023-05-05 22:41,1374352,626160,513673,234519,1374352
2023-05-05 22:42,1374378,626184,513673,234521,1374378
2023-05-05 22:43,1374404,626207,513676,234521,1374404
2023-05-05 22:44,1374434,626236,513676,234522,1374434
2023-05-05 22:45,1374460,626256,513680,234524,1374460
2023-05-05 22:46,1374486,626282,513680,234524,1374486
2023-05-05 22:47,1374516,626308,513683,234525,1374516
2023-05-05 22:48,1374541,626332,513683,234526,1374541
2023-05-05 22:49,1374568,626353,513688,234527,1374568
2023-05-05 22:50,1374594,626377,513688,234529,1374594
2023-05-05 22:51,1374623,626399,513694,234530,1374623
2023-05-05 22:52,1374648,626423,513694,234531,1374648
2023-05-05 22:53,1374675,626446,513697,234532,1374675
2023-05-05 22:54,1374702,626471,513697,234534,1374702
2023-05-05 22:55,1374730,626493,513702,234535,1374730
2023-05-05 22:56,1374756,626519,513702,234535,1374756
2023-05-05 22:57,1374783,626540,513708,234535,1374783
2023-05-05 22:58,1374812,626567,513708,234537,1374812
2023-05-05 23:00,1374838,626592,513709,234537,1374838
2023-05-05 23:01,1374859,626611,513709,234539,1374859
2023-05-05 23:02,1374878,626628,513711,234539,1374878
2023-05-05 23:03,1374899,626649,513711,234539,1374899
2023-05-05 23:04,1374922,626668,513715,234539,1374922
2023-05-05 23:05,1374942,626686,513715,234541,1374942
2023-05-05 23:06,1374962,626705,513716,234541,1374962
2023-05-05 23:07,1374983,626726,513716,234541,1374983
2023-05-05 23:08,1375004,626743,513720,234541,1375004
2023-05-05 23:09,1375026,626762,513720,234544,1375026
2023-05-05 23:10,1375047,626778,513724,234545,1375047
2023-05-05 23:11,1375067,626797,513724,234546,1375067
2023-05-05 23:12,1375088,626813,513727,234548,1375088
2023-05-05 23:13,1375108,626833,513727,234548,1375108
2023-05-05 23:14,1375130,626851,513730,234549,1375130
2023-05-05 23:15,1375150,626870,513730,234550,1375150
2023-05-05 23:16,1375170,626885,513732,234553,1375170
2023-05-05 23:17,1375191,626905,513732,234554,1375191
2023-05-05 23:18,1375213,626923,513734,234556,1375213
2023-05-05 23:19,1375234,626943,513734,234557,1375234
2023-05-05 23:20,1375254,626957,513739,234558,1375254
2023-05-05 23:21,1375275,626973,513739,234563,1375275
2023-05-05 23:22,1375296,626990,513742,234564,1375296
2023-05-05 23:23,1375316,627010,513742,234564,1375316
2023-05-05 23:24,1375337,627023,513747,234567,1375337
2023-05-05 23:25,1375358,627043,513747,234568,1375358
2023-05-05 23:26,1375379,627055,513755,234569,1375379
2023-05-05 23:27,1375399,627075,513755,234569,1375399
2023-05-05 23:28,1375420,627092,513759,234569,1375420
2023-05-05 23:29,1375441,627113,513759,234569,1375441
2023-05-05 23:30,1375461,627123,513768,234570,1375461
2023-05-05 23:31,1375483,627145,513768,234570,1375483
2023-05-05 23:32,1375503,627160,513773,234570,1375503
2023-05-05 23:33,1375524,627181,513773,234570,1375524
2023-05-05 23:34,1375545,627193,513781,234571,1375545
2023-05-05 23:35,1375565,627212,513781,234572,1375565
2023-05-05 23:36,1375586,627227,513785,234574,1375586
2023-05-05 23:37,1375606,627247,513785,234574,1375606
2023-05-05 23:38,1375627,627261,513791,234575,1375627
2023-05-05 23:39,1375649,627281,513791,234577,1375649
2023-05-05 23:40,1375669,627297,513794,234578,1375669
2023-05-05 23:41,1375690,627316,513794,234580,1375690
2023-05-05 23:42,1375711,627335,513796,234580,1375711
2023-05-05 23:43,1375732,627356,513796,234580,1375732
2023-05-05 23:44,1375752,627374,513799,234579,1375752
2023-05-05 23:45,1375773,627392,513799,234582,1375773
2023-05-05 23:47,1375794,627410,513802,234582,1375794
2023-05-05 23:48,1375815,627428,513802,234585,1375815
2023-05-05 23:49,1375836,627449,513802,234585,1375836
2023-05-05 23:50,1375856,627468,513802,234586,1375856
2023-05-05 23:51,1375879,627489,513804,234586,1375879
2023-05-05 23:52,1375899,627507,513804,234588,1375899
2023-05-05 23:53,1375920,627522,513808,234590,1375920
2023-05-05 23:54,1375940,627541,513808,234591,1375940
2023-05-05 23:55,1375961,627558,513811,234592,1375961
2023-05-05 23:56,1375982,627579,513811,234592,1375982
2023-05-05 23:57,1376002,627595,513815,234592,1376002
2023-05-05 23:58,1376024,627617,513815,234592,1376024
2023-05-05 23:59,1376044,627635,513817,234592,1376044
2023-05-06 00:00,1376064,627653,513817,234594,1376064
2023-05-06 00:01,1376082,627667,513820,234595,1376082
2023-05-06 00:02,1376100,627684,513820,234596,1376100
2023-05-06 00:03,1376118,627701,513821,234596,1376118
2023-05-06 00:04,1376136,627718,513821,234597,1376136
2023-05-06 00:05,1376156,627735,513824,234597,1376156
2023-05-06 00:06,1376173,627753,513824,234596,1376173
2023-05-06 00:07,1376192,627766,513829,234597,1376192
2023-05-06 00:08,1376209,627783,513829,234597,1376209
2023-05-06 00:09,1376227,627798,513832,234597,1376227
2023-05-06 00:10,1376246,627815,513832,234599,1376246
2023-05-06 00:11,1376264,627826,513837,234601,1376264
2023-05-06 00:12,1376282,627844,513837,234601,1376282
2023-05-06 00:13,1376300,627859,513839,234602,1376300
2023-05-06 00:14,1376319,627874,513839,234606,1376319
2023-05-06 00:15,1376338,627889,513842,234607,1376338
2023-05-06 00:16,1376355,627905,513842,234608,1376355
2023-05-06 00:17,1376373,627922,513843,234608,1376373
2023-05-06 00:18,1376391,627940,513843,234608,1376391
2023-05-06 00:19,1376409,627950,513849,234610,1376409
2023-05-06 00:20,1376428,627969,513849,234610,1376428
2023-05-06 00:21,1376446,627982,513853,234611,1376446
2023-05-06 00:22,1376465,627998,513853,234614,1376465
2023-05-06 00:23,1376483,628013,513855,234615,1376483
2023-05-06 00:24,1376501,628030,513855,234616,1376501
2023-05-06 00:25,1376520,628047,513857,234616,1376520
2023-05-06 00:26,1376538,628058,513862,234618,1376538
2023-05-06 00:27,1376557,628076,513863,234618,1376557
2023-05-06 00:28,1376574,628092,513863,234619,1376574
2023-05-06 00:29,1376593,628111,513863,234619,1376593
2023-05-06 00:30,1376610,628128,513863,234619,1376610
2023-05-06 00:31,1376630,628145,513865,234620,1376630
2023-05-06 00:32,1376647,628161,513865,234621,1376647
2023-05-06 00:34,1376665,628177,513867,234621,1376665
2023-05-06 00:35,1376683,628195,513867,234621,1376683
2023-05-06 00:36,1376703,628210,513871,234622,1376703
2023-05-06 00:37,1376721,628222,513876,234623,1376721
2023-05-06 00:38,1376739,628240,513876,234623,1376739
2023-05-06 00:39,1376757,628254,513879,234624,1376757
2023-05-06 00:40,1376776,628273,513879,234624,1376776
2023-05-06 00:41,1376795,628288,513882,234625,1376795
2023-05-06 00:42,1376813,628305,513882,234626,1376813
2023-05-06 00:43,1376832,628323,513883,234626,1376832
2023-05-06 00:44,1376849,628338,513883,234628,1376849
2023-05-06 00:45,1376868,628354,513886,234628,1376868
2023-05-06 00:46,1376886,628371,513886,234629,1376886
2023-05-06 00:47,1376904,628385,513889,234630,1376904
2023-05-06 00:48,1376922,628401,513889,234632,1376922
2023-05-06 00:49,1376940,628415,513891,234634,1376940
2023-05-06 00:50,1376959,628434,513891,234634,1376959
2023-05-06 00:51,1376977,628449,513893,234635,1376977
2023-05-06 00:52,1376995,628467,513893,234635,1376995
2023-05-06 00:53,1377014,628486,513893,234635,1377014
2023-05-06 00:54,1377031,628500,513893,234638,1377031
2023-05-06 00:55,1377049,628517,513894,234638,1377049
2023-05-06 00:56,1377068,628535,513894,234639,1377068
2023-05-06 00:57,1377086,628552,513895,234639,1377086
2023-05-06 00:58,1377104,628570,513895,234639,1377104
2023-05-06 00:59,1377123,628586,513897,234640,1377123
2023-05-06 01:00,1377147,628605,513899,234643,1377147
2023-05-06 01:01,1377179,628635,513899,234645,1377179
2023-05-06 01:02,1377211,628666,513899,234646,1377211
2023-05-06 01:03,1377243,628692,513903,234648,1377243
2023-05-06 01:04,1377275,628722,513903,234650,1377275
2023-05-06 01:05,1377308,628749,513907,234652,1377308
2023-05-06 01:06,1377339,628779,513907,234653,1377339
2023-05-06 01:07,1377372,628809,513909,234654,1377372
2023-05-06 01:08,1377404,628840,513909,234655,1377404
2023-05-06 01:09,1377436,628871,513910,234655,1377436
2023-05-06 01:10,1377470,628905,513910,234655,1377470
2023-05-06 01:11,1377502,628937,513910,234655,1377502
2023-05-06 01:12,1377534,628968,513910,234656,1377534
2023-05-06 01:13,1377567,628999,513911,234657,1377567
2023-05-06 01:14,1377599,629031,513911,234657,1377599
2023-05-06 01:15,1377630,629060,513912,234658,1377630
2023-05-06 01:16,1377663,629093,513912,234658,1377663
2023-05-06 01:17,1377696,629125,513913,234658,1377696
2023-05-06 01:18,1377727,629156,513913,234658,1377727
2023-05-06 01:19,1377758,629185,513914,234659,1377758
2023-05-06 01:20,1377792,629219,513914,234659,1377792
2023-05-06 01:21,1377824,629249,513916,234659,1377824
2023-05-06 01:22,1377856,629281,513916,234659,1377856
2023-05-06 01:23,1377888,629312,513917,234659,1377888
2023-05-06 01:25,1377921,629345,513917,234659,1377921
2023-05-06 01:26,1377952,629377,513916,234659,1377952
2023-05-06 01:27,1377986,629411,513916,234659,1377986
2023-05-06 01:28,1378017,629441,513917,234659,1378017
2023-05-06 01:29,1378049,629473,513917,234659,1378049
2023-05-06 01:30,1378081,629503,513918,234660,1378081
2023-05-06 01:31,1378114,629536,513918,234660,1378114
2023-05-06 01:32,1378145,629563,513921,234661,1378145
2023-05-06 01:33,1378177,629594,513921,234662,1378177
2023-05-06 01:34,1378211,629627,513921,234663,1378211
2023-05-06 01:35,1378241,629657,513921,234663,1378241
2023-05-06 01:36,1378274,629688,513921,234665,1378274
2023-05-06 01:37,1378308,629722,513921,234665,1378308
2023-05-06 01:38,1378340,629752,513922,234666,1378340
2023-05-06 01:39,1378371,629783,513922,234666,1378371
2023-05-06 01:40,1378403,629812,513924,234667,1378403
2023-05-06 01:41,1378435,629844,513924,234667,1378435
2023-05-06 01:42,1378469,629875,513927,234667,1378469
2023-05-06 01:43,1378501,629907,513927,234667,1378501
2023-05-06 01:44,1378533,629934,513932,234667,1378533
2023-05-06 01:45,1378564,629965,513932,234667,1378564
2023-05-06 01:46,1378596,629995,513934,234667,1378596
2023-05-06 01:47,1378630,630029,513934,234667,1378630
2023-05-06 01:48,1378660,630057,513936,234667,1378660
2023-05-06 01:49,1378695,630092,513936,234667,1378695
2023-05-06 01:50,1378726,630122,513937,234667,1378726
2023-05-06 01:51,1378759,630155,513937,234667,1378759
2023-05-06 01:52,1378791,630185,513939,234667,1378791
2023-05-06 01:53,1378824,630217,513939,234668,1378824
2023-05-06 01:54,1378853,630245,513940,234668,1378853
2023-05-06 01:55,1378887,630279,513940,234668,1378887
2023-05-06 01:56,1378920,630311,513941,234668,1378920
2023-05-06 01:57,1378952,630341,513941,234670,1378952
2023-05-06 01:58,1378985,630373,513942,234670,1378985
2023-05-06 01:59,1379016,630403,513942,234671,1379016
2023-05-06 02:00,1379033,630419,513943,234671,1379033
2023-05-06 02:01,1379044,630430,513943,234671,1379044
2023-05-06 02:02,1379054,630439,513943,234672,1379054
2023-05-06 02:03,1379065,630449,513943,234673,1379065
2023-05-06 02:04,1379075,630457,513945,234673,1379075
2023-05-06 02:05,1379085,630467,513945,234673,1379085
2023-05-06 02:06,1379096,630478,513945,234673,1379096
2023-05-06 02:07,1379107,630489,513945,234673,1379107
2023-05-06 02:08,1379117,630498,513946,234673,1379117
2023-05-06 02:09,1379128,630509,513946,234673,1379128
2023-05-06 02:10,1379139,630519,513947,234673,1379139
2023-05-06 02:11,1379149,630529,513947,234673,1379149
2023-05-06 02:13,1379160,630540,513947,234673,1379160
2023-05-06 02:14,1379170,630550,513947,234673,1379170
2023-05-06 02:15,1379181,630559,513949,234673,1379181
2023-05-06 02:16,1379191,630568,513949,234674,1379191
2023-05-06 02:17,1379202,630578,513949,234675,1379202
2023-05-06 02:18,1379213,630589,513949,234675,1379213
2023-05-06 02:19,1379223,630599,513949,234675,1379223
2023-05-06 02:20,1379234,630610,513949,234675,1379234
2023-05-06 02:21,1379244,630617,513951,234676,1379244
2023-05-06 02:22,1379255,630628,513951,234676,1379255
2023-05-06 02:23,1379265,630637,513952,234676,1379265
2023-05-06 02:24,1379276,630648,513952,234676,1379276
2023-05-06 02:25,1379286,630655,513955,234676,1379286
2023-05-06 02:26,1379297,630664,513955,234678,1379297
2023-05-06 02:27,1379308,630675,513955,234678,1379308
2023-05-06 02:28,1379318,630684,513955,234679,1379318
2023-05-06 02:29,1379329,630694,513955,234680,1379329
2023-05-06 02:30,1379339,630704,513955,234680,1379339
2023-05-06 02:31,1379350,630711,513958,234681,1379350
2023-05-06 02:32,1379360,630721,513958,234681,1379360
2023-05-06 02:33,1379371,630731,513959,234681,1379371
2023-05-06 02:34,1379382,630742,513959,234681,1379382
2023-05-06 02:35,1379392,630750,513961,234681,1379392
2023-05-06 02:36,1379403,630761,513961,234681,1379403
2023-05-06 02:37,1379413,630771,513961,234681,1379413
2023-05-06 02:38,1379424,630782,513961,234681,1379424
2023-05-06 02:39,1379436,630794,513961,234681,1379436
2023-05-06 02:40,1379446,630804,513961,234681,1379446
2023-05-06 02:41,1379457,630815,513961,234681,1379457
2023-05-06 02:42,1379467,630825,513961,234681,1379467
2023-05-06 02:43,1379478,630834,513963,234681,1379478
2023-05-06 02:44,1379489,630845,513963,234681,1379489
2023-05-06 02:45,1379499,630854,513964,234681,1379499
2023-05-06 02:46,1379511,630866,513964,234681,1379511
2023-05-06 02:47,1379521,630875,513965,234681,1379521
2023-05-06 02:48,1379532,630886,513965,234681,1379532
2023-05-06 02:49,1379542,630895,513965,234682,1379542
2023-05-06 02:50,1379553,630906,513965,234682,1379553
2023-05-06 02:51,1379563,630915,513966,234682,1379563
2023-05-06 02:52,1379574,630927,513966,234681,1379574
2023-05-06 02:53,1379586,630937,513968,234681,1379586
2023-05-06 02:54,1379596,630947,513968,234681,1379596
2023-05-06 02:55,1379607,630957,513969,234681,1379607
2023-05-06 02:56,1379618,630968,513969,234681,1379618
2023-05-06 02:57,1379628,630978,513969,234681,1379628
2023-05-06 02:58,1379639,630988,513969,234682,1379639
2023-05-06 03:00,1379650,630998,513970,234682,1379650
2023-05-06 03:01,1379657,631005,513970,234682,1379657
2023-05-06 03:02,1379664,631011,513971,234682,1379664
2023-05-06 03:03,1379671,631018,513971,234682,1379671
2023-05-06 03:04,1379679,631025,513972,234682,1379679
2023-05-06 03:05,1379685,631031,513972,234682,1379685
2023-05-06 03:06,1379693,631038,513972,234683,1379693
2023-05-06 03:07,1379699,631044,513972,234683,1379699
2023-05-06 03:08,1379708,631049,513974,234685,1379708
2023-05-06 03:09,1379714,631055,513974,234685,1379714
2023-05-06 03:10,1379721,631061,513974,234686,1379721
2023-05-06 03:11,1379728,631068,513974,234686,1379728
2023-05-06 03:12,1379736,631076,513974,234686,1379736
2023-05-06 03:13,1379742,631082,513974,234686,1379742
2023-05-06 03:14,1379750,631090,513974,234686,1379750
2023-05-06 03:15,1379757,631097,513974,234686,1379757
2023-05-06 03:16,1379763,631103,513974,234686,1379763
2023-05-06 03:17,1379771,631111,513974,234686,1379771
2023-05-06 03:18,1379777,631116,513974,234687,1379777
2023-05-06 03:19,1379784,631123,513974,234687,1379784
2023-05-06 03:20,1379792,631130,513974,234688,1379792
2023-05-06 03:21,1379798,631135,513974,234689,1379798
2023-05-06 03:22,1379805,631141,513975,234689,1379805
2023-05-06 03:23,1379813,631148,513975,234690,1379813
2023-05-06 03:24,1379820,631155,513975,234690,1379820
2023-05-06 03:25,1379827,631162,513975,234690,1379827
2023-05-06 03:26,1379834,631168,513976,234690,1379834
2023-05-06 03:27,1379841,631175,513976,234690,1379841
2023-05-06 03:28,1379848,631182,513976,234690,1379848
2023-05-06 03:29,1379855,631189,513976,234690,1379855
2023-05-06 03:30,1379862,631196,513976,234690,1379862
2023-05-06 03:31,1379869,631203,513976,234690,1379869
2023-05-06 03:32,1379876,631210,513976,234690,1379876
2023-05-06 03:33,1379883,631217,513976,234690,1379883
2023-05-06 03:34,1379890,631224,513976,234690,1379890
2023-05-06 03:35,1379897,631231,513976,234690,1379897
2023-05-06 03:36,1379904,631235,513978,234691,1379904
2023-05-06 03:37,1379911,631242,513978,234691,1379911
2023-05-06 03:38,1379918,631248,513979,234691,1379918
2023-05-06 03:39,1379925,631255,513979,234691,1379925
2023-05-06 03:40,1379932,631261,513980,234691,1379932
2023-05-06 03:41,1379939,631268,513980,234691,1379939
2023-05-06 03:42,1379946,631274,513981,234691,1379946
2023-05-06 03:43,1379953,631282,513981,234690,1379953
2023-05-06 03:44,1379960,631289,513981,234690,1379960
2023-05-06 03:46,1379967,631296,513981,234690,1379967
2023-05-06 03:47,1379974,631303,513981,234690,1379974
2023-05-06 03:48,1379982,631311,513981,234690,1379982
2023-05-06 03:49,1379989,631317,513982,234690,1379989
2023-05-06 03:50,1379996,631323,513982,234691,1379996
2023-05-06 03:51,1380003,631330,513982,234691,1380003
2023-05-06 03:52,1380010,631337,513982,234691,1380010
2023-05-06 03:53,1380017,631344,513982,234691,1380017
2023-05-06 03:54,1380024,631351,513982,234691,1380024
2023-05-06 03:55,1380031,631356,513984,234691,1380031
2023-05-06 03:56,1380038,631363,513984,234691,1380038
2023-05-06 03:57,1380045,631370,513984,234691,1380045
2023-05-06 03:58,1380052,631377,513984,234691,1380052
2023-05-06 03:59,1380059,631384,513984,234691,1380059
2023-05-06 04:00,1380068,631393,513984,234691,1380068
2023-05-06 04:01,1380078,631403,513984,234691,1380078
2023-05-06 04:02,1380089,631414,513984,234691,1380089
2023-05-06 04:03,1380099,631424,513984,234691,1380099
2023-05-06 04:04,1380110,631435,513984,234691,1380110
2023-05-06 04:05,1380121,631446,513984,234691,1380121
2023-05-06 04:06,1380132,631457,513984,234691,1380132
2023-05-06 04:07,1380142,631466,513985,234691,1380142
2023-05-06 04:08,1380153,631477,513985,234691,1380153
2023-05-06 04:09,1380164,631488,513985,234691,1380164
2023-05-06 04:10,1380174,631498,513985,234691,1380174
2023-05-06 04:11,1380186,631508,513986,234692,1380186
2023-05-06 04:12,1380196,631518,513986,234692,1380196
2023-05-06 04:13,1380207,631529,513986,234692,1380207
2023-05-06 04:14,1380218,631540,513986,234692,1380218
2023-05-06 04:15,1380229,631551,513986,234692,1380229
2023-05-06 04:16,1380239,631560,513986,234693,1380239
2023-05-06 04:17,1380251,631571,513987,234693,1380251
2023-05-06 04:18,1380261,631581,513987,234693,1380261
2023-05-06 04:19,1380272,631592,513987,234693,1380272
2023-05-06 04:20,1380283,631603,513987,234693,1380283
2023-05-06 04:21,1380294,631614,513987,234693,1380294
2023-05-06 04:22,1380304,631624,513987,234693,1380304
2023-05-06 04:23,1380315,631635,513987,234693,1380315
2023-05-06 04:24,1380325,631645,513987,234693,1380325
2023-05-06 04:25,1380337,631657,513987,234693,1380337
2023-05-06 04:26,1380347,631667,513987,234693,1380347
2023-05-06 04:27,1380358,631678,513987,234693,1380358
2023-05-06 04:28,1380368,631687,513987,234694,1380368
2023-05-06 04:29,1380379,631697,513988,234694,1380379
2023-05-06 04:30,1380390,631707,513988,234695,1380390
2023-05-06 04:32,1380401,631717,513989,234695,1380401
2023-05-06 04:33,1380412,631728,513989,234695,1380412
2023-05-06 04:34,1380423,631738,513990,234695,1380423
2023-05-06 04:35,1380433,631748,513990,234695,1380433
2023-05-06 04:36,1380444,631759,513990,234695,1380444
2023-05-06 04:37,1380455,631770,513990,234695,1380455
2023-05-06 04:38,1380466,631781,513990,234695,1380466
2023-05-06 04:39,1380476,631791,513990,234695,1380476
2023-05-06 04:40,1380487,631802,513990,234695,1380487
2023-05-06 04:41,1380498,631813,513990,234695,1380498
2023-05-06 04:42,1380509,631824,513990,234695,1380509
2023-05-06 04:43,1380520,631835,513990,234695,1380520
2023-05-06 04:44,1380530,631845,513990,234695,1380530
2023-05-06 04:45,1380541,631856,513990,234695,1380541
2023-05-06 04:46,1380552,631867,513990,234695,1380552
2023-05-06 04:47,1380562,631877,513990,234695,1380562
2023-05-06 04:48,1380573,631886,513992,234695,1380573
2023-05-06 04:49,1380584,631897,513992,234695,1380584
2023-05-06 04:50,1380595,631907,513993,234695,1380595
2023-05-06 04:51,1380605,631916,513993,234696,1380605
2023-05-06 04:52,1380616,631928,513993,234695,1380616
2023-05-06 04:53,1380627,631939,513993,234695,1380627
2023-05-06 04:54,1380638,631950,513993,234695,1380638
2023-05-06 04:55,1380648,631960,513993,234695,1380648
2023-05-06 04:56,1380659,631971,513993,234695,1380659
2023-05-06 04:57,1380670,631982,513993,234695,1380670
2023-05-06 04:58,1380681,631993,513993,234695,1380681
2023-05-06 04:59,1380691,632003,513993,234695,1380691
2023-05-06 05:00,1380709,632021,513993,234695,1380709
2023-05-06 05:01,1380736,632048,513993,234695,1380736
2023-05-06 05:02,1380761,632072,513994,234695,1380761
2023-05-06 05:03,1380785,632096,513994,234695,1380785
2023-05-06 05:04,1380812,632123,513994,234695,1380812
2023-05-06 05:05,1380838,632149,513994,234695,1380838
2023-05-06 05:06,1380863,632173,513995,234695,1380863
2023-05-06 05:07,1380889,632199,513995,234695,1380889
2023-05-06 05:08,1380914,632224,513995,234695,1380914
2023-05-06 05:09,1380940,632250,513995,234695,1380940
2023-05-06 05:10,1380965,632275,513995,234695,1380965
2023-05-06 05:11,1380990,632300,513995,234695,1380990
2023-05-06 05:12,1381014,632324,513995,234695,1381014
2023-05-06 05:13,1381041,632351,513995,234695,1381041
2023-05-06 05:14,1381066,632376,513995,234695,1381066
2023-05-06 05:15,1381091,632401,513995,234695,1381091
2023-05-06 05:16,1381116,632426,513995,234695,1381116
2023-05-06 05:17,1381143,632453,513995,234695,1381143
2023-05-06 05:19,1381167,632476,513996,234695,1381167
2023-05-06 05:20,1381192,632501,513996,234695,1381192
2023-05-06 05:21,1381217,632526,513996,234695,1381217
2023-05-06 05:22,1381242,632551,513996,234695,1381242
2023-05-06 05:23,1381269,632578,513996,234695,1381269
2023-05-06 05:24,1381294,632603,513996,234695,1381294
2023-05-06 05:25,1381319,632627,513997,234695,1381319
2023-05-06 05:26,1381345,632653,513997,234695,1381345
2023-05-06 05:27,1381369,632676,513998,234695,1381369
2023-05-06 05:28,1381395,632702,513998,234695,1381395
2023-05-06 05:29,1381421,632728,513998,234695,1381421
2023-05-06 05:30,1381446,632752,513998,234696,1381446
2023-05-06 05:31,1381472,632777,513998,234697,1381472
2023-05-06 05:32,1381497,632802,513998,234697,1381497
2023-05-06 05:33,1381522,632827,513998,234697,1381522
2023-05-06 05:34,1381547,632852,513998,234697,1381547
2023-05-06 05:35,1381571,632875,513999,234697,1381571
2023-05-06 05:36,1381599,632903,513999,234697,1381599
2023-05-06 05:37,1381623,632926,514000,234697,1381623
2023-05-06 05:38,1381648,632951,514000,234697,1381648
2023-05-06 05:39,1381674,632977,514000,234697,1381674
2023-05-06 05:40,1381700,633003,514000,234697,1381700
2023-05-06 05:41,1381725,633027,514001,234697,1381725
2023-05-06 05:42,1381750,633052,514001,234697,1381750
2023-05-06 05:43,1381775,633076,514002,234697,1381775
2023-05-06 05:44,1381801,633101,514003,234697,1381801
2023-05-06 05:45,1381826,633126,514003,234697,1381826
2023-05-06 05:46,1381851,633151,514003,234697,1381851
2023-05-06 05:47,1381875,633175,514003,234697,1381875
2023-05-06 05:48,1381901,633201,514003,234697,1381901
2023-05-06 05:49,1381927,633227,514003,234697,1381927
2023-05-06 05:50,1381952,633252,514003,234697,1381952
2023-05-06 05:51,1381978,633278,514003,234697,1381978
2023-05-06 05:52,1382004,633303,514003,234698,1382004
2023-05-06 05:53,1382028,633326,514003,234699,1382028
2023-05-06 05:54,1382053,633350,514003,234700,1382053
2023-05-06 05:55,1382079,633376,514003,234700,1382079
2023-05-06 05:56,1382105,633402,514003,234700,1382105
2023-05-06 05:57,1382129,633426,514003,234700,1382129
2023-05-06 05:58,1382154,633451,514003,234700,1382154
2023-05-06 05:59,1382180,633477,514003,234700,1382180
2023-05-06 06:00,1382197,633494,514003,234700,1382197
2023-05-06 06:01,1382212,633509,514003,234700,1382212
2023-05-06 06:02,1382226,633523,514003,234700,1382226
2023-05-06 06:03,1382241,633538,514003,234700,1382241
2023-05-06 06:04,1382256,633551,514005,234700,1382256
2023-05-06 06:06,1382270,633565,514005,234700,1382270
2023-05-06 06:07,1382285,633580,514005,234700,1382285
2023-05-06 06:08,1382301,633596,514005,234700,1382301
2023-05-06 06:09,1382316,633611,514005,234700,1382316
2023-05-06 06:10,1382331,633626,514005,234700,1382331
2023-05-06 06:11,1382346,633641,514005,234700,1382346
2023-05-06 06:12,1382361,633656,514005,234700,1382361
2023-05-06 06:13,1382375,633670,514005,234700,1382375
2023-05-06 06:14,1382389,633684,514005,234700,1382389
2023-05-06 06:15,1382405,633697,514008,234700,1382405
2023-05-06 06:16,1382419,633711,514008,234700,1382419
2023-05-06 06:17,1382434,633726,514008,234700,1382434
2023-05-06 06:18,1382449,633741,514008,234700,1382449
2023-05-06 06:19,1382463,633755,514008,234700,1382463
2023-05-06 06:20,1382478,633770,514008,234700,1382478
2023-05-06 06:21,1382493,633785,514008,234700,1382493
2023-05-06 06:22,1382508,633800,514008,234700,1382508
2023-05-06 06:23,1382522,633814,514008,234700,1382522
2023-05-06 06:24,1382538,633827,514011,234700,1382538
2023-05-06 06:25,1382552,633840,514011,234701,1382552
2023-05-06 06:26,1382567,633855,514011,234701,1382567
2023-05-06 06:27,1382582,633870,514011,234701,1382582
2023-05-06 06:28,1382597,633885,514011,234701,1382597
2023-05-06 06:29,1382612,633900,514011,234701,1382612
2023-05-06 06:30,1382626,633914,514011,234701,1382626
2023-05-06 06:31,1382641,633929,514011,234701,1382641
2023-05-06 06:32,1382656,633944,514011,234701,1382656
2023-05-06 06:33,1382671,633959,514011,234701,1382671
2023-05-06 06:34,1382685,633968,514016,234701,1382685
2023-05-06 06:35,1382700,633982,514016,234702,1382700
2023-05-06 06:36,1382714,633996,514016,234702,1382714
2023-05-06 06:37,1382729,634011,514016,234702,1382729
2023-05-06 06:38,1382744,634025,514016,234703,1382744
2023-05-06 06:39,1382760,634041,514016,234703,1382760
2023-05-06 06:40,1382774,634054,514016,234704,1382774
2023-05-06 06:41,1382789,634069,514016,234704,1382789
2023-05-06 06:42,1382804,634084,514016,234704,1382804
2023-05-06 06:43,1382818,634098,514016,234704,1382818
2023-05-06 06:44,1382833,634109,514020,234704,1382833
2023-05-06 06:45,1382848,634124,514020,234704,1382848
2023-05-06 06:46,1382862,634138,514020,234704,1382862
2023-05-06 06:47,1382877,634153,514020,234704,1382877
2023-05-06 06:48,1382892,634167,514020,234705,1382892
2023-05-06 06:49,1382907,634182,514020,234705,1382907
2023-05-06 06:50,1382922,634197,514020,234705,1382922
2023-05-06 06:51,1382936,634210,514020,234706,1382936
2023-05-06 06:52,1382951,634225,514020,234706,1382951
2023-05-06 06:53,1382966,634239,514020,234707,1382966
2023-05-06 06:55,1382980,634249,514024,234707,1382980
2023-05-06 06:56,1382995,634264,514024,234707,1382995
2023-05-06 06:57,1383010,634279,514024,234707,1383010
2023-05-06 06:58,1383025,634294,514024,234707,1383025
2023-05-06 06:59,1383040,634309,514024,234707,1383040
2023-05-06 07:00,1383055,634324,514024,234707,1383055
2023-05-06 07:01,1383069,634338,514024,234707,1383069
2023-05-06 07:02,1383085,634354,514024,234707,1383085
2023-05-06 07:03,1383099,634368,514024,234707,1383099
2023-05-06 07:04,1383114,634383,514024,234707,1383114
2023-05-06 07:05,1383130,634397,514026,234707,1383130
2023-05-06 07:06,1383145,634412,514026,234707,1383145
2023-05-06 07:07,1383159,634426,514026,234707,1383159
2023-05-06 07:08,1383174,634441,514026,234707,1383174
2023-05-06 07:09,1383189,634456,514026,234707,1383189
2023-05-06 07:10,1383204,634471,514026,234707,1383204
2023-05-06 07:11,1383219,634486,514026,234707,1383219
2023-05-06 07:12,1383235,634502,514026,234707,1383235
2023-05-06 07:13,1383249,634516,514026,234707,1383249
2023-05-06 07:14,1383264,634529,514028,234707,1383264
2023-05-06 07:15,1383279,634544,514028,234707,1383279
2023-05-06 07:16,1383295,634560,514028,234707,1383295
2023-05-06 07:17,1383310,634575,514028,234707,1383310
2023-05-06 07:18,1383325,634590,514028,234707,1383325
2023-05-06 07:19,1383342,634607,514028,234707,1383342
2023-05-06 07:20,1383357,634622,514028,234707,1383357
2023-05-06 07:21,1383371,634636,514028,234707,1383371
2023-05-06 07:22,1383387,634652,514028,234707,1383387
2023-05-06 07:23,1383402,634667,514028,234707,1383402
2023-05-06 07:24,1383416,634674,514035,234707,1383416
2023-05-06 07:25,1383432,634690,514035,234707,1383432
2023-05-06 07:26,1383447,634705,514035,234707,1383447
2023-05-06 07:27,1383461,634719,514035,234707,1383461
2023-05-06 07:28,1383477,634735,514035,234707,1383477
2023-05-06 07:29,1383492,634750,514035,234707,1383492
2023-05-06 07:30,1383507,634765,514035,234707,1383507
2023-05-06 07:31,1383522,634780,514035,234707,1383522
2023-05-06 07:32,1383537,634795,514035,234707,1383537
2023-05-06 07:33,1383552,634809,514035,234708,1383552
2023-05-06 07:34,1383566,634821,514036,234709,1383566
2023-05-06 07:35,1383581,634836,514036,234709,1383581
2023-05-06 07:36,1383597,634852,514036,234709,1383597
2023-05-06 07:37,1383612,634867,514036,234709,1383612
2023-05-06 07:38,1383627,634882,514036,234709,1383627
2023-05-06 07:39,1383642,634897,514036,234709,1383642
2023-05-06 07:40,1383657,634912,514036,234709,1383657
2023-05-06 07:41,1383672,634926,514036,234710,1383672
2023-05-06 07:43,1383686,634939,514036,234711,1383686
2023-05-06 07:44,1383701,634954,514036,234711,1383701
2023-05-06 07:45,1383716,634964,514040,234712,1383716
2023-05-06 07:46,1383732,634980,514040,234712,1383732
2023-05-06 07:47,1383746,634994,514040,234712,1383746
2023-05-06 07:48,1383761,635009,514040,234712,1383761
2023-05-06 07:49,1383777,635025,514040,234712,1383777
2023-05-06 07:50,1383792,635039,514040,234713,1383792
2023-05-06 07:51,1383808,635054,514040,234714,1383808
2023-05-06 07:52,1383823,635069,514040,234714,1383823
2023-05-06 07:53,1383838,635084,514040,234714,1383838
2023-05-06 07:54,1383852,635098,514040,234714,1383852
2023-05-06 07:55,1383868,635107,514046,234715,1383868
2023-05-06 07:56,1383882,635120,514046,234716,1383882
2023-05-06 07:57,1383898,635136,514046,234716,1383898
2023-05-06 07:58,1383912,635150,514046,234716,1383912
2023-05-06 07:59,1383928,635166,514046,234716,1383928
2023-05-06 08:00,1383944,635181,514046,234717,1383944
2023-05-06 08:01,1383962,635199,514046,234717,1383962
2023-05-06 08:02,1383983,635220,514046,234717,1383983
2023-05-06 08:03,1384002,635239,514046,234717,1384002
2023-05-06 08:04,1384020,635252,514051,234717,1384020
2023-05-06 08:05,1384040,635272,514051,234717,1384040
2023-05-06 08:06,1384059,635290,514051,234718,1384059
2023-05-06 08:07,1384079,635309,514051,234719,1384079
2023-05-06 08:08,1384098,635327,514051,234720,1384098
2023-05-06 08:09,1384118,635347,514051,234720,1384118
2023-05-06 08:10,1384137,635366,514051,234720,1384137
2023-05-06 08:11,1384156,635385,514051,234720,1384156
2023-05-06 08:12,1384176,635405,514051,234720,1384176
2023-05-06 08:13,1384195,635424,514051,234720,1384195
2023-05-06 08:14,1384214,635441,514053,234720,1384214
2023-05-06 08:15,1384234,635461,514053,234720,1384234
2023-05-06 08:16,1384254,635481,514053,234720,1384254
2023-05-06 08:17,1384274,635501,514053,234720,1384274
2023-05-06 08:18,1384293,635520,514053,234720,1384293
2023-05-06 08:19,1384312,635538,514053,234721,1384312
2023-05-06 08:20,1384332,635558,514053,234721,1384332
2023-05-06 08:21,1384351,635577,514053,234721,1384351
2023-05-06 08:22,1384370,635596,514053,234721,1384370
2023-05-06 08:23,1384390,635615,514053,234722,1384390
2023-05-06 08:24,1384409,635627,514059,234723,1384409
2023-05-06 08:25,1384430,635648,514059,234723,1384430
2023-05-06 08:26,1384449,635667,514059,234723,1384449
2023-05-06 08:27,1384468,635686,514059,234723,1384468
2023-05-06 08:28,1384488,635706,514059,234723,1384488
2023-05-06 08:29,1384508,635726,514059,234723,1384508
2023-05-06 08:31,1384527,635744,514059,234724,1384527
2023-05-06 08:32,1384546,635763,514059,234724,1384546
2023-05-06 08:33,1384566,635783,514059,234724,1384566
2023-05-06 08:34,1384585,635802,514059,234724,1384585
2023-05-06 08:35,1384605,635815,514066,234724,1384605
2023-05-06 08:36,1384624,635834,514066,234724,1384624
2023-05-06 08:37,1384643,635850,514066,234727,1384643
2023-05-06 08:38,1384663,635870,514066,234727,1384663
2023-05-06 08:39,1384683,635890,514066,234727,1384683
2023-05-06 08:40,1384702,635909,514066,234727,1384702
2023-05-06 08:41,1384722,635928,514066,234728,1384722
2023-05-06 08:42,1384740,635946,514066,234728,1384740
2023-05-06 08:43,1384761,635965,514066,234730,1384761
2023-05-06 08:44,1384780,635984,514066,234730,1384780
2023-05-06 08:45,1384801,635999,514072,234730,1384801
2023-05-06 08:46,1384820,636018,514072,234730,1384820
2023-05-06 08:47,1384839,636037,514072,234730,1384839
2023-05-06 08:48,1384858,636056,514072,234730,1384858
2023-05-06 08:49,1384879,636076,514072,234731,1384879
2023-05-06 08:50,1384897,636094,514072,234731,1384897
2023-05-06 08:51,1384917,636114,514072,234731,1384917
2023-05-06 08:52,1384936,636133,514072,234731,1384936
2023-05-06 08:53,1384955,636152,514072,234731,1384955
2023-05-06 08:54,1384975,636167,514077,234731,1384975
2023-05-06 08:55,1384994,636185,514077,234732,1384994
2023-05-06 08:56,1385013,636204,514077,234732,1385013
2023-05-06 08:57,1385035,636224,514077,234734,1385035
2023-05-06 08:58,1385054,636242,514077,234735,1385054
2023-05-06 08:59,1385073,636261,514077,234735,1385073
2023-05-06 09:00,1385097,636284,514077,234736,1385097
2023-05-06 09:01,1385124,636311,514077,234736,1385124
2023-05-06 09:02,1385152,636339,514077,234736,1385152
2023-05-06 09:03,1385178,636364,514077,234737,1385178
2023-05-06 09:04,1385203,636386,514080,234737,1385203
2023-05-06 09:05,1385231,636414,514080,234737,1385231
2023-05-06 09:06,1385257,636438,514080,234739,1385257
2023-05-06 09:07,1385283,636464,514080,234739,1385283
2023-05-06 09:08,1385310,636490,514080,234740,1385310
2023-05-06 09:09,1385339,636519,514080,234740,1385339
2023-05-06 09:10,1385364,636544,514080,234740,1385364
2023-05-06 09:11,1385390,636570,514080,234740,1385390
2023-05-06 09:12,1385418,636597,514080,234741,1385418
2023-05-06 09:13,1385445,636624,514080,234741,1385445
2023-05-06 09:14,1385471,636643,514087,234741,1385471
2023-05-06 09:15,1385496,636668,514087,234741,1385496
2023-05-06 09:16,1385524,636696,514087,234741,1385524
2023-05-06 09:18,1385549,636720,514087,234742,1385549
2023-05-06 09:19,1385576,636747,514087,234742,1385576
2023-05-06 09:20,1385602,636773,514087,234742,1385602
2023-05-06 09:21,1385630,636800,514087,234743,1385630
2023-05-06 09:22,1385656,636825,514087,234744,1385656
2023-05-06 09:23,1385682,636851,514087,234744,1385682
2023-05-06 09:24,1385708,636877,514087,234744,1385708
2023-05-06 09:25,1385736,636899,514093,234744,1385736
2023-05-06 09:26,1385761,636924,514093,234744,1385761
2023-05-06 09:27,1385790,636953,514093,234744,1385790
2023-05-06 09:28,1385816,636979,514093,234744,1385816
2023-05-06 09:29,1385841,637003,514093,234745,1385841
2023-05-06 09:30,1385868,637029,514093,234746,1385868
2023-05-06 09:31,1385894,637054,514093,234747,1385894
2023-05-06 09:32,1385920,637080,514093,234747,1385920
2023-05-06 09:33,1385947,637105,514093,234749,1385947
2023-05-06 09:34,1385974,637131,514093,234750,1385974
2023-05-06 09:35,1386001,637152,514097,234752,1386001
2023-05-06 09:36,1386028,637179,514097,234752,1386028
2023-05-06 09:37,1386054,637204,514097,234753,1386054
2023-05-06 09:38,1386080,637231,514097,234752,1386080
2023-05-06 09:39,1386108,637253,514103,234752,1386108
2023-05-06 09:40,1386133,637276,514103,234754,1386133
2023-05-06 09:41,1386159,637297,514108,234754,1386159
2023-05-06 09:42,1386187,637325,514108,234754,1386187
2023-05-06 09:43,1386213,637348,514110,234755,1386213
2023-05-06 09:44,1386241,637376,514110,234755,1386241
2023-05-06 09:45,1386267,637402,514110,234755,1386267
2023-05-06 09:46,1386294,637426,514113,234755,1386294
2023-05-06 09:47,1386319,637450,514113,234756,1386319
2023-05-06 09:48,1386346,637475,514115,234756,1386346
2023-05-06 09:49,1386374,637503,514115,234756,1386374
2023-05-06 09:50,1386401,637527,514118,234756,1386401
2023-05-06 09:51,1386429,637555,514118,234756,1386429
2023-05-06 09:52,1386455,637580,514118,234757,1386455
2023-05-06 09:53,1386482,637606,514118,234758,1386482
2023-05-06 09:54,1386508,637630,514120,234758,1386508
2023-05-06 09:55,1386534,637656,514120,234758,1386534
2023-05-06 09:56,1386561,637680,514123,234758,1386561
2023-05-06 09:57,1386588,637706,514123,234759,1386588
2023-05-06 09:58,1386617,637732,514125,234760,1386617
2023-05-06 09:59,1386643,637758,514125,234760,1386643
2023-05-06 10:00,1386657,637768,514128,234761,1386657
2023-05-06 10:01,1386670,637780,514128,234762,1386670
2023-05-06 10:02,1386682,637791,514128,234763,1386682
2023-05-06 10:03,1386694,637802,514128,234764,1386694
2023-05-06 10:05,1386707,637813,514129,234765,1386707
2023-05-06 10:06,1386720,637826,514129,234765,1386720
2023-05-06 10:07,1386733,637835,514132,234766,1386733
2023-05-06 10:08,1386746,637846,514134,234766,1386746
2023-05-06 10:09,1386758,637858,514134,234766,1386758
2023-05-06 10:10,1386771,637872,514133,234766,1386771
2023-05-06 10:11,1386783,637881,514133,234769,1386783
2023-05-06 10:12,1386796,637891,514136,234769,1386796
2023-05-06 10:13,1386808,637903,514136,234769,1386808
2023-05-06 10:14,1386821,637915,514136,234770,1386821
2023-05-06 10:15,1386835,637929,514136,234770,1386835
2023-05-06 10:16,1386847,637939,514138,234770,1386847
2023-05-06 10:17,1386859,637951,514138,234770,1386859
2023-05-06 10:18,1386872,637964,514138,234770,1386872
2023-05-06 10:19,1386885,637977,514138,234770,1386885
2023-05-06 10:20,1386898,637987,514141,234770,1386898
2023-05-06 10:21,1386911,637999,514141,234771,1386911
2023-05-06 10:22,1386924,638008,514144,234772,1386924
2023-05-06 10:23,1386936,638020,514144,234772,1386936
2023-05-06 10:24,1386949,638029,514148,234772,1386949
2023-05-06 10:25,1386961,638041,514148,234772,1386961
2023-05-06 10:26,1386974,638052,514150,234772,1386974
2023-05-06 10:27,1386987,638064,514150,234773,1386987
2023-05-06 10:28,1387000,638074,514152,234774,1387000
2023-05-06 10:29,1387012,638086,514152,234774,1387012
2023-05-06 10:30,1387025,638096,514155,234774,1387025
2023-05-06 10:31,1387037,638107,514155,234775,1387037
2023-05-06 10:32,1387050,638119,514156,234775,1387050
2023-05-06 10:33,1387064,638131,514156,234777,1387064
2023-05-06 10:34,1387077,638143,514157,234777,1387077
2023-05-06 10:35,1387090,638155,514158,234777,1387090
2023-05-06 10:36,1387102,638166,514158,234778,1387102
2023-05-06 10:37,1387116,638177,514161,234778,1387116
2023-05-06 10:38,1387130,638190,514161,234779,1387130
2023-05-06 10:39,1387144,638201,514164,234779,1387144
2023-05-06 10:40,1387156,638213,514164,234779,1387156
2023-05-06 10:41,1387168,638222,514166,234780,1387168
2023-05-06 10:42,1387182,638235,514166,234781,1387182
2023-05-06 10:43,1387194,638245,514168,234781,1387194
2023-05-06 10:44,1387207,638258,514168,234781,1387207
2023-05-06 10:45,1387220,638265,514173,234782,1387220
2023-05-06 10:46,1387233,638276,514173,234784,1387233
2023-05-06 10:47,1387245,638285,514174,234786,1387245
2023-05-06 10:48,1387258,638298,514174,234786,1387258
2023-05-06 10:49,1387270,638307,514176,234787,1387270
2023-05-06 10:50,1387283,638320,514176,234787,1387283
2023-05-06 10:52,1387296,638332,514177,234787,1387296
2023-05-06 10:53,1387308,638344,514177,234787,1387308
2023-05-06 10:54,1387320,638356,514178,234786,1387320
2023-05-06 10:55,1387333,638368,514178,234787,1387333
2023-05-06 10:56,1387346,638379,514180,234787,1387346
2023-05-06 10:57,1387358,638390,514180,234788,1387358
2023-05-06 10:58,1387372,638402,514182,234788,1387372
2023-05-06 10:59,1387384,638414,514182,234788,1387384
2023-05-06 11:00,1387400,638429,514182,234789,1387400
2023-05-06 11:01,1387432,638460,514182,234790,1387432
2023-05-06 11:02,1387466,638490,514186,234790,1387466
2023-05-06 11:03,1387501,638525,514186,234790,1387501
2023-05-06 11:04,1387535,638557,514186,234792,1387535
2023-05-06 11:05,1387567,638589,514186,234792,1387567
2023-05-06 11:06,1387605,638626,514187,234792,1387605
2023-05-06 11:07,1387637,638658,514187,234792,1387637
2023-05-06 11:08,1387672,638691,514189,234792,1387672
2023-05-06 11:09,1387705,638724,514189,234792,1387705
2023-05-06 11:10,1387740,638753,514195,234792,1387740
2023-05-06 11:11,1387775,638788,514195,234792,1387775
2023-05-06 11:12,1387809,638821,514195,234793,1387809
2023-05-06 11:13,1387842,638853,514195,234794,1387842
2023-05-06 11:14,1387875,638885,514196,234794,1387875
2023-05-06 11:15,1387911,638921,514196,234794,1387911
2023-05-06 11:16,1387943,638952,514196,234795,1387943
2023-05-06 11:17,1387979,638988,514196,234795,1387979
2023-05-06 11:18,1388013,639022,514196,234795,1388013
2023-05-06 11:19,1388046,639055,514196,234795,1388046
2023-05-06 11:20,1388081,639088,514196,234797,1388081
2023-05-06 11:21,1388114,639120,514196,234798,1388114
2023-05-06 11:22,1388148,639150,514199,234799,1388148
2023-05-06 11:23,1388185,639186,514199,234800,1388185
2023-05-06 11:24,1388220,639220,514200,234800,1388220
2023-05-06 11:25,1388255,639255,514200,234800,1388255
2023-05-06 11:26,1388290,639290,514200,234800,1388290
2023-05-06 11:27,1388326,639322,514200,234804,1388326
2023-05-06 11:28,1388360,639355,514200,234805,1388360
2023-05-06 11:29,1388398,639393,514200,234805,1388398
2023-05-06 11:30,1388432,639425,514200,234807,1388432
2023-05-06 11:31,1388466,639459,514200,234807,1388466
2023-05-06 11:32,1388502,639493,514200,234809,1388502
2023-05-06 11:33,1388535,639526,514200,234809,1388535
2023-05-06 11:34,1388568,639546,514212,234810,1388568
2023-05-06 11:35,1388603,639581,514212,234810,1388603
2023-05-06 11:36,1388637,639614,514212,234811,1388637
2023-05-06 11:37,1388671,639647,514212,234812,1388671
2023-05-06 11:39,1388704,639680,514212,234812,1388704
2023-05-06 11:40,1388739,639715,514212,234812,1388739
2023-05-06 11:41,1388773,639749,514212,234812,1388773
2023-05-06 11:42,1388807,639757,514235,234815,1388807
2023-05-06 11:43,1388844,639793,514236,234815,1388844
2023-05-06 11:44,1388876,639814,514247,234815,1388876
2023-05-06 11:45,1388911,639849,514247,234815,1388911
2023-05-06 11:46,1388945,639873,514255,234817,1388945
2023-05-06 11:47,1388980,639908,514255,234817,1388980
2023-05-06 11:48,1389016,639935,514264,234817,1389016
2023-05-06 11:49,1389049,639968,514264,234817,1389049
2023-05-06 11:50,1389085,639994,514272,234819,1389085
2023-05-06 11:51,1389119,640026,514272,234821,1389119
2023-05-06 11:52,1389153,640058,514275,234820,1389153
2023-05-06 11:53,1389188,640092,514275,234821,1389188
2023-05-06 11:54,1389220,640118,514280,234822,1389220
2023-05-06 11:55,1389255,640153,514280,234822,1389255
2023-05-06 11:56,1389290,640185,514283,234822,1389290
2023-05-06 11:57,1389327,640221,514283,234823,1389327
2023-05-06 11:58,1389363,640248,514292,234823,1389363
2023-05-06 11:59,1389395,640280,514292,234823,1389395
2023-05-06 12:00,1389424,640301,514300,234823,1389424
2023-05-06 12:01,1389448,640324,514300,234824,1389448
2023-05-06 12:02,1389470,640342,514304,234824,1389470
2023-05-06 12:03,1389492,640363,514304,234825,1389492
2023-05-06 12:04,1389516,640382,514308,234826,1389516
2023-05-06 12:05,1389540,640406,514308,234826,1389540
2023-05-06 12:06,1389563,640429,514308,234826,1389563
2023-05-06 12:07,1389587,640441,514320,234826,1389587
2023-05-06 12:08,1389610,640464,514320,234826,1389610
2023-05-06 12:09,1389635,640482,514326,234827,1389635
2023-05-06 12:10,1389656,640498,514329,234829,1389656
2023-05-06 12:11,1389679,640520,514329,234830,1389679
2023-05-06 12:12,1389702,640541,514331,234830,1389702
2023-05-06 12:13,1389725,640564,514331,234830,1389725
2023-05-06 12:14,1389747,640577,514338,234832,1389747
2023-05-06 12:15,1389769,640599,514338,234832,1389769
2023-05-06 12:16,1389792,640616,514344,234832,1389792
2023-05-06 12:17,1389815,640638,514344,234833,1389815
2023-05-06 12:18,1389838,640654,514349,234835,1389838
2023-05-06 12:19,1389860,640675,514350,234835,1389860
2023-05-06 12:20,1389883,640694,514354,234835,1389883
2023-05-06 12:21,1389905,640716,514354,234835,1389905
2023-05-06 12:22,1389926,640735,514356,234835,1389926
2023-05-06 12:23,1389951,640759,514356,234836,1389951
2023-05-06 12:24,1389974,640776,514360,234838,1389974
2023-05-06 12:26,1389995,640797,514360,234838,1389995
2023-05-06 12:27,1390018,640811,514370,234837,1390018
2023-05-06 12:28,1390042,640832,514373,234837,1390042
2023-05-06 12:29,1390064,640855,514373,234836,1390064
2023-05-06 12:30,1390086,640871,514378,234837,1390086
2023-05-06 12:31,1390110,640895,514378,234837,1390110
2023-05-06 12:32,1390132,640909,514386,234837,1390132
2023-05-06 12:33,1390155,640932,514386,234837,1390155
2023-05-06 12:34,1390177,640948,514392,234837,1390177
2023-05-06 12:35,1390201,640969,514394,234838,1390201
2023-05-06 12:36,1390223,640991,514394,234838,1390223
2023-05-06 12:37,1390246,641013,514394,234839,1390246
2023-05-06 12:38,1390268,641033,514394,234841,1390268
2023-05-06 12:39,1390290,641054,514394,234842,1390290
2023-05-06 12:40,1390314,641068,514404,234842,1390314
2023-05-06 12:41,1390337,641089,514405,234843,1390337
2023-05-06 12:42,1390359,641110,514405,234844,1390359
2023-05-06 12:43,1390381,641129,514408,234844,1390381
2023-05-06 12:44,1390404,641150,514408,234846,1390404
2023-05-06 12:45,1390426,641165,514414,234847,1390426
2023-05-06 12:46,1390448,641187,514414,234847,1390448
2023-05-06 12:47,1390470,641204,514419,234847,1390470
2023-05-06 12:48,1390492,641225,514419,234848,1390492
2023-05-06 12:49,1390514,641240,514424,234850,1390514
2023-05-06 12:50,1390537,641261,514424,234852,1390537
2023-05-06 12:51,1390559,641280,514426,234853,1390559
2023-05-06 12:52,1390582,641303,514426,234853,1390582
2023-05-06 12:53,1390606,641322,514430,234854,1390606
2023-05-06 12:54,1390628,641344,514430,234854,1390628
2023-05-06 12:55,1390650,641363,514432,234855,1390650
2023-05-06 12:56,1390672,641385,514432,234855,1390672
2023-05-06 12:57,1390695,641405,514434,234856,1390695
2023-05-06 12:58,1390718,641427,514434,234857,1390718
2023-05-06 12:59,1390741,641444,514440,234857,1390741
2023-05-06 13:00,1390753,641454,514440,234859,1390753
2023-05-06 13:01,1390759,641458,514440,234861,1390759
2023-05-06 13:02,1390765,641463,514440,234862,1390765
2023-05-06 13:03,1390771,641461,514446,234864,1390771
2023-05-06 13:04,1390778,641467,514446,234865,1390778
2023-05-06 13:05,1390785,641466,514452,234867,1390785
2023-05-06 13:06,1390791,641471,514452,234868,1390791
2023-05-06 13:07,1390799,641478,514453,234868,1390799
2023-05-06 13:08,1390805,641484,514453,234868,1390805
2023-05-06 13:09,1390812,641485,514458,234869,1390812
2023-05-06 13:10,1390818,641491,514458,234869,1390818
2023-05-06 13:11,1390825,641494,514461,234870,1390825
2023-05-06 13:12,1390831,641499,514462,234870,1390831
2023-05-06 13:14,1390839,641507,514462,234870,1390839
2023-05-06 13:15,1390845,641505,514469,234871,1390845
2023-05-06 13:16,1390851,641511,514469,234871,1390851
2023-05-06 13:17,1390857,641514,514472,234871,1390857
2023-05-06 13:18,1390866,641522,514472,234872,1390866
2023-05-06 13:19,1390872,641524,514475,234873,1390872
2023-05-06 13:20,1390879,641531,514475,234873,1390879
2023-05-06 13:21,1390886,641536,514477,234873,1390886
2023-05-06 13:22,1390892,641541,514477,234874,1390892
2023-05-06 13:23,1390899,641542,514482,234875,1390899
2023-05-06 13:24,1390906,641549,514482,234875,1390906
2023-05-06 13:25,1390912,641549,514488,234875,1390912
2023-05-06 13:26,1390918,641555,514488,234875,1390918
2023-05-06 13:27,1390924,641558,514490,234876,1390924
2023-05-06 13:28,1390931,641564,514490,234877,1390931
2023-05-06 13:29,1390937,641567,514492,234878,1390937
2023-05-06 13:30,1390944,641573,514492,234879,1390944
2023-05-06 13:31,1390951,641578,514493,234880,1390951
2023-05-06 13:32,1390957,641583,514493,234881,1390957
2023-05-06 13:33,1390963,641586,514496,234881,1390963
2023-05-06 13:34,1390970,641592,514496,234882,1390970
2023-05-06 13:35,1390976,641594,514500,234882,1390976
2023-05-06 13:36,1390983,641601,514500,234882,1390983
2023-05-06 13:37,1390988,641602,514502,234884,1390988
2023-05-06 13:38,1390995,641609,514502,234884,1390995
2023-05-06 13:39,1391001,641609,514507,234885,1391001
2023-05-06 13:40,1391009,641614,514507,234888,1391009
2023-05-06 13:41,1391016,641615,514512,234889,1391016
2023-05-06 13:42,1391022,641620,514512,234890,1391022
2023-05-06 13:43,1391029,641622,514516,234891,1391029
2023-05-06 13:44,1391035,641627,514517,234891,1391035
2023-05-06 13:45,1391041,641632,514517,234892,1391041
2023-05-06 13:46,1391047,641633,514521,234893,1391047
2023-05-06 13:47,1391054,641639,514521,234894,1391054
2023-05-06 13:48,1391060,641642,514523,234895,1391060
2023-05-06 13:49,1391067,641649,514523,234895,1391067
2023-05-06 13:50,1391074,641655,514524,234895,1391074
2023-05-06 13:51,1391081,641661,514524,234896,1391081
2023-05-06 13:52,1391088,641667,514525,234896,1391088
2023-05-06 13:53,1391094,641673,514525,234896,1391094
2023-05-06 13:54,1391102,641677,514529,234896,1391102
2023-05-06 13:55,1391108,641682,514529,234897,1391108
2023-05-06 13:56,1391114,641687,514530,234897,1391114
2023-05-06 13:57,1391121,641694,514530,234897,1391121
2023-05-06 13:58,1391128,641698,514533,234897,1391128
2023-05-06 13:59,1391134,641704,514533,234897,1391134
2023-05-06 14:01,1391152,641722,514533,234897,1391152
2023-05-06 14:02,1391173,641743,514533,234897,1391173
2023-05-06 14:03,1391194,641764,514533,234897,1391194
2023-05-06 14:04,1391213,641783,514533,234897,1391213
2023-05-06 14:05,1391233,641800,514536,234897,1391233
2023-05-06 14:06,1391252,641819,514536,234897,1391252
2023-05-06 14:07,1391272,641837,514536,234899,1391272
2023-05-06 14:08,1391293,641857,514536,234900,1391293
2023-05-06 14:09,1391313,641875,514537,234901,1391313
2023-05-06 14:10,1391332,641894,514537,234901,1391332
2023-05-06 14:11,1391352,641910,514541,234901,1391352
2023-05-06 14:12,1391373,641929,514541,234903,1391373
2023-05-06 14:13,1391393,641945,514545,234903,1391393
2023-05-06 14:14,1391412,641964,514545,234903,1391412
2023-05-06 14:15,1391433,641981,514549,234903,1391433
2023-05-06 14:16,1391452,641998,514549,234905,1391452
2023-05-06 14:17,1391472,642013,514554,234905,1391472
2023-05-06 14:19,1391493,642034,514554,234905,1391493
2023-05-06 14:20,1391524,642063,514556,234905,1391524
2023-05-06 14:21,1391544,642083,514556,234905,1391544
2023-05-06 14:22,1391563,642098,514560,234905,1391563
2023-05-06 14:23,1391583,642118,514560,234905,1391583
2023-05-06 14:24,1391602,642136,514560,234906,1391602
2023-05-06 14:25,1391622,642156,514560,234906,1391622
2023-05-06 14:26,1391642,642170,514566,234906,1391642
2023-05-06 14:27,1391661,642189,514566,234906,1391661
2023-05-06 14:28,1391681,642205,514570,234906,1391681
2023-05-06 14:29,1391700,642224,514570,234906,1391700
2023-05-06 14:30,1391719,642241,514572,234906,1391719
2023-05-06 14:31,1391739,642261,514571,234907,1391739
2023-05-06 14:32,1391758,642278,514571,234909,1391758
2023-05-06 14:33,1391780,642298,514572,234910,1391780
2023-05-06 14:34,1391801,642319,514572,234910,1391801
2023-05-06 14:35,1391820,642337,514573,234910,1391820
2023-05-06 14:36,1391840,642356,514573,234911,1391840
2023-05-06 14:37,1391859,642374,514574,234911,1391859
2023-05-06 14:38,1391878,642393,514574,234911,1391878
2023-05-06 14:39,1391899,642413,514575,234911,1391899
2023-05-06 14:40,1391919,642431,514577,234911,1391919
2023-05-06 14:41,1391938,642449,514577,234912,1391938
2023-05-06 14:42,1391959,642469,514578,234912,1391959
2023-05-06 14:43,1391979,642489,514578,234912,1391979
2023-05-06 14:44,1391997,642503,514581,234913,1391997
2023-05-06 14:45,1392017,642522,514581,234914,1392017
2023-05-06 14:46,1392036,642540,514582,234914,1392036
2023-05-06 14:47,1392056,642560,514582,234914,1392056
2023-05-06 14:48,1392076,642577,514585,234914,1392076
2023-05-06 14:49,1392098,642599,514585,234914,1392098
2023-05-06 14:50,1392116,642614,514588,234914,1392116
2023-05-06 14:51,1392137,642635,514588,234914,1392137
2023-05-06 14:52,1392158,642653,514591,234914,1392158
2023-05-06 14:53,1392179,642674,514591,234914,1392179
2023-05-06 14:54,1392198,642692,514592,234914,1392198
2023-05-06 14:55,1392219,642711,514594,234914,1392219
2023-05-06 14:56,1392239,642730,514595,234914,1392239
2023-05-06 14:57,1392257,642747,514595,234915,1392257
2023-05-06 14:58,1392278,642766,514596,234916,1392278
2023-05-06 14:59,1392296,642784,514596,234916,1392296
2023-05-06 15:00,1392321,642805,514600,234916,1392321
2023-05-06 15:01,1392346,642829,514600,234917,1392346
2023-05-06 15:03,1392370,642850,514602,234918,1392370
2023-05-06 15:04,1392394,642873,514602,234919,1392394
2023-05-06 15:05,1392418,642894,514604,234920,1392418
2023-05-06 15:06,1392442,642916,514604,234922,1392442
2023-05-06 15:07,1392468,642942,514604,234922,1392468
2023-05-06 15:08,1392491,642965,514604,234922,1392491
2023-05-06 15:09,1392516,642990,514604,234922,1392516
2023-05-06 15:10,1392539,643013,514604,234922,1392539
2023-05-06 15:11,1392563,643037,514604,234922,1392563
2023-05-06 15:12,1392586,643059,514604,234923,1392586
2023-05-06 15:13,1392609,643082,514604,234923,1392609
2023-05-06 15:14,1392633,643106,514604,234923,1392633
2023-05-06 15:15,1392659,643126,514610,234923,1392659
2023-05-06 15:16,1392682,643148,514610,234924,1392682
2023-05-06 15:17,1392705,643171,514610,234924,1392705
2023-05-06 15:18,1392730,643195,514610,234925,1392730
2023-05-06 15:19,1392754,643216,514610,234928,1392754
2023-05-06 15:20,1392778,643235,514613,234930,1392778
2023-05-06 15:21,1392802,643258,514613,234931,1392802
2023-05-06 15:22,1392826,643280,514615,234931,1392826
2023-05-06 15:23,1392850,643301,514616,234933,1392850
2023-05-06 15:24,1392873,643323,514616,234934,1392873
2023-05-06 15:25,1392897,643347,514616,234934,1392897
2023-05-06 15:26,1392920,643369,514616,234935,1392920
2023-05-06 15:27,1392945,643393,514617,234935,1392945
2023-05-06 15:28,1392968,643416,514617,234935,1392968
2023-05-06 15:29,1392992,643437,514619,234936,1392992
2023-05-06 15:30,1393016,643460,514619,234937,1393016
2023-05-06 15:31,1393040,643482,514620,234938,1393040
2023-05-06 15:32,1393063,643505,514620,234938,1393063
2023-05-06 15:33,1393086,643526,514620,234940,1393086
2023-05-06 15:34,1393111,643550,514620,234941,1393111
2023-05-06 15:35,1393134,643571,514622,234941,1393134
2023-05-06 15:36,1393157,643593,514624,234940,1393157
2023-05-06 15:37,1393182,643616,514624,234942,1393182
2023-05-06 15:38,1393205,643635,514628,234942,1393205
2023-05-06 15:39,1393229,643659,514628,234942,1393229
2023-05-06 15:40,1393252,643680,514630,234942,1393252
2023-05-06 15:42,1393277,643701,514634,234942,1393277
2023-05-06 15:43,1393323,643747,514634,234942,1393323
2023-05-06 15:44,1393347,643770,514634,234943,1393347
2023-05-06 15:45,1393372,643792,514637,234943,1393372
2023-05-06 15:46,1393395,643815,514637,234943,1393395
2023-05-06 15:48,1393421,643838,514639,234944,1393421
2023-05-06 15:49,1393443,643859,514639,234945,1393443
2023-05-06 15:50,1393468,643882,514641,234945,1393468
2023-05-06 15:51,1393493,643904,514643,234946,1393493
2023-05-06 15:52,1393515,643923,514643,234949,1393515
2023-05-06 15:53,1393540,643946,514645,234949,1393540
2023-05-06 15:54,1393562,643968,514645,234949,1393562
2023-05-06 15:55,1393585,643991,514645,234949,1393585
2023-05-06 15:56,1393609,644015,514645,234949,1393609
2023-05-06 15:57,1393632,644038,514645,234949,1393632
2023-05-06 15:58,1393656,644057,514650,234949,1393656
2023-05-06 15:59,1393681,644082,514650,234949,1393681
2023-05-06 16:00,1393704,644104,514650,234950,1393704
2023-05-06 16:01,1393720,644119,514650,234951,1393720
2023-05-06 16:02,1393736,644132,514652,234952,1393736
2023-05-06 16:03,1393752,644148,514652,234952,1393752
2023-05-06 16:04,1393769,644164,514652,234953,1393769
2023-05-06 16:05,1393786,644181,514652,234953,1393786
2023-05-06 16:06,1393803,644198,514652,234953,1393803
2023-05-06 16:07,1393819,644213,514652,234954,1393819
2023-05-06 16:08,1393836,644228,514654,234954,1393836
2023-05-06 16:09,1393852,644243,514654,234955,1393852
2023-05-06 16:10,1393868,644256,514657,234955,1393868
2023-05-06 16:11,1393884,644270,514657,234957,1393884
2023-05-06 16:12,1393900,644286,514657,234957,1393900
2023-05-06 16:13,1393916,644302,514657,234957,1393916
2023-05-06 16:14,1393932,644316,514658,234958,1393932
2023-05-06 16:15,1393948,644331,514658,234959,1393948
2023-05-06 16:16,1393963,644342,514661,234960,1393963
2023-05-06 16:17,1393980,644359,514661,234960,1393980
2023-05-06 16:18,1393996,644376,514661,234959,1393996
2023-05-06 16:19,1394012,644392,514661,234959,1394012
2023-05-06 16:20,1394027,644403,514665,234959,1394027
2023-05-06 16:21,1394044,644419,514665,234960,1394044
2023-05-06 16:22,1394060,644431,514669,234960,1394060
2023-05-06 16:23,1394076,644447,514669,234960,1394076
2023-05-06 16:24,1394093,644463,514670,234960,1394093
2023-05-06 16:25,1394109,644479,514670,234960,1394109
2023-05-06 16:26,1394125,644491,514673,234961,1394125
2023-05-06 16:27,1394141,644507,514673,234961,1394141
2023-05-06 16:28,1394156,644514,514679,234963,1394156
2023-05-06 16:29,1394171,644527,514680,234964,1394171
2023-05-06 16:30,1394189,644544,514680,234965,1394189
2023-05-06 16:31,1394204,644557,514682,234965,1394204
2023-05-06 16:32,1394220,644573,514682,234965,1394220
2023-05-06 16:33,1394236,644585,514685,234966,1394236
2023-05-06 16:34,1394251,644598,514687,234966,1394251
2023-05-06 16:36,1394267,644613,514687,234967,1394267
2023-05-06 16:37,1394283,644626,514689,234968,1394283
2023-05-06 16:38,1394298,644641,514689,234968,1394298
2023-05-06 16:39,1394314,644654,514690,234970,1394314
2023-05-06 16:40,1394331,644670,514690,234971,1394331
2023-05-06 16:41,1394348,644684,514692,234972,1394348
2023-05-06 16:42,1394364,644700,514692,234972,1394364
2023-05-06 16:43,1394380,644712,514694,234974,1394380
2023-05-06 16:44,1394396,644726,514694,234976,1394396
2023-05-06 16:45,1394413,644741,514694,234978,1394413
2023-05-06 16:46,1394429,644756,514694,234979,1394429
2023-05-06 16:47,1394445,644772,514694,234979,1394445
2023-05-06 16:48,1394463,644790,514694,234979,1394463
2023-05-06 16:49,1394479,644801,514699,234979,1394479
2023-05-06 16:50,1394494,644816,514699,234979,1394494
2023-05-06 16:51,1394512,644831,514702,234979,1394512
2023-05-06 16:52,1394528,644845,514702,234981,1394528
2023-05-06 16:53,1394545,644861,514702,234982,1394545
2023-05-06 16:54,1394561,644876,514702,234983,1394561
2023-05-06 16:55,1394578,644892,514703,234983,1394578
2023-05-06 16:56,1394594,644908,514703,234983,1394594
2023-05-06 16:57,1394609,644921,514705,234983,1394609
2023-05-06 16:58,1394624,644934,514705,234985,1394624
2023-05-06 16:59,1394640,644947,514707,234986,1394640
2023-05-06 17:00,1394655,644962,514707,234986,1394655
2023-05-06 17:01,1394667,644968,514710,234989,1394667
2023-05-06 17:02,1394680,644981,514710,234989,1394680
2023-05-06 17:03,1394694,644994,514711,234989,1394694
2023-05-06 17:04,1394707,645006,514712,234989,1394707
2023-05-06 17:05,1394719,645017,514712,234990,1394719
2023-05-06 17:06,1394732,645026,514713,234993,1394732
2023-05-06 17:07,1394745,645039,514713,234993,1394745
2023-05-06 17:08,1394757,645045,514718,234994,1394757
2023-05-06 17:09,1394771,645058,514718,234995,1394771
2023-05-06 17:10,1394785,645068,514722,234995,1394785
2023-05-06 17:11,1394798,645080,514722,234996,1394798
2023-05-06 17:12,1394811,645091,514724,234996,1394811
2023-05-06 17:13,1394824,645104,514724,234996,1394824
2023-05-06 17:14,1394838,645114,514728,234996,1394838
2023-05-06 17:15,1394851,645126,514728,234997,1394851
2023-05-06 17:16,1394863,645133,514733,234997,1394863
2023-05-06 17:17,1394876,645145,514733,234998,1394876
2023-05-06 17:18,1394889,645153,514736,235000,1394889
2023-05-06 17:19,1394902,645166,514736,235000,1394902
2023-05-06 17:20,1394915,645178,514737,235000,1394915
2023-05-06 17:21,1394927,645189,514737,235001,1394927
2023-05-06 17:23,1394941,645202,514737,235002,1394941
2023-05-06 17:24,1394955,645216,514737,235002,1394955
2023-05-06 17:25,1394969,645229,514737,235003,1394969
2023-05-06 17:26,1394984,645244,514737,235003,1394984
2023-05-06 17:27,1394997,645255,514739,235003,1394997
2023-05-06 17:28,1395009,645267,514739,235003,1395009
2023-05-06 17:29,1395023,645276,514744,235003,1395023
2023-05-06 17:30,1395037,645289,514744,235004,1395037
2023-05-06 17:31,1395051,645300,514747,235004,1395051
2023-05-06 17:32,1395064,645312,514747,235005,1395064
2023-05-06 17:33,1395077,645319,514751,235007,1395077
2023-05-06 17:34,1395090,645332,514751,235007,1395090
2023-05-06 17:35,1395103,645342,514752,235009,1395103
2023-05-06 17:36,1395115,645353,514752,235010,1395115
2023-05-06 17:37,1395129,645366,514753,235010,1395129
2023-05-06 17:38,1395142,645378,514753,235011,1395142
2023-05-06 17:39,1395156,645388,514757,235011,1395156
2023-05-06 17:40,1395169,645399,514757,235013,1395169
2023-05-06 17:41,1395182,645408,514761,235013,1395182
2023-05-06 17:42,1395196,645422,514761,235013,1395196
2023-05-06 17:43,1395208,645429,514764,235015,1395208
2023-05-06 17:44,1395222,645441,514765,235016,1395222
2023-05-06 17:45,1395234,645450,514765,235019,1395234
2023-05-06 17:46,1395248,645461,514767,235020,1395248
2023-05-06 17:47,1395261,645474,514767,235020,1395261
2023-05-06 17:48,1395274,645479,514774,235021,1395274
2023-05-06 17:49,1395286,645491,514774,235021,1395286
2023-05-06 17:50,1395302,645508,514772,235022,1395302
2023-05-06 17:51,1395315,645520,514772,235023,1395315
2023-05-06 17:52,1395327,645529,514774,235024,1395327
2023-05-06 17:53,1395342,645543,514774,235025,1395342
2023-05-06 17:54,1395354,645548,514780,235026,1395354
2023-05-06 17:55,1395369,645564,514780,235025,1395369
2023-05-06 17:56,1395382,645575,514782,235025,1395382
2023-05-06 17:57,1395395,645588,514782,235025,1395395
2023-05-06 17:58,1395408,645595,514786,235027,1395408
2023-05-06 17:59,1395422,645608,514786,235028,1395422
2023-05-06 18:00,1395445,645628,514787,235030,1395445
2023-05-06 18:01,1395475,645656,514789,235030,1395475
2023-05-06 18:02,1395503,645682,514791,235030,1395503
2023-05-06 18:03,1395529,645708,514791,235030,1395529
2023-05-06 18:04,1395558,645732,514795,235031,1395558
2023-05-06 18:05,1395584,645752,514797,235035,1395584
2023-05-06 18:06,1395613,645781,514797,235035,1395613
2023-05-06 18:07,1395640,645804,514801,235035,1395640
2023-05-06 18:08,1395668,645831,514801,235036,1395668
2023-05-06 18:09,1395696,645859,514801,235036,1395696
2023-05-06 18:11,1395724,645887,514801,235036,1395724
2023-05-06 18:12,1395752,645908,514806,235038,1395752
2023-05-06 18:13,1395779,645934,514806,235039,1395779
2023-05-06 18:14,1395809,645962,514808,235039,1395809
2023-05-06 18:15,1395835,645988,514808,235039,1395835
2023-05-06 18:16,1395863,646017,514807,235039,1395863
2023-05-06 18:17,1395891,646044,514807,235040,1395891
2023-05-06 18:18,1395919,646064,514814,235041,1395919
2023-05-06 18:19,1395948,646090,514814,235044,1395948
2023-05-06 18:20,1395976,646111,514818,235047,1395976
2023-05-06 18:21,1396006,646140,514818,235048,1396006
2023-05-06 18:22,1396034,646164,514820,235050,1396034
2023-05-06 18:23,1396062,646187,514823,235052,1396062
2023-05-06 18:24,1396090,646212,514823,235055,1396090
2023-05-06 18:25,1396115,646235,514825,235055,1396115
2023-05-06 18:26,1396145,646265,514825,235055,1396145
2023-05-06 18:27,1396173,646291,514826,235056,1396173
2023-05-06 18:28,1396200,646317,514826,235057,1396200
2023-05-06 18:29,1396227,646342,514827,235058,1396227
2023-05-06 18:30,1396255,646368,514829,235058,1396255
2023-05-06 18:31,1396284,646393,514833,235058,1396284
2023-05-06 18:32,1396311,646419,514833,235059,1396311
2023-05-06 18:33,1396338,646434,514841,235063,1396338
2023-05-06 18:34,1396368,646463,514841,235064,1396368
2023-05-06 18:35,1396396,646483,514849,235064,1396396
2023-05-06 18:36,1396423,646505,514854,235064,1396423
2023-05-06 18:37,1396452,646533,514854,235065,1396452
2023-05-06 18:38,1396478,646550,514862,235066,1396478
2023-05-06 18:39,1396508,646579,514862,235067,1396508
2023-05-06 18:40,1396535,646602,514865,235068,1396535
2023-05-06 18:41,1396565,646632,514865,235068,1396565
2023-05-06 18:42,1396593,646655,514869,235069,1396593
2023-05-06 18:43,1396621,646683,514869,235069,1396621
2023-05-06 18:44,1396650,646702,514879,235069,1396650
2023-05-06 18:45,1396678,646722,514886,235070,1396678
2023-05-06 18:46,1396709,646752,514886,235071,1396709
2023-05-06 18:47,1396736,646772,514892,235072,1396736
2023-05-06 18:48,1396763,646796,514892,235075,1396763
2023-05-06 18:49,1396792,646818,514898,235076,1396792
2023-05-06 18:50,1396819,646841,514901,235077,1396819
2023-05-06 18:51,1396846,646868,514901,235077,1396846
2023-05-06 18:52,1396873,646888,514906,235079,1396873
2023-05-06 18:53,1396901,646912,514909,235080,1396901
2023-05-06 18:54,1396929,646940,514909,235080,1396929
2023-05-06 18:55,1396957,646967,514910,235080,1396957
2023-05-06 18:56,1396985,646995,514910,235080,1396985
2023-05-06 18:58,1397011,647012,514917,235082,1397011
2023-05-06 18:59,1397040,647040,514917,235083,1397040
2023-05-06 19:00,1397070,647070,514917,235083,1397070
2023-05-06 19:01,1397103,647101,514917,235085,1397103
2023-05-06 19:02,1397137,647131,514921,235085,1397137
2023-05-06 19:03,1397170,647162,514921,235087,1397170
2023-05-06 19:04,1397203,647185,514931,235087,1397203
2023-05-06 19:05,1397235,647216,514931,235088,1397235
2023-05-06 19:06,1397268,647239,514937,235092,1397268
2023-05-06 19:07,1397301,647272,514937,235092,1397301
2023-05-06 19:08,1397335,647298,514943,235094,1397335
2023-05-06 19:09,1397369,647331,514943,235095,1397369
2023-05-06 19:10,1397404,647363,514945,235096,1397404
2023-05-06 19:11,1397435,647392,514945,235098,1397435
2023-05-06 19:12,1397468,647418,514950,235100,1397468
2023-05-06 19:13,1397502,647451,514950,235101,1397502
2023-05-06 19:14,1397533,647476,514955,235102,1397533
2023-05-06 19:15,1397568,647510,514955,235103,1397568
2023-05-06 19:16,1397603,647544,514957,235102,1397603
2023-05-06 19:17,1397634,647572,514957,235105,1397634
2023-05-06 19:18,1397667,647602,514960,235105,1397667
2023-05-06 19:19,1397701,647631,514964,235106,1397701
2023-05-06 19:20,1397734,647663,514964,235107,1397734
2023-05-06 19:21,1397766,647692,514966,235108,1397766
2023-05-06 19:22,1397801,647727,514966,235108,1397801
2023-05-06 19:23,1397832,647756,514968,235108,1397832
2023-05-06 19:24,1397865,647789,514968,235108,1397865
2023-05-06 19:25,1397900,647819,514973,235108,1397900
2023-05-06 19:26,1397930,647848,514973,235109,1397930
2023-05-06 19:27,1397964,647880,514975,235109,1397964
2023-05-06 19:28,1397999,647914,514975,235110,1397999
2023-05-06 19:29,1398032,647946,514976,235110,1398032
2023-05-06 19:30,1398065,647975,514980,235110,1398065
2023-05-06 19:31,1398099,648008,514980,235111,1398099
2023-05-06 19:32,1398132,648037,514983,235112,1398132
2023-05-06 19:33,1398165,648069,514983,235113,1398165
2023-05-06 19:34,1398199,648101,514983,235115,1398199
2023-05-06 19:35,1398231,648129,514986,235116,1398231
2023-05-06 19:36,1398262,648158,514986,235118,1398262
2023-05-06 19:37,1398295,648188,514988,235119,1398295
2023-05-06 19:38,1398330,648219,514992,235119,1398330
2023-05-06 19:39,1398362,648251,514992,235119,1398362
2023-05-06 19:40,1398395,648282,514994,235119,1398395
2023-05-06 19:41,1398430,648317,514994,235119,1398430
2023-05-06 19:42,1398463,648343,514998,235122,1398463
2023-05-06 19:43,1398495,648374,514999,235122,1398495
2023-05-06 19:45,1398529,648407,514999,235123,1398529
2023-05-06 19:46,1398563,648438,515002,235123,1398563
2023-05-06 19:47,1398595,648470,515002,235123,1398595
2023-05-06 19:48,1398627,648495,515008,235124,1398627
2023-05-06 19:49,1398660,648527,515008,235125,1398660
2023-05-06 19:50,1398696,648556,515015,235125,1398696
2023-05-06 19:51,1398731,648590,515015,235126,1398731
2023-05-06 19:52,1398765,648614,515024,235127,1398765
2023-05-06 19:53,1398796,648644,515024,235128,1398796
2023-05-06 19:54,1398829,648675,515026,235128,1398829
2023-05-06 19:55,1398862,648708,515026,235128,1398862
2023-05-06 19:56,1398894,648737,515029,235128,1398894
2023-05-06 19:57,1398929,648771,515029,235129,1398929
2023-05-06 19:58,1398961,648800,515032,235129,1398961
2023-05-06 19:59,1398995,648833,515033,235129,1398995
2023-05-06 20:00,1399027,648864,515033,235130,1399027
2023-05-06 20:01,1399055,648890,515034,235131,1399055
2023-05-06 20:02,1399081,648916,515034,235131,1399081
2023-05-06 20:03,1399108,648937,515040,235131,1399108
2023-05-06 20:04,1399134,648961,515040,235133,1399134
2023-05-06 20:05,1399162,648982,515046,235134,1399162
2023-05-06 20:06,1399188,649007,515046,235135,1399188
2023-05-06 20:07,1399214,649029,515048,235137,1399214
2023-05-06 20:08,1399241,649055,515048,235138,1399241
2023-05-06 20:09,1399268,649075,515052,235141,1399268
2023-05-06 20:10,1399296,649103,515052,235141,1399296
2023-05-06 20:11,1399321,649127,515053,235141,1399321
2023-05-06 20:12,1399347,649153,515053,235141,1399347
2023-05-06 20:13,1399375,649178,515056,235141,1399375
2023-05-06 20:14,1399401,649204,515056,235141,1399401
2023-05-06 20:15,1399426,649228,515057,235141,1399426
2023-05-06 20:16,1399453,649251,515061,235141,1399453
2023-05-06 20:17,1399480,649278,515061,235141,1399480
2023-05-06 20:18,1399507,649302,515063,235142,1399507
2023-05-06 20:19,1399534,649328,515063,235143,1399534
2023-05-06 20:20,1399561,649349,515069,235143,1399561
2023-05-06 20:21,1399587,649370,515073,235144,1399587
2023-05-06 20:22,1399615,649393,515077,235145,1399615
2023-05-06 20:23,1399640,649416,515077,235147,1399640
2023-05-06 20:24,1399666,649439,515078,235149,1399666
2023-05-06 20:25,1399692,649465,515078,235149,1399692
2023-05-06 20:26,1399719,649487,515082,235150,1399719
2023-05-06 20:27,1399746,649514,515082,235150,1399746
2023-05-06 20:28,1399773,649537,515086,235150,1399773
2023-05-06 20:29,1399799,649562,515086,235151,1399799
2023-05-06 20:30,1399827,649586,515087,235154,1399827
2023-05-06 20:31,1399853,649612,515087,235154,1399853
2023-05-06 20:33,1399880,649638,515088,235154,1399880
2023-05-06 20:34,1399906,649663,515088,235155,1399906
2023-05-06 20:35,1399932,649684,515092,235156,1399932
2023-05-06 20:36,1399957,649705,515092,235160,1399957
2023-05-06 20:37,1399986,649734,515092,235160,1399986
2023-05-06 20:38,1400013,649761,515092,235160,1400013
2023-05-06 20:39,1400040,649784,515095,235161,1400040
2023-05-06 20:40,1400066,649805,515099,235162,1400066
2023-05-06 20:41,1400094,649830,515101,235163,1400094
2023-05-06 20:42,1400121,649857,515101,235163,1400121
2023-05-06 20:43,1400147,649879,515100,235168,1400147
2023-05-06 20:44,1400173,649904,515100,235169,1400173
2023-05-06 20:45,1400201,649927,515104,235170,1400201
2023-05-06 20:46,1400228,649953,515104,235171,1400228
2023-05-06 20:47,1400255,649973,515111,235171,1400255
2023-05-06 20:48,1400283,649999,515113,235171,1400283
2023-05-06 20:49,1400309,650024,515113,235172,1400309
2023-05-06 20:50,1400335,650043,515119,235173,1400335
2023-05-06 20:51,1400361,650068,515119,235174,1400361
2023-05-06 20:52,1400387,650091,515120,235176,1400387
2023-05-06 20:53,1400415,650118,515121,235176,1400415
2023-05-06 20:54,1400442,650145,515121,235176,1400442
2023-05-06 20:55,1400468,650166,515126,235176,1400468
2023-05-06 20:56,1400496,650192,515126,235178,1400496
2023-05-06 20:57,1400522,650215,515127,235180,1400522
2023-05-06 20:58,1400548,650232,515135,235181,1400548
2023-05-06 20:59,1400574,650254,515138,235182,1400574
2023-05-06 21:00,1400604,650284,515138,235182,1400604
2023-05-06 21:01,1400639,650314,515141,235184,1400639
2023-05-06 21:02,1400674,650348,515141,235185,1400674
2023-05-06 21:03,1400707,650373,515149,235185,1400707
2023-05-06 21:04,1400741,650407,515149,235185,1400741
2023-05-06 21:05,1400774,650436,515153,235185,1400774
2023-05-06 21:06,1400809,650470,515153,235186,1400809
2023-05-06 21:07,1400842,650496,515158,235188,1400842
2023-05-06 21:08,1400877,650530,515158,235189,1400877
2023-05-06 21:09,1400911,650559,515162,235190,1400911
2023-05-06 21:10,1400943,650590,515162,235191,1400943
2023-05-06 21:11,1400978,650615,515172,235191,1400978
2023-05-06 21:12,1401013,650648,515172,235193,1401013
2023-05-06 21:13,1401046,650677,515174,235195,1401046
2023-05-06 21:14,1401082,650713,515174,235195,1401082
2023-05-06 21:15,1401116,650744,515176,235196,1401116
2023-05-06 21:16,1401150,650777,515176,235197,1401150
2023-05-06 21:17,1401183,650805,515180,235198,1401183
2023-05-06 21:18,1401216,650837,515180,235199,1401216
2023-05-06 21:20,1401249,650865,515184,235200,1401249
2023-05-06 21:21,1401283,650898,515184,235201,1401283
2023-05-06 21:22,1401319,650933,515185,235201,1401319
2023-05-06 21:23,1401352,650966,515185,235201,1401352
2023-05-06 21:24,1401386,650998,515187,235201,1401386
2023-05-06 21:25,1401418,651026,515188,235204,1401418
2023-05-06 21:26,1401453,651061,515188,235204,1401453
2023-05-06 21:27,1401488,651091,515192,235205,1401488
2023-05-06 21:28,1401522,651125,515192,235205,1401522
2023-05-06 21:29,1401556,651156,515194,235206,1401556
2023-05-06 21:30,1401589,651188,515194,235207,1401589
2023-05-06 21:31,1401624,651215,515202,235207,1401624
2023-05-06 21:32,1401657,651248,515202,235207,1401657
2023-05-06 21:33,1401689,651278,515203,235208,1401689
2023-05-06 21:34,1401724,651310,515206,235208,1401724
2023-05-06 21:35,1401757,651339,515206,235212,1401757
2023-05-06 21:36,1401793,651369,515210,235214,1401793
2023-05-06 21:37,1401825,651400,515210,235215,1401825
2023-05-06 21:38,1401860,651429,515216,235215,1401860
2023-05-06 21:39,1401892,651460,515216,235216,1401892
2023-05-06 21:40,1401929,651487,515225,235217,1401929
2023-05-06 21:41,1401960,651518,515225,235217,1401960
2023-05-06 21:42,1401996,651550,515227,235219,1401996
2023-05-06 21:43,1402028,651578,515231,235219,1402028
2023-05-06 21:44,1402064,651613,515231,235220,1402064
2023-05-06 21:45,1402098,651644,515234,235220,1402098
2023-05-06 21:46,1402132,651677,515234,235221,1402132
2023-05-06 21:47,1402165,651705,515239,235221,1402165
2023-05-06 21:48,1402199,651738,515240,235221,1402199
2023-05-06 21:49,1402233,651771,515240,235222,1402233
2023-05-06 21:50,1402269,651803,515243,235223,1402269
2023-05-06 21:51,1402305,651837,515243,235225,1402305
2023-05-06 21:52,1402339,651863,515251,235225,1402339
2023-05-06 21:53,1402373,651896,515251,235226,1402373
2023-05-06 21:54,1402407,651925,515254,235228,1402407
2023-05-06 21:55,1402440,651955,515254,235231,1402440
2023-05-06 21:56,1402475,651985,515258,235232,1402475
2023-05-06 21:57,1402507,652014,515258,235235,1402507
2023-05-06 21:58,1402541,652034,515269,235238,1402541
2023-05-06 21:59,1402576,652068,515269,235239,1402576
2023-05-06 22:00,1402604,652092,515272,235240,1402604
2023-05-06 22:01,1402632,652119,515272,235241,1402632
2023-05-06 22:02,1402659,652142,515275,235242,1402659
2023-05-06 22:03,1402686,652168,515275,235243,1402686
2023-05-06 22:04,1402714,652194,515276,235244,1402714
2023-05-06 22:05,1402741,652221,515276,235244,1402741
2023-05-06 22:07,1402768,652246,515276,235246,1402768
2023-05-06 22:08,1402795,652265,515283,235247,1402795
2023-05-06 22:09,1402824,652294,515283,235247,1402824
2023-05-06 22:10,1402850,652312,515290,235248,1402850
2023-05-06 22:11,1402877,652337,515290,235250,1402877
2023-05-06 22:12,1402905,652358,515296,235251,1402905
2023-05-06 22:13,1402932,652383,515296,235253,1402932
2023-05-06 22:14,1402960,652404,515302,235254,1402960
2023-05-06 22:15,1402985,652429,515302,235254,1402985
2023-05-06 22:16,1403012,652452,515304,235256,1403012
2023-05-06 22:17,1403040,652480,515304,235256,1403040
2023-05-06 22:18,1403068,652502,515309,235257,1403068
2023-05-06 22:19,1403096,652530,515309,235257,1403096
2023-05-06 22:20,1403122,652551,515313,235258,1403122
2023-05-06 22:21,1403150,652579,515313,235258,1403150
2023-05-06 22:22,1403175,652601,515313,235261,1403175
2023-05-06 22:23,1403203,652628,515313,235262,1403203
2023-05-06 22:24,1403230,652649,515317,235264,1403230
2023-05-06 22:25,1403258,652675,515319,235264,1403258
2023-05-06 22:26,1403285,652699,515319,235267,1403285
2023-05-06 22:27,1403312,652722,515322,235268,1403312
2023-05-06 22:28,1403338,652746,515322,235270,1403338
2023-05-06 22:29,1403366,652769,515325,235272,1403366
2023-05-06 22:30,1403393,652795,515326,235272,1403393
2023-05-06 22:31,1403421,652821,515326,235274,1403421
2023-05-06 22:32,1403448,652842,515329,235277,1403448
2023-05-06 22:33,1403474,652868,515329,235277,1403474
2023-05-06 22:34,1403503,652895,515330,235278,1403503
2023-05-06 22:35,1403531,652921,515330,235280,1403531
2023-05-06 22:36,1403557,652939,515338,235280,1403557
2023-05-06 22:37,1403584,652965,515338,235281,1403584
2023-05-06 22:38,1403613,652994,515338,235281,1403613
2023-05-06 22:39,1403639,653019,515338,235282,1403639
2023-05-06 22:40,1403666,653038,515344,235284,1403666
2023-05-06 22:41,1403696,653067,515344,235285,1403696
2023-05-06 22:42,1403722,653089,515348,235285,1403722
2023-05-06 22:43,1403751,653116,515348,235287,1403751
2023-05-06 22:44,1403777,653132,515355,235290,1403777
2023-05-06 22:45,1403804,653157,515355,235292,1403804
2023-05-06 22:46,1403831,653176,515360,235295,1403831
2023-05-06 22:47,1403860,653204,515360,235296,1403860
2023-05-06 22:48,1403887,653223,515364,235300,1403887
2023-05-06 22:49,1403915,653245,515370,235300,1403915
2023-05-06 22:50,1403942,653271,515370,235301,1403942
2023-05-06 22:51,1403970,653295,515373,235302,1403970
2023-05-06 22:53,1403997,653319,515373,235305,1403997
2023-05-06 22:54,1404024,653342,515377,235305,1404024
2023-05-06 22:55,1404053,653371,515377,235305,1404053
2023-05-06 22:56,1404081,653397,515378,235306,1404081
2023-05-06 22:57,1404108,653420,515381,235307,1404108
2023-05-06 22:58,1404134,653443,515384,235307,1404134
2023-05-06 22:59,1404161,653465,515384,235312,1404161
2023-05-06 23:00,1404189,653487,515387,235315,1404189
2023-05-06 23:01,1404210,653507,515387,235316,1404210
2023-05-06 23:02,1404230,653522,515392,235316,1404230
2023-05-06 23:03,1404251,653539,515394,235318,1404251
2023-05-06 23:04,1404271,653558,515394,235319,1404271
2023-05-06 23:05,1404292,653573,515399,235320,1404292
2023-05-06 23:06,1404313,653594,515399,235320,1404313
2023-05-06 23:07,1404333,653611,515402,235320,1404333
2023-05-06 23:08,1404353,653630,515402,235321,1404353
2023-05-06 23:09,1404375,653645,515408,235322,1404375
2023-05-06 23:10,1404396,653661,515411,235324,1404396
2023-05-06 23:11,1404416,653679,515411,235326,1404416
2023-05-06 23:12,1404438,653698,515413,235327,1404438
2023-05-06 23:13,1404457,653717,515413,235327,1404457
2023-05-06 23:14,1404479,653733,515418,235328,1404479
2023-05-06 23:15,1404498,653752,515418,235328,1404498
2023-05-06 23:16,1404519,653772,515419,235328,1404519
2023-05-06 23:17,1404540,653791,515419,235330,1404540
2023-05-06 23:18,1404560,653804,515425,235331,1404560
2023-05-06 23:19,1404580,653824,515425,235331,1404580
2023-05-06 23:20,1404600,653836,515433,235331,1404600
2023-05-06 23:21,1404620,653856,515433,235331,1404620
2023-05-06 23:22,1404642,653875,515436,235331,1404642
2023-05-06 23:23,1404661,653894,515436,235331,1404661
2023-05-06 23:24,1404682,653911,515439,235332,1404682
2023-05-06 23:25,1404704,653930,515441,235333,1404704
2023-05-06 23:26,1404724,653948,515441,235335,1404724
2023-05-06 23:27,1404745,653966,515443,235336,1404745
2023-05-06 23:28,1404765,653986,515443,235336,1404765
2023-05-06 23:29,1404785,654001,515448,235336,1404785
2023-05-06 23:30,1404807,654023,515448,235336,1404807
2023-05-06 23:31,1404827,654042,515448,235337,1404827
2023-05-06 23:32,1404847,654061,515448,235338,1404847
2023-05-06 23:33,1404866,654070,515458,235338,1404866
2023-05-06 23:34,1404888,654092,515458,235338,1404888
2023-05-06 23:35,1404908,654102,515467,235339,1404908
2023-05-06 23:36,1404929,654121,515467,235341,1404929
2023-05-06 23:37,1404949,654135,515472,235342,1404949
2023-05-06 23:38,1404969,654155,515472,235342,1404969
2023-05-06 23:39,1404989,654171,515476,235342,1404989
2023-05-06 23:41,1405009,654191,515476,235342,1405009
2023-05-06 23:42,1405030,654210,515477,235343,1405030
2023-05-06 23:43,1405050,654231,515477,235342,1405050
2023-05-06 23:44,1405072,654250,515480,235342,1405072
2023-05-06 23:45,1405092,654266,515483,235343,1405092
2023-05-06 23:46,1405113,654285,515483,235345,1405113
2023-05-06 23:47,1405133,654297,515490,235346,1405133
2023-05-06 23:48,1405153,654314,515490,235349,1405153
2023-05-06 23:49,1405174,654326,515497,235351,1405174
2023-05-06 23:50,1405194,654345,515497,235352,1405194
2023-05-06 23:51,1405213,654363,515498,235352,1405213
2023-05-06 23:52,1405234,654382,515498,235354,1405234
2023-05-06 23:53,1405255,654399,515501,235355,1405255
2023-05-06 23:54,1405276,654418,515501,235357,1405276
2023-05-06 23:55,1405295,654429,515507,235359,1405295
2023-05-06 23:56,1405319,654452,515507,235360,1405319
2023-05-06 23:57,1405339,654470,515507,235362,1405339
2023-05-06 23:58,1405360,654488,515507,235365,1405360
2023-05-06 23:59,1405381,654505,515509,235367,1405381
2023-05-07 00:00,1405412,654534,515509,235369,1405412
2023-05-07 00:01,1405451,654571,515511,235369,1405451
2023-05-07 00:02,1405488,654607,515511,235370,1405488
2023-05-07 00:03,1405529,654640,515518,235371,1405529
2023-05-07 00:04,1405566,654676,515518,235372,1405566
2023-05-07 00:05,1405605,654708,515525,235372,1405605
2023-05-07 00:06,1405645,654746,515525,235374,1405645
2023-05-07 00:07,1405683,654780,515528,235375,1405683
2023-05-07 00:08,1405722,654819,515528,235375,1405722
2023-05-07 00:09,1405760,654852,515532,235376,1405760
2023-05-07 00:10,1405798,654890,515532,235376,1405798
2023-05-07 00:11,1405836,654925,515535,235376,1405836
2023-05-07 00:12,1405874,654963,515535,235376,1405874
2023-05-07 00:13,1405915,655002,515535,235378,1405915
2023-05-07 00:14,1405953,655039,515535,235379,1405953
2023-05-07 00:15,1405992,655076,515535,235381,1405992
2023-05-07 00:16,1406031,655113,515535,235383,1406031
2023-05-07 00:17,1406069,655149,515535,235385,1406069
2023-05-07 00:18,1406107,655177,515545,235385,1406107
2023-05-07 00:19,1406146,655216,515545,235385,1406146
2023-05-07 00:20,1406186,655252,515548,235386,1406186
2023-05-07 00:21,1406222,655287,515548,235387,1406222
2023-05-07 00:22,1406262,655323,515550,235389,1406262
2023-05-07 00:23,1406300,655360,515550,235390,1406300
2023-05-07 00:24,1406338,655394,515553,235391,1406338
2023-05-07 00:25,1406377,655432,515554,235391,1406377
2023-05-07 00:27,1406416,655470,515554,235392,1406416
2023-05-07 00:28,1406456,655504,515559,235393,1406456
2023-05-07 00:29,1406493,655540,515559,235394,1406493
2023-05-07 00:30,1406533,655577,515561,235395,1406533
2023-05-07 00:31,1406571,655613,515561,235397,1406571
2023-05-07 00:32,1406610,655645,515566,235399,1406610
2023-05-07 00:33,1406648,655683,515566,235399,1406648
2023-05-07 00:34,1406686,655716,515569,235401,1406686
2023-05-07 00:35,1406725,655755,515569,235401,1406725
2023-05-07 00:36,1406765,655788,515575,235402,1406765
2023-05-07 00:37,1406803,655824,515575,235404,1406803
2023-05-07 00:38,1406841,655856,515578,235407,1406841
2023-05-07 00:39,1406879,655895,515578,235406,1406879
2023-05-07 00:40,1406920,655928,515582,235410,1406920
2023-05-07 00:41,1406957,655965,515582,235410,1406957
2023-05-07 00:42,1406995,656000,515584,235411,1406995
2023-05-07 00:43,1407034,656037,515584,235413,1407034
2023-05-07 00:44,1407072,656071,515586,235415,1407072
2023-05-07 00:45,1407112,656108,515586,235418,1407112
2023-05-07 00:46,1407149,656142,515588,235419,1407149
2023-05-07 00:47,1407187,656179,515588,235420,1407187
2023-05-07 00:48,1407229,656216,515592,235421,1407229
2023-05-07 00:49,1407267,656254,515592,235421,1407267
2023-05-07 00:50,1407304,656289,515592,235423,1407304
2023-05-07 00:51,1407341,656326,515592,235423,1407341
2023-05-07 00:52,1407380,656360,515597,235423,1407380
2023-05-07 00:53,1407419,656399,515597,235423,1407419
2023-05-07 00:54,1407457,656432,515602,235423,1407457
2023-05-07 00:55,1407497,656471,515602,235424,1407497
2023-05-07 00:56,1407534,656504,515606,235424,1407534
2023-05-07 00:57,1407572,656542,515606,235424,1407572
2023-05-07 00:58,1407612,656580,515607,235425,1407612
2023-05-07 00:59,1407651,656618,515607,235426,1407651
2023-05-07 01:00,1407682,656644,515612,235426,1407682
2023-05-07 01:01,1407707,656669,515612,235426,1407707
2023-05-07 01:02,1407734,656692,515614,235428,1407734
2023-05-07 01:03,1407761,656719,515614,235428,1407761
2023-05-07 01:04,1407788,656744,515615,235429,1407788
2023-05-07 01:05,1407816,656772,515615,235429,1407816
2023-05-07 01:06,1407843,656795,515619,235429,1407843
2023-05-07 01:07,1407870,656820,515619,235431,1407870
2023-05-07 01:08,1407897,656842,515621,235434,1407897
2023-05-07 01:09,1407924,656870,515621,235433,1407924
2023-05-07 01:10,1407950,656891,515626,235433,1407950
2023-05-07 01:11,1407977,656917,515626,235434,1407977
2023-05-07 01:12,1408004,656942,515628,235434,1408004
2023-05-07 01:13,1408030,656968,515628,235434,1408030
2023-05-07 01:15,1408058,656993,515631,235434,1408058
2023-05-07 01:16,1408085,657019,515631,235435,1408085
2023-05-07 01:17,1408110,657042,515633,235435,1408110
2023-05-07 01:18,1408137,657069,515633,235435,1408137
2023-05-07 01:19,1408164,657093,515636,235435,1408164
2023-05-07 01:20,1408190,657119,515636,235435,1408190
2023-05-07 01:21,1408215,657142,515638,235435,1408215
2023-05-07 01:22,1408243,657169,515639,235435,1408243
2023-05-07 01:23,1408269,657193,515639,235437,1408269
2023-05-07 01:24,1408296,657216,515643,235437,1408296
2023-05-07 01:25,1408323,657242,515643,235438,1408323
2023-05-07 01:26,1408350,657265,515644,235441,1408350
2023-05-07 01:27,1408377,657292,515644,235441,1408377
2023-05-07 01:28,1408406,657317,515648,235441,1408406
2023-05-07 01:29,1408431,657342,515648,235441,1408431
2023-05-07 01:30,1408459,657368,515650,235441,1408459
2023-05-07 01:31,1408485,657393,515650,235442,1408485
2023-05-07 01:32,1408510,657417,515651,235442,1408510
2023-05-07 01:33,1408537,657442,515651,235444,1408537
2023-05-07 01:34,1408564,657467,515652,235445,1408564
2023-05-07 01:35,1408592,657495,515652,235445,1408592
2023-05-07 01:36,1408616,657516,515653,235447,1408616
2023-05-07 01:37,1408644,657544,515653,235447,1408644
2023-05-07 01:38,1408670,657569,515654,235447,1408670
2023-05-07 01:39,1408696,657594,515654,235448,1408696
2023-05-07 01:40,1408725,657620,515657,235448,1408725
2023-05-07 01:41,1408749,657644,515657,235448,1408749
2023-05-07 01:42,1408776,657670,515658,235448,1408776
2023-05-07 01:43,1408804,657696,515658,235450,1408804
2023-05-07 01:44,1408832,657724,515658,235450,1408832
2023-05-07 01:45,1408858,657750,515658,235450,1408858
2023-05-07 01:46,1408885,657775,515659,235451,1408885
2023-05-07 01:47,1408911,657797,515659,235455,1408911
2023-05-07 01:48,1408938,657822,515661,235455,1408938
2023-05-07 01:49,1408963,657847,515661,235455,1408963
2023-05-07 01:50,1408990,657871,515664,235455,1408990
2023-05-07 01:51,1409015,657896,515664,235455,1409015
2023-05-07 01:52,1409041,657921,515664,235456,1409041
2023-05-07 01:53,1409068,657946,515665,235457,1409068
2023-05-07 01:54,1409094,657970,515665,235459,1409094
2023-05-07 01:55,1409121,657996,515666,235459,1409121
2023-05-07 01:56,1409147,658021,515666,235460,1409147
2023-05-07 01:57,1409174,658048,515666,235460,1409174
2023-05-07 01:58,1409201,658075,515666,235460,1409201
2023-05-07 01:59,1409227,658102,515665,235460,1409227
2023-05-07 02:00,1409257,658132,515665,235460,1409257
2023-05-07 02:01,1409286,658160,515666,235460,1409286
2023-05-07 02:03,1409317,658191,515666,235460,1409317
2023-05-07 02:04,1409345,658217,515668,235460,1409345
2023-05-07 02:05,1409376,658247,515668,235461,1409376
2023-05-07 02:06,1409405,658274,515669,235462,1409405
2023-05-07 02:07,1409435,658304,515669,235462,1409435
2023-05-07 02:08,1409464,658329,515671,235464,1409464
2023-05-07 02:09,1409495,658360,515671,235464,1409495
2023-05-07 02:10,1409524,658389,515671,235464,1409524
2023-05-07 02:11,1409553,658418,515671,235464,1409553
2023-05-07 02:12,1409585,658450,515671,235464,1409585
2023-05-07 02:13,1409613,658478,515671,235464,1409613
2023-05-07 02:14,1409642,658501,515676,235465,1409642
2023-05-07 02:15,1409672,658530,515677,235465,1409672
2023-05-07 02:16,1409702,658559,515677,235466,1409702
2023-05-07 02:17,1409731,658584,515681,235466,1409731
2023-05-07 02:18,1409760,658612,515681,235467,1409760
2023-05-07 02:19,1409791,658642,515682,235467,1409791
2023-05-07 02:20,1409818,658669,515682,235467,1409818
2023-05-07 02:21,1409850,658699,515684,235467,1409850
2023-05-07 02:22,1409879,658728,515684,235467,1409879
2023-05-07 02:23,1409908,658753,515688,235467,1409908
2023-05-07 02:24,1409938,658783,515688,235467,1409938
2023-05-07 02:25,1409967,658812,515688,235467,1409967
2023-05-07 02:26,1409996,658838,515690,235468,1409996
2023-05-07 02:27,1410025,658865,515690,235470,1410025
2023-05-07 02:28,1410054,658893,515690,235471,1410054
2023-05-07 02:29,1410085,658924,515690,235471,1410085
2023-05-07 02:30,1410114,658953,515690,235471,1410114
2023-05-07 02:31,1410144,658983,515690,235471,1410144
2023-05-07 02:32,1410172,659010,515690,235472,1410172
2023-05-07 02:33,1410202,659038,515690,235474,1410202
2023-05-07 02:34,1410231,659066,515690,235475,1410231
2023-05-07 02:35,1410261,659095,515690,235476,1410261
2023-05-07 02:36,1410291,659114,515700,235477,1410291
2023-05-07 02:37,1410320,659143,515700,235477,1410320
2023-05-07 02:38,1410350,659173,515700,235477,1410350
2023-05-07 02:39,1410380,659202,515700,235478,1410380
2023-05-07 02:40,1410411,659233,515700,235478,1410411
2023-05-07 02:41,1410441,659263,515700,235478,1410441
2023-05-07 02:42,1410469,659289,515700,235480,1410469
2023-05-07 02:43,1410499,659318,515700,235481,1410499
2023-05-07 02:44,1410528,659347,515700,235481,1410528
2023-05-07 02:45,1410558,659377,515700,235481,1410558
2023-05-07 02:46,1410589,659401,515706,235482,1410589
2023-05-07 02:47,1410617,659429,515706,235482,1410617
2023-05-07 02:48,1410647,659459,515706,235482,1410647
2023-05-07 02:49,1410676,659488,515706,235482,1410676
2023-05-07 02:51,1410706,659518,515706,235482,1410706
2023-05-07 02:52,1410735,659546,515706,235483,1410735
2023-05-07 02:53,1410764,659575,515706,235483,1410764
2023-05-07 02:54,1410793,659604,515706,235483,1410793
2023-05-07 02:55,1410823,659633,515706,235484,1410823
2023-05-07 02:56,1410852,659662,515706,235484,1410852
2023-05-07 02:57,1410881,659688,515709,235484,1410881
2023-05-07 02:58,1410912,659719,515709,235484,1410912
2023-05-07 02:59,1410940,659747,515709,235484,1410940
2023-05-07 03:00,1410971,659778,515709,235484,1410971
2023-05-07 03:01,1410998,659805,515709,235484,1410998
2023-05-07 03:02,1411027,659833,515709,235485,1411027
2023-05-07 03:03,1411056,659862,515709,235485,1411056
2023-05-07 03:04,1411084,659890,515709,235485,1411084
2023-05-07 03:05,1411111,659917,515709,235485,1411111
2023-05-07 03:06,1411140,659935,515720,235485,1411140
2023-05-07 03:07,1411170,659964,515721,235485,1411170
2023-05-07 03:08,1411198,659992,515721,235485,1411198
2023-05-07 03:09,1411226,660020,515721,235485,1411226
2023-05-07 03:10,1411254,660048,515721,235485,1411254
2023-05-07 03:11,1411281,660075,515721,235485,1411281
2023-05-07 03:12,1411309,660103,515721,235485,1411309
2023-05-07 03:13,1411339,660133,515721,235485,1411339
2023-05-07 03:14,1411367,660160,515721,235486,1411367
2023-05-07 03:15,1411393,660183,515723,235487,1411393
2023-05-07 03:16,1411421,660211,515723,235487,1411421
2023-05-07 03:17,1411450,660239,515724,235487,1411450
2023-05-07 03:18,1411480,660269,515724,235487,1411480
2023-05-07 03:19,1411508,660297,515724,235487,1411508
2023-05-07 03:20,1411537,660326,515724,235487,1411537
2023-05-07 03:21,1411566,660355,515724,235487,1411566
2023-05-07 03:22,1411594,660383,515724,235487,1411594
2023-05-07 03:23,1411622,660409,515726,235487,1411622
2023-05-07 03:24,1411651,660438,515726,235487,1411651
2023-05-07 03:25,1411677,660462,515726,235489,1411677
2023-05-07 03:26,1411707,660492,515726,235489,1411707
2023-05-07 03:27,1411735,660520,515726,235489,1411735
2023-05-07 03:28,1411764,660549,515726,235489,1411764
2023-05-07 03:29,1411792,660574,515728,235490,1411792
2023-05-07 03:30,1411820,660601,515728,235491,1411820
2023-05-07 03:31,1411849,660629,515729,235491,1411849
2023-05-07 03:32,1411877,660657,515729,235491,1411877
2023-05-07 03:33,1411904,660684,515729,235491,1411904
2023-05-07 03:34,1411932,660712,515729,235491,1411932
2023-05-07 03:35,1411961,660741,515729,235491,1411961
2023-05-07 03:36,1411989,660769,515729,235491,1411989
2023-05-07 03:38,1412018,660798,515729,235491,1412018
2023-05-07 03:39,1412044,660824,515729,235491,1412044
2023-05-07 03:40,1412075,660854,515730,235491,1412075
2023-05-07 03:41,1412102,660881,515730,235491,1412102
2023-05-07 03:42,1412131,660908,515732,235491,1412131
2023-05-07 03:43,1412158,660934,515732,235492,1412158
2023-05-07 03:44,1412187,660963,515732,235492,1412187
2023-05-07 03:45,1412215,660990,515732,235493,1412215
2023-05-07 03:46,1412242,661016,515732,235494,1412242
2023-05-07 03:47,1412272,661046,515732,235494,1412272
2023-05-07 03:48,1412300,661073,515733,235494,1412300
2023-05-07 03:49,1412327,661100,515733,235494,1412327
2023-05-07 03:50,1412356,661127,515735,235494,1412356
2023-05-07 03:51,1412384,661155,515735,235494,1412384
2023-05-07 03:52,1412412,661182,515736,235494,1412412
2023-05-07 03:53,1412440,661209,515736,235495,1412440
2023-05-07 03:54,1412469,661237,515737,235495,1412469
2023-05-07 03:55,1412497,661265,515737,235495,1412497
2023-05-07 03:56,1412524,661291,515737,235496,1412524
2023-05-07 03:57,1412552,661319,515737,235496,1412552
2023-05-07 03:58,1412581,661347,515737,235497,1412581
2023-05-07 03:59,1412608,661373,515737,235498,1412608
2023-05-07 04:00,1412629,661393,515737,235499,1412629
2023-05-07 04:01,1412638,661402,515737,235499,1412638
2023-05-07 04:02,1412648,661410,515739,235499,1412648
2023-05-07 04:03,1412658,661420,515739,235499,1412658
2023-05-07 04:04,1412667,661429,515739,235499,1412667
2023-05-07 04:05,1412677,661439,515739,235499,1412677
2023-05-07 04:06,1412688,661450,515739,235499,1412688
2023-05-07 04:07,1412698,661460,515739,235499,1412698
2023-05-07 04:08,1412707,661468,515739,235500,1412707
2023-05-07 04:09,1412718,661479,515739,235500,1412718
2023-05-07 04:10,1412728,661489,515739,235500,1412728
2023-05-07 04:11,1412738,661499,515739,235500,1412738
2023-05-07 04:12,1412747,661508,515739,235500,1412747
2023-05-07 04:13,1412756,661517,515739,235500,1412756
2023-05-07 04:14,1412767,661527,515741,235499,1412767
2023-05-07 04:15,1412776,661535,515741,235500,1412776
2023-05-07 04:16,1412786,661545,515741,235500,1412786
2023-05-07 04:17,1412795,661554,515741,235500,1412795
2023-05-07 04:18,1412805,661562,515743,235500,1412805
2023-05-07 04:19,1412814,661571,515743,235500,1412814
2023-05-07 04:20,1412823,661580,515743,235500,1412823
2023-05-07 04:21,1412833,661590,515743,235500,1412833
2023-05-07 04:22,1412842,661599,515743,235500,1412842
2023-05-07 04:24,1412852,661609,515743,235500,1412852
2023-05-07 04:25,1412862,661619,515743,235500,1412862
2023-05-07 04:26,1412872,661629,515743,235500,1412872
2023-05-07 04:27,1412881,661637,515744,235500,1412881
2023-05-07 04:28,1412891,661646,515744,235501,1412891
2023-05-07 04:29,1412901,661655,515745,235501,1412901
2023-05-07 04:30,1412911,661665,515745,235501,1412911
2023-05-07 04:31,1412921,661675,515745,235501,1412921
2023-05-07 04:32,1412930,661684,515745,235501,1412930
2023-05-07 04:33,1412939,661693,515745,235501,1412939
2023-05-07 04:34,1412949,661703,515745,235501,1412949
2023-05-07 04:35,1412958,661711,515746,235501,1412958
2023-05-07 04:36,1412968,661722,515746,235500,1412968
2023-05-07 04:37,1412978,661731,515746,235501,1412978
2023-05-07 04:38,1412987,661740,515746,235501,1412987
2023-05-07 04:39,1412997,661748,515748,235501,1412997
2023-05-07 04:40,1413006,661757,515748,235501,1413006
2023-05-07 04:41,1413016,661767,515748,235501,1413016
2023-05-07 04:42,1413026,661777,515748,235501,1413026
2023-05-07 04:43,1413035,661785,515749,235501,1413035
2023-05-07 04:44,1413044,661794,515749,235501,1413044
2023-05-07 04:45,1413055,661804,515750,235501,1413055
2023-05-07 04:46,1413066,661815,515750,235501,1413066
2023-05-07 04:47,1413075,661824,515750,235501,1413075
2023-05-07 04:48,1413085,661833,515750,235502,1413085
2023-05-07 04:49,1413094,661842,515750,235502,1413094
2023-05-07 04:50,1413104,661852,515750,235502,1413104
2023-05-07 04:51,1413113,661859,515751,235503,1413113
2023-05-07 04:52,1413123,661868,515751,235504,1413123
2023-05-07 04:53,1413132,661878,515751,235503,1413132
2023-05-07 04:54,1413142,661888,515751,235503,1413142
2023-05-07 04:55,1413152,661894,515753,235505,1413152
2023-05-07 04:56,1413161,661903,515753,235505,1413161
2023-05-07 04:57,1413171,661913,515753,235505,1413171
2023-05-07 04:58,1413180,661922,515753,235505,1413180
2023-05-07 04:59,1413189,661930,515754,235505,1413189
2023-05-07 05:00,1413204,661945,515754,235505,1413204
2023-05-07 05:01,1413220,661959,515754,235507,1413220
2023-05-07 05:02,1413236,661975,515754,235507,1413236
2023-05-07 05:03,1413253,661992,515754,235507,1413253
2023-05-07 05:04,1413269,662008,515754,235507,1413269
2023-05-07 05:05,1413285,662024,515754,235507,1413285
2023-05-07 05:06,1413301,662040,515754,235507,1413301
2023-05-07 05:07,1413317,662056,515754,235507,1413317
2023-05-07 05:08,1413334,662073,515754,235507,1413334
2023-05-07 05:09,1413349,662088,515754,235507,1413349
2023-05-07 05:11,1413366,662105,515754,235507,1413366
2023-05-07 05:12,1413383,662120,515756,235507,1413383
2023-05-07 05:13,1413398,662134,515756,235508,1413398
2023-05-07 05:14,1413414,662150,515756,235508,1413414
2023-05-07 05:15,1413432,662167,515756,235509,1413432
2023-05-07 05:16,1413447,662182,515756,235509,1413447
2023-05-07 05:17,1413464,662199,515756,235509,1413464
2023-05-07 05:18,1413480,662215,515756,235509,1413480
2023-05-07 05:19,1413496,662230,515756,235510,1413496
2023-05-07 05:20,1413513,662247,515756,235510,1413513
2023-05-07 05:21,1413529,662263,515756,235510,1413529
2023-05-07 05:22,1413545,662277,515758,235510,1413545
2023-05-07 05:23,1413562,662294,515758,235510,1413562
2023-05-07 05:24,1413577,662309,515758,235510,1413577
2023-05-07 05:25,1413594,662325,515758,235511,1413594
2023-05-07 05:26,1413610,662340,515758,235512,1413610
2023-05-07 05:27,1413626,662356,515758,235512,1413626
2023-05-07 05:28,1413642,662371,515759,235512,1413642
2023-05-07 05:29,1413659,662388,515759,235512,1413659
2023-05-07 05:30,1413675,662404,515759,235512,1413675
2023-05-07 05:31,1413690,662419,515759,235512,1413690
2023-05-07 05:32,1413708,662437,515759,235512,1413708
2023-05-07 05:33,1413724,662453,515759,235512,1413724
2023-05-07 05:34,1413740,662469,515759,235512,1413740
2023-05-07 05:35,1413757,662486,515759,235512,1413757
2023-05-07 05:36,1413772,662502,515758,235512,1413772
2023-05-07 05:37,1413789,662519,515758,235512,1413789
2023-05-07 05:38,1413805,662535,515758,235512,1413805
2023-05-07 05:39,1413821,662551,515758,235512,1413821
2023-05-07 05:40,1413838,662568,515758,235512,1413838
2023-05-07 05:41,1413855,662585,515758,235512,1413855
2023-05-07 05:42,1413871,662602,515757,235512,1413871
2023-05-07 05:43,1413888,662619,515757,235512,1413888
2023-05-07 05:44,1413903,662634,515757,235512,1413903
2023-05-07 05:45,1413920,662651,515757,235512,1413920
2023-05-07 05:46,1413936,662666,515758,235512,1413936
2023-05-07 05:47,1413953,662683,515758,235512,1413953
2023-05-07 05:48,1413969,662699,515758,235512,1413969
2023-05-07 05:49,1413986,662716,515758,235512,1413986
2023-05-07 05:50,1414002,662732,515758,235512,1414002
2023-05-07 05:51,1414018,662748,515758,235512,1414018
2023-05-07 05:52,1414034,662763,515759,235512,1414034
2023-05-07 05:53,1414051,662780,515759,235512,1414051
2023-05-07 05:54,1414066,662795,515759,235512,1414066
2023-05-07 05:55,1414083,662812,515759,235512,1414083
2023-05-07 05:56,1414099,662828,515759,235512,1414099
2023-05-07 05:58,1414115,662844,515759,235512,1414115
2023-05-07 05:59,1414132,662859,515760,235513,1414132
2023-05-07 06:00,1414148,662875,515760,235513,1414148
2023-05-07 06:01,1414158,662884,515761,235513,1414158
2023-05-07 06:02,1414168,662894,515761,235513,1414168
2023-05-07 06:03,1414178,662903,515762,235513,1414178
2023-05-07 06:04,1414187,662912,515762,235513,1414187
2023-05-07 06:05,1414196,662921,515762,235513,1414196
2023-05-07 06:06,1414206,662931,515762,235513,1414206
2023-05-07 06:07,1414216,662941,515762,235513,1414216
2023-05-07 06:08,1414226,662951,515762,235513,1414226
2023-05-07 06:09,1414237,662962,515762,235513,1414237
2023-05-07 06:10,1414247,662972,515762,235513,1414247
2023-05-07 06:11,1414257,662981,515763,235513,1414257
2023-05-07 06:12,1414266,662989,515763,235514,1414266
2023-05-07 06:13,1414276,662997,515765,235514,1414276
2023-05-07 06:14,1414286,663007,515765,235514,1414286
2023-05-07 06:15,1414296,663017,515765,235514,1414296
2023-05-07 06:16,1414306,663026,515765,235515,1414306
2023-05-07 06:17,1414316,663036,515765,235515,1414316
2023-05-07 06:18,1414325,663045,515765,235515,1414325
2023-05-07 06:19,1414336,663056,515765,235515,1414336
2023-05-07 06:20,1414345,663065,515765,235515,1414345
2023-05-07 06:21,1414355,663074,515766,235515,1414355
2023-05-07 06:22,1414364,663083,515766,235515,1414364
2023-05-07 06:23,1414373,663091,515766,235516,1414373
2023-05-07 06:24,1414385,663103,515766,235516,1414385
2023-05-07 06:25,1414394,663111,515767,235516,1414394
2023-05-07 06:26,1414404,663121,515767,235516,1414404
2023-05-07 06:27,1414413,663129,515768,235516,1414413
2023-05-07 06:28,1414422,663138,515768,235516,1414422
2023-05-07 06:29,1414432,663147,515769,235516,1414432
2023-05-07 06:30,1414442,663157,515769,235516,1414442
2023-05-07 06:31,1414451,663166,515769,235516,1414451
2023-05-07 06:32,1414461,663175,515769,235517,1414461
2023-05-07 06:33,1414470,663184,515769,235517,1414470
2023-05-07 06:34,1414480,663193,515769,235518,1414480
2023-05-07 06:35,1414490,663202,515770,235518,1414490
2023-05-07 06:36,1414499,663210,515770,235519,1414499
2023-05-07 06:37,1414509,663220,515770,235519,1414509
2023-05-07 06:38,1414518,663229,515770,235519,1414518
2023-05-07 06:39,1414527,663237,515771,235519,1414527
2023-05-07 06:40,1414538,663247,515771,235520,1414538
2023-05-07 06:41,1414547,663256,515771,235520,1414547
2023-05-07 06:42,1414556,663265,515771,235520,1414556
2023-05-07 06:43,1414566,663275,515771,235520,1414566
2023-05-07 06:45,1414576,663285,515771,235520,1414576
2023-05-07 06:46,1414585,663293,515772,235520,1414585
2023-05-07 06:47,1414595,663303,515772,235520,1414595
2023-05-07 06:48,1414604,663311,515773,235520,1414604
2023-05-07 06:49,1414614,663320,515773,235521,1414614
2023-05-07 06:50,1414623,663327,515775,235521,1414623
2023-05-07 06:51,1414633,663337,515775,235521,1414633
2023-05-07 06:52,1414643,663343,515778,235522,1414643
2023-05-07 06:53,1414653,663353,515778,235522,1414653
2023-05-07 06:54,1414665,663363,515778,235524,1414665
2023-05-07 06:55,1414674,663372,515778,235524,1414674
2023-05-07 06:56,1414685,663382,515779,235524,1414685
2023-05-07 06:57,1414695,663392,515779,235524,1414695
2023-05-07 06:58,1414704,663400,515780,235524,1414704
2023-05-07 06:59,1414714,663410,515780,235524,1414714
2023-05-07 07:00,1414726,663420,515782,235524,1414726
2023-05-07 07:01,1414739,663433,515782,235524,1414739
2023-05-07 07:02,1414752,663443,515784,235525,1414752
2023-05-07 07:03,1414766,663457,515784,235525,1414766
2023-05-07 07:04,1414780,663470,515785,235525,1414780
2023-05-07 07:05,1414793,663483,515785,235525,1414793
2023-05-07 07:06,1414806,663493,515787,235526,1414806
2023-05-07 07:07,1414819,663505,515787,235527,1414819
2023-05-07 07:08,1414833,663513,515792,235528,1414833
2023-05-07 07:09,1414846,663526,515792,235528,1414846
2023-05-07 07:10,1414860,663538,515794,235528,1414860
2023-05-07 07:11,1414874,663552,515794,235528,1414874
2023-05-07 07:12,1414887,663563,515794,235530,1414887
2023-05-07 07:13,1414899,663574,515794,235531,1414899
2023-05-07 07:14,1414912,663584,515797,235531,1414912
2023-05-07 07:15,1414926,663598,515797,235531,1414926
2023-05-07 07:16,1414939,663608,515799,235532,1414939
2023-05-07 07:17,1414952,663620,515799,235533,1414952
2023-05-07 07:18,1414965,663632,515799,235534,1414965
2023-05-07 07:19,1414978,663645,515799,235534,1414978
2023-05-07 07:20,1414991,663655,515802,235534,1414991
2023-05-07 07:21,1415004,663669,515802,235533,1415004
2023-05-07 07:22,1415017,663679,515805,235533,1415017
2023-05-07 07:23,1415030,663692,515805,235533,1415030
2023-05-07 07:24,1415043,663703,515806,235534,1415043
2023-05-07 07:25,1415056,663716,515806,235534,1415056
2023-05-07 07:26,1415070,663729,515806,235535,1415070
2023-05-07 07:27,1415083,663743,515806,235534,1415083
2023-05-07 07:28,1415095,663754,515807,235534,1415095
2023-05-07 07:29,1415109,663767,515807,235535,1415109
2023-05-07 07:30,1415121,663778,515808,235535,1415121
2023-05-07 07:31,1415135,663791,515808,235536,1415135
2023-05-07 07:33,1415148,663802,515810,235536,1415148
2023-05-07 07:34,1415161,663815,515810,235536,1415161
2023-05-07 07:35,1415175,663828,515810,235537,1415175
2023-05-07 07:36,1415188,663841,515810,235537,1415188
2023-05-07 07:37,1415201,663849,515814,235538,1415201
2023-05-07 07:38,1415214,663859,515814,235541,1415214
2023-05-07 07:39,1415228,663871,515816,235541,1415228
2023-05-07 07:40,1415241,663884,515816,235541,1415241
2023-05-07 07:41,1415255,663898,515816,235541,1415255
2023-05-07 07:42,1415268,663911,515816,235541,1415268
2023-05-07 07:43,1415281,663922,515817,235542,1415281
2023-05-07 07:44,1415295,663935,515817,235543,1415295
2023-05-07 07:45,1415307,663945,515817,235545,1415307
2023-05-07 07:46,1415322,663958,515817,235547,1415322
2023-05-07 07:47,1415335,663969,515819,235547,1415335
2023-05-07 07:48,1415350,663983,515819,235548,1415350
2023-05-07 07:49,1415362,663995,515819,235548,1415362
2023-05-07 07:50,1415375,664007,515819,235549,1415375
2023-05-07 07:51,1415389,664022,515818,235549,1415389
2023-05-07 07:52,1415402,664035,515818,235549,1415402
2023-05-07 07:53,1415416,664047,515820,235549,1415416
2023-05-07 07:54,1415429,664060,515820,235549,1415429
2023-05-07 07:55,1415442,664071,515822,235549,1415442
2023-05-07 07:56,1415455,664080,515823,235552,1415455
2023-05-07 07:57,1415468,664093,515823,235552,1415468
2023-05-07 07:58,1415481,664103,515826,235552,1415481
2023-05-07 07:59,1415495,664117,515826,235552,1415495
2023-05-07 08:00,1415514,664136,515826,235552,1415514
2023-05-07 08:01,1415537,664157,515826,235554,1415537
2023-05-07 08:02,1415561,664181,515826,235554,1415561
2023-05-07 08:03,1415583,664203,515826,235554,1415583
2023-05-07 08:04,1415607,664222,515829,235556,1415607
2023-05-07 08:05,1415629,664243,515829,235557,1415629
2023-05-07 08:06,1415654,664265,515831,235558,1415654
2023-05-07 08:07,1415676,664287,515831,235558,1415676
2023-05-07 08:08,1415699,664306,515835,235558,1415699
2023-05-07 08:09,1415722,664327,515835,235560,1415722
2023-05-07 08:10,1415746,664349,515836,235561,1415746
2023-05-07 08:11,1415770,664372,515836,235562,1415770
2023-05-07 08:12,1415792,664392,515836,235564,1415792
2023-05-07 08:13,1415816,664416,515836,235564,1415816
2023-05-07 08:14,1415840,664437,515839,235564,1415840
2023-05-07 08:15,1415864,664461,515839,235564,1415864
2023-05-07 08:16,1415886,664481,515840,235565,1415886
2023-05-07 08:17,1415909,664503,515840,235566,1415909
2023-05-07 08:18,1415934,664527,515840,235567,1415934
2023-05-07 08:20,1415959,664552,515840,235567,1415959
2023-05-07 08:21,1415981,664572,515841,235568,1415981
2023-05-07 08:22,1416003,664594,515841,235568,1416003
2023-05-07 08:23,1416026,664614,515844,235568,1416026
2023-05-07 08:24,1416050,664638,515844,235568,1416050
2023-05-07 08:25,1416075,664660,515847,235568,1416075
2023-05-07 08:26,1416099,664684,515847,235568,1416099
2023-05-07 08:27,1416122,664705,515848,235569,1416122
2023-05-07 08:28,1416146,664729,515848,235569,1416146
2023-05-07 08:29,1416169,664750,515850,235569,1416169
2023-05-07 08:30,1416194,664775,515850,235569,1416194
2023-05-07 08:31,1416218,664796,515852,235570,1416218
2023-05-07 08:32,1416241,664817,515852,235572,1416241
2023-05-07 08:33,1416267,664840,515855,235572,1416267
2023-05-07 08:34,1416291,664863,515855,235573,1416291
2023-05-07 08:35,1416315,664884,515856,235575,1416315
2023-05-07 08:36,1416339,664906,515856,235577,1416339
2023-05-07 08:37,1416362,664923,515859,235580,1416362
2023-05-07 08:38,1416386,664947,515859,235580,1416386
2023-05-07 08:39,1416410,664967,515863,235580,1416410
2023-05-07 08:40,1416435,664991,515863,235581,1416435
2023-05-07 08:41,1416460,665013,515865,235582,1416460
2023-05-07 08:42,1416483,665035,515865,235583,1416483
2023-05-07 08:43,1416506,665057,515865,235584,1416506
2023-05-07 08:44,1416528,665079,515865,235584,1416528
2023-05-07 08:45,1416553,665102,515868,235583,1416553
2023-05-07 08:46,1416577,665126,515868,235583,1416577
2023-05-07 08:47,1416601,665148,515870,235583,1416601
2023-05-07 08:48,1416623,665169,515870,235584,1416623
2023-05-07 08:49,1416647,665192,515871,235584,1416647
2023-05-07 08:50,1416671,665216,515871,235584,1416671
2023-05-07 08:51,1416696,665237,515872,235587,1416696
2023-05-07 08:52,1416718,665257,515874,235587,1416718
2023-05-07 08:53,1416741,665280,515874,235587,1416741
2023-05-07 08:54,1416764,665300,515876,235588,1416764
2023-05-07 08:55,1416788,665324,515876,235588,1416788
2023-05-07 08:56,1416811,665346,515877,235588,1416811
2023-05-07 08:57,1416834,665369,515877,235588,1416834
2023-05-07 08:58,1416856,665386,515882,235588,1416856
2023-05-07 08:59,1416880,665410,515882,235588,1416880
2023-05-07 09:00,1416896,665422,515884,235590,1416896
2023-05-07 09:01,1416910,665436,515884,235590,1416910
2023-05-07 09:02,1416925,665447,515887,235591,1416925
2023-05-07 09:03,1416938,665459,515887,235592,1416938
2023-05-07 09:04,1416951,665469,515889,235593,1416951
2023-05-07 09:05,1416965,665482,515889,235594,1416965
2023-05-07 09:07,1416978,665493,515891,235594,1416978
2023-05-07 09:08,1416993,665506,515893,235594,1416993
2023-05-07 09:09,1417008,665521,515893,235594,1417008
2023-05-07 09:10,1417022,665529,515898,235595,1417022
2023-05-07 09:11,1417035,665542,515898,235595,1417035
2023-05-07 09:12,1417052,665556,515901,235595,1417052
2023-05-07 09:13,1417065,665568,515901,235596,1417065
2023-05-07 09:14,1417081,665577,515906,235598,1417081
2023-05-07 09:15,1417096,665591,515906,235599,1417096
2023-05-07 09:16,1417109,665602,515908,235599,1417109
2023-05-07 09:17,1417123,665615,515908,235600,1417123
2023-05-07 09:18,1417139,665629,515910,235600,1417139
2023-05-07 09:19,1417154,665643,515910,235601,1417154
2023-05-07 09:20,1417168,665653,515914,235601,1417168
2023-05-07 09:21,1417182,665666,515915,235601,1417182
2023-05-07 09:22,1417196,665679,515915,235602,1417196
2023-05-07 09:23,1417210,665688,515919,235603,1417210
2023-05-07 09:24,1417223,665701,515919,235603,1417223
2023-05-07 09:25,1417237,665709,515925,235603,1417237
2023-05-07 09:26,1417253,665725,515925,235603,1417253
2023-05-07 09:27,1417268,665734,515930,235604,1417268
2023-05-07 09:28,1417281,665746,515930,235605,1417281
2023-05-07 09:29,1417295,665756,515932,235607,1417295
2023-05-07 09:30,1417309,665768,515932,235609,1417309
2023-05-07 09:31,1417323,665774,515938,235611,1417323
2023-05-07 09:32,1417337,665788,515938,235611,1417337
2023-05-07 09:33,1417351,665798,515941,235612,1417351
2023-05-07 09:34,1417366,665812,515941,235613,1417366
2023-05-07 09:35,1417380,665821,515945,235614,1417380
2023-05-07 09:36,1417393,665833,515945,235615,1417393
2023-05-07 09:37,1417407,665843,515947,235617,1417407
2023-05-07 09:38,1417423,665859,515947,235617,1417423
2023-05-07 09:39,1417436,665868,515950,235618,1417436
2023-05-07 09:40,1417452,665884,515950,235618,1417452
2023-05-07 09:41,1417466,665896,515951,235619,1417466
2023-05-07 09:42,1417479,665907,515951,235621,1417479
2023-05-07 09:43,1417493,665919,515952,235622,1417493
2023-05-07 09:44,1417506,665932,515952,235622,1417506
2023-05-07 09:45,1417520,665941,515955,235624,1417520
2023-05-07 09:46,1417536,665957,515955,235624,1417536
2023-05-07 09:47,1417550,665969,515956,235625,1417550
2023-05-07 09:48,1417564,665982,515956,235626,1417564
2023-05-07 09:49,1417578,665992,515960,235626,1417578
2023-05-07 09:50,1417591,666005,515960,235626,1417591
2023-05-07 09:51,1417604,666015,515962,235627,1417604
2023-05-07 09:52,1417618,666028,515962,235628,1417618
2023-05-07 09:53,1417633,666037,515966,235630,1417633
2023-05-07 09:55,1417648,666052,515966,235630,1417648
2023-05-07 09:56,1417664,666062,515970,235632,1417664
2023-05-07 09:57,1417676,666073,515970,235633,1417676
2023-05-07 09:58,1417692,666084,515975,235633,1417692
2023-05-07 09:59,1417705,666096,515975,235634,1417705
2023-05-07 10:00,1417718,666108,515976,235634,1417718
2023-05-07 10:01,1417730,666120,515976,235634,1417730
2023-05-07 10:02,1417742,666127,515979,235636,1417742
2023-05-07 10:03,1417753,666137,515979,235637,1417753
2023-05-07 10:04,1417764,666147,515980,235637,1417764
2023-05-07 10:05,1417776,666159,515980,235637,1417776
2023-05-07 10:06,1417786,666164,515984,235638,1417786
2023-05-07 10:07,1417798,666175,515984,235639,1417798
2023-05-07 10:08,1417811,666187,515985,235639,1417811
2023-05-07 10:09,1417822,666198,515985,235639,1417822
2023-05-07 10:10,1417834,666201,515993,235640,1417834
2023-05-07 10:11,1417845,666211,515993,235641,1417845
2023-05-07 10:12,1417856,666220,515995,235641,1417856
2023-05-07 10:13,1417867,666227,515997,235643,1417867
2023-05-07 10:14,1417879,666239,515997,235643,1417879
2023-05-07 10:15,1417890,666243,516004,235643,1417890
2023-05-07 10:16,1417901,666255,516004,235642,1417901
2023-05-07 10:17,1417913,666264,516006,235643,1417913
2023-05-07 10:18,1417926,666276,516006,235644,1417926
2023-05-07 10:19,1417937,666283,516010,235644,1417937
2023-05-07 10:20,1417948,666294,516010,235644,1417948
2023-05-07 10:21,1417959,666302,516012,235645,1417959
2023-05-07 10:22,1417971,666313,516012,235646,1417971
2023-05-07 10:23,1417982,666320,516016,235646,1417982
2023-05-07 10:24,1417994,666329,516019,235646,1417994
2023-05-07 10:25,1418005,666338,516019,235648,1418005
2023-05-07 10:26,1418016,666345,516021,235650,1418016
2023-05-07 10:27,1418026,666353,516021,235652,1418026
2023-05-07 10:28,1418038,666361,516024,235653,1418038
2023-05-07 10:29,1418048,666370,516024,235654,1418048
2023-05-07 10:30,1418061,666378,516026,235657,1418061
2023-05-07 10:31,1418072,666388,516026,235658,1418072
2023-05-07 10:32,1418083,666394,516030,235659,1418083
2023-05-07 10:33,1418096,666406,516030,235660,1418096
2023-05-07 10:34,1418107,666412,516035,235660,1418107
2023-05-07 10:35,1418117,666421,516035,235661,1418117
2023-05-07 10:36,1418129,666427,516040,235662,1418129
2023-05-07 10:37,1418142,666440,516040,235662,1418142
2023-05-07 10:38,1418153,666447,516042,235664,1418153
2023-05-07 10:39,1418165,666459,516042,235664,1418165
2023-05-07 10:40,1418178,666471,516043,235664,1418178
2023-05-07 10:42,1418188,666480,516043,235665,1418188
2023-05-07 10:43,1418200,666489,516046,235665,1418200
2023-05-07 10:44,1418211,666499,516046,235666,1418211
2023-05-07 10:45,1418222,666507,516048,235667,1418222
2023-05-07 10:46,1418234,666519,516048,235667,1418234
2023-05-07 10:47,1418244,666523,516051,235670,1418244
2023-05-07 10:48,1418258,666535,516052,235671,1418258
2023-05-07 10:49,1418270,666542,516055,235673,1418270
2023-05-07 10:50,1418282,666552,516055,235675,1418282
2023-05-07 10:51,1418295,666559,516060,235676,1418295
2023-05-07 10:52,1418305,666563,516065,235677,1418305
2023-05-07 10:53,1418317,666575,516065,235677,1418317
2023-05-07 10:54,1418328,666581,516070,235677,1418328
2023-05-07 10:55,1418339,666591,516070,235678,1418339
2023-05-07 10:56,1418351,666598,516074,235679,1418351
2023-05-07 10:57,1418361,666608,516074,235679,1418361
2023-05-07 10:58,1418373,666620,516074,235679,1418373
2023-05-07 10:59,1418385,666631,516074,235680,1418385
2023-05-07 11:00,1418405,666648,516077,235680,1418405
2023-05-07 11:01,1418445,666688,516077,235680,1418445
2023-05-07 11:02,1418485,666727,516077,235681,1418485
2023-05-07 11:03,1418523,666764,516077,235682,1418523
2023-05-07 11:04,1418562,666802,516077,235683,1418562
2023-05-07 11:05,1418602,666831,516086,235685,1418602
2023-05-07 11:06,1418640,666869,516086,235685,1418640
2023-05-07 11:07,1418679,666900,516093,235686,1418679
2023-05-07 11:08,1418718,666939,516093,235686,1418718
2023-05-07 11:09,1418759,666976,516095,235688,1418759
2023-05-07 11:10,1418797,667014,516095,235688,1418797
2023-05-07 11:11,1418835,667050,516096,235689,1418835
2023-05-07 11:12,1418875,667090,516096,235689,1418875
2023-05-07 11:13,1418912,667120,516100,235692,1418912
2023-05-07 11:14,1418951,667157,516100,235694,1418951
2023-05-07 11:15,1418989,667187,516106,235696,1418989
2023-05-07 11:16,1419027,667224,516106,235697,1419027
2023-05-07 11:17,1419068,667262,516109,235697,1419068
2023-05-07 11:18,1419106,667298,516109,235699,1419106
2023-05-07 11:19,1419145,667331,516115,235699,1419145
2023-05-07 11:20,1419183,667369,516115,235699,1419183
2023-05-07 11:21,1419223,667406,516118,235699,1419223
2023-05-07 11:22,1419262,667443,516118,235701,1419262
2023-05-07 11:23,1419301,667476,516122,235703,1419301
2023-05-07 11:24,1419340,667514,516122,235704,1419340
2023-05-07 11:25,1419380,667550,516124,235706,1419380
2023-05-07 11:26,1419418,667588,516124,235706,1419418
2023-05-07 11:27,1419457,667624,516127,235706,1419457
2023-05-07 11:29,1419498,667662,516129,235707,1419498
2023-05-07 11:30,1419535,667697,516129,235709,1419535
2023-05-07 11:31,1419574,667734,516130,235710,1419574
2023-05-07 11:32,1419613,667773,516130,235710,1419613
2023-05-07 11:33,1419653,667804,516137,235712,1419653
2023-05-07 11:34,1419690,667841,516137,235712,1419690
2023-05-07 11:35,1419729,667877,516140,235712,1419729
2023-05-07 11:36,1419770,667916,516140,235714,1419770
2023-05-07 11:37,1419810,667950,516143,235717,1419810
2023-05-07 11:38,1419848,667987,516143,235718,1419848
2023-05-07 11:39,1419889,668023,516148,235718,1419889
2023-05-07 11:40,1419927,668061,516148,235718,1419927
2023-05-07 11:41,1419965,668093,516153,235719,1419965
2023-05-07 11:42,1420001,668129,516153,235719,1420001
2023-05-07 11:43,1420043,668162,516159,235722,1420043
2023-05-07 11:44,1420081,668200,516159,235722,1420081
2023-05-07 11:45,1420120,668232,516165,235723,1420120
2023-05-07 11:46,1420157,668265,516167,235725,1420157
2023-05-07 11:47,1420198,668304,516167,235727,1420198
2023-05-07 11:48,1420238,668339,516169,235730,1420238
2023-05-07 11:49,1420276,668377,516169,235730,1420276
2023-05-07 11:50,1420316,668412,516173,235731,1420316
2023-05-07 11:51,1420355,668451,516173,235731,1420355
2023-05-07 11:52,1420394,668484,516179,235731,1420394
2023-05-07 11:53,1420433,668523,516179,235731,1420433
2023-05-07 11:54,1420474,668560,516182,235732,1420474
2023-05-07 11:55,1420513,668598,516182,235733,1420513
2023-05-07 11:56,1420551,668634,516183,235734,1420551
2023-05-07 11:57,1420590,668672,516183,235735,1420590
2023-05-07 11:58,1420627,668702,516189,235736,1420627
2023-05-07 11:59,1420667,668741,516189,235737,1420667
2023-05-07 12:00,1420695,668763,516194,235738,1420695
2023-05-07 12:01,1420718,668785,516194,235739,1420718
2023-05-07 12:02,1420740,668802,516198,235740,1420740
2023-05-07 12:03,1420764,668826,516198,235740,1420764
2023-05-07 12:04,1420785,668843,516200,235742,1420785
2023-05-07 12:05,1420809,668866,516200,235743,1420809
2023-05-07 12:06,1420831,668881,516206,235744,1420831
2023-05-07 12:07,1420854,668900,516209,235745,1420854
2023-05-07 12:08,1420875,668918,516212,235745,1420875
2023-05-07 12:09,1420897,668938,516212,235747,1420897
2023-05-07 12:10,1420919,668957,516214,235748,1420919
2023-05-07 12:11,1420942,668980,516214,235748,1420942
2023-05-07 12:12,1420964,668992,516220,235752,1420964
2023-05-07 12:13,1420985,669012,516220,235753,1420985
2023-05-07 12:14,1421007,669031,516222,235754,1421007
2023-05-07 12:16,1421030,669054,516222,235754,1421030
2023-05-07 12:17,1421052,669069,516227,235756,1421052
2023-05-07 12:18,1421074,669089,516227,235758,1421074
2023-05-07 12:19,1421097,669111,516228,235758,1421097
2023-05-07 12:20,1421120,669130,516228,235762,1421120
2023-05-07 12:21,1421142,669148,516232,235762,1421142
2023-05-07 12:22,1421163,669167,516232,235764,1421163
2023-05-07 12:23,1421185,669184,516236,235765,1421185
2023-05-07 12:24,1421208,669205,516236,235767,1421208
2023-05-07 12:25,1421229,669222,516239,235768,1421229
2023-05-07 12:26,1421252,669245,516239,235768,1421252
2023-05-07 12:27,1421274,669258,516246,235770,1421274
2023-05-07 12:28,1421296,669280,516246,235770,1421296
2023-05-07 12:29,1421319,669295,516254,235770,1421319
2023-05-07 12:30,1421341,669316,516254,235771,1421341
2023-05-07 12:31,1421364,669335,516256,235773,1421364
2023-05-07 12:32,1421386,669356,516256,235774,1421386
2023-05-07 12:33,1421408,669372,516262,235774,1421408
2023-05-07 12:34,1421430,669392,516262,235776,1421430
2023-05-07 12:35,1421453,669410,516267,235776,1421453
2023-05-07 12:36,1421476,669429,516267,235780,1421476
2023-05-07 12:37,1421498,669445,516270,235783,1421498
2023-05-07 12:38,1421520,669467,516270,235783,1421520
2023-05-07 12:39,1421543,669485,516273,235785,1421543
2023-05-07 12:40,1421565,669505,516273,235787,1421565
2023-05-07 12:41,1421587,669524,516276,235787,1421587
2023-05-07 12:42,1421611,669548,516276,235787,1421611
2023-05-07 12:43,1421635,669568,516279,235788,1421635
2023-05-07 12:44,1421657,669587,516279,235791,1421657
2023-05-07 12:45,1421679,669603,516281,235795,1421679
2023-05-07 12:46,1421700,669622,516281,235797,1421700
2023-05-07 12:47,1421722,669634,516291,235797,1421722
2023-05-07 12:48,1421744,669654,516291,235799,1421744
2023-05-07 12:49,1421767,669670,516295,235802,1421767
2023-05-07 12:50,1421790,669693,516295,235802,1421790
2023-05-07 12:51,1421812,669710,516299,235803,1421812
2023-05-07 12:52,1421834,669729,516299,235806,1421834
2023-05-07 12:53,1421857,669748,516302,235807,1421857
2023-05-07 12:54,1421879,669765,516305,235809,1421879
2023-05-07 12:55,1421901,669786,516305,235810,1421901
2023-05-07 12:56,1421923,669805,516308,235810,1421923
2023-05-07 12:57,1421945,669824,516308,235813,1421945
2023-05-07 12:58,1421967,669841,516310,235816,1421967
2023-05-07 12:59,1421991,669864,516310,235817,1421991
2023-05-07 13:00,1422018,669887,516313,235818,1422018
2023-05-07 13:01,1422043,669911,516313,235819,1422043
2023-05-07 13:03,1422072,669936,516316,235820,1422072
2023-05-07 13:04,1422096,669959,516316,235821,1422096
2023-05-07 13:05,1422122,669981,516320,235821,1422122
2023-05-07 13:06,1422147,670002,516320,235825,1422147
2023-05-07 13:07,1422173,670022,516323,235828,1422173
2023-05-07 13:08,1422199,670048,516323,235828,1422199
2023-05-07 13:09,1422223,670069,516326,235828,1422223
2023-05-07 13:10,1422251,670094,516326,235831,1422251
2023-05-07 13:11,1422278,670119,516327,235832,1422278
2023-05-07 13:12,1422303,670142,516327,235834,1422303
2023-05-07 13:13,1422328,670163,516329,235836,1422328
2023-05-07 13:14,1422353,670184,516329,235840,1422353
2023-05-07 13:15,1422378,670207,516330,235841,1422378
2023-05-07 13:16,1422405,670233,516330,235842,1422405
2023-05-07 13:17,1422432,670256,516332,235844,1422432
2023-05-07 13:18,1422457,670281,516332,235844,1422457
2023-05-07 13:19,1422483,670302,516336,235845,1422483
2023-05-07 13:20,1422510,670328,516336,235846,1422510
2023-05-07 13:21,1422535,670347,516341,235847,1422535
2023-05-07 13:22,1422561,670373,516341,235847,1422561
2023-05-07 13:23,1422588,670395,516346,235847,1422588
2023-05-07 13:24,1422612,670419,516346,235847,1422612
2023-05-07 13:25,1422637,670441,516348,235848,1422637
2023-05-07 13:26,1422663,670466,516348,235849,1422663
2023-05-07 13:27,1422689,670488,516349,235852,1422689
2023-05-07 13:28,1422715,670514,516349,235852,1422715
2023-05-07 13:29,1422740,670534,516354,235852,1422740
2023-05-07 13:30,1422767,670561,516354,235852,1422767
2023-05-07 13:31,1422793,670587,516354,235852,1422793
2023-05-07 13:32,1422819,670609,516356,235854,1422819
2023-05-07 13:33,1422845,670633,516356,235856,1422845
2023-05-07 13:34,1422869,670654,516357,235858,1422869
2023-05-07 13:35,1422895,670678,516357,235860,1422895
2023-05-07 13:36,1422919,670698,516360,235861,1422919
2023-05-07 13:37,1422945,670720,516360,235865,1422945
2023-05-07 13:38,1422971,670741,516365,235865,1422971
2023-05-07 13:39,1422997,670765,516365,235867,1422997
2023-05-07 13:40,1423022,670785,516369,235868,1423022
2023-05-07 13:41,1423048,670808,516369,235871,1423048
2023-05-07 13:42,1423073,670830,516372,235871,1423073
2023-05-07 13:43,1423099,670851,516374,235874,1423099
2023-05-07 13:44,1423126,670875,516374,235877,1423126
2023-05-07 13:45,1423152,670896,516378,235878,1423152
2023-05-07 13:46,1423178,670920,516378,235880,1423178
2023-05-07 13:47,1423203,670943,516379,235881,1423203
2023-05-07 13:48,1423229,670969,516379,235881,1423229
2023-05-07 13:50,1423254,670990,516383,235881,1423254
2023-05-07 13:51,1423280,671015,516383,235882,1423280
2023-05-07 13:52,1423306,671038,516385,235883,1423306
2023-05-07 13:53,1423332,671062,516386,235884,1423332
2023-05-07 13:54,1423355,671084,516386,235885,1423355
2023-05-07 13:55,1423381,671104,516390,235887,1423381
2023-05-07 13:56,1423408,671131,516390,235887,1423408
2023-05-07 13:57,1423433,671152,516394,235887,1423433
2023-05-07 13:58,1423459,671177,516394,235888,1423459
2023-05-07 13:59,1423485,671201,516394,235890,1423485
2023-05-07 14:00,1423512,671228,516394,235890,1423512
2023-05-07 14:01,1423541,671254,516396,235891,1423541
2023-05-07 14:02,1423572,671282,516396,235894,1423572
2023-05-07 14:03,1423604,671310,516398,235896,1423604
2023-05-07 14:04,1423636,671340,516398,235898,1423636
2023-05-07 14:05,1423665,671365,516401,235899,1423665
2023-05-07 14:06,1423696,671395,516401,235900,1423696
2023-05-07 14:07,1423725,671420,516402,235903,1423725
2023-05-07 14:08,1423755,671449,516402,235904,1423755
2023-05-07 14:09,1423785,671478,516403,235904,1423785
2023-05-07 14:10,1423817,671503,516410,235904,1423817
2023-05-07 14:11,1423847,671533,516410,235904,1423847
2023-05-07 14:12,1423876,671558,516414,235904,1423876
2023-05-07 14:13,1423907,671589,516414,235904,1423907
2023-05-07 14:14,1423937,671613,516420,235904,1423937
2023-05-07 14:15,1423966,671640,516420,235906,1423966
2023-05-07 14:16,1423998,671666,516426,235906,1423998
2023-05-07 14:17,1424027,671694,516426,235907,1424027
2023-05-07 14:18,1424058,671723,516428,235907,1424058
2023-05-07 14:19,1424090,671755,516428,235907,1424090
2023-05-07 14:20,1424121,671781,516432,235908,1424121
2023-05-07 14:21,1424151,671810,516432,235909,1424151
2023-05-07 14:22,1424180,671831,516440,235909,1424180
2023-05-07 14:23,1424211,671861,516440,235910,1424211
2023-05-07 14:24,1424242,671889,516441,235912,1424242
2023-05-07 14:25,1424273,671920,516441,235912,1424273
2023-05-07 14:26,1424303,671945,516445,235913,1424303
2023-05-07 14:27,1424334,671976,516445,235913,1424334
2023-05-07 14:28,1424365,671998,516450,235917,1424365
2023-05-07 14:29,1424394,672026,516450,235918,1424394
2023-05-07 14:30,1424427,672052,516456,235919,1424427
2023-05-07 14:31,1424455,672079,516456,235920,1424455
2023-05-07 14:32,1424487,672107,516459,235921,1424487
2023-05-07 14:33,1424516,672136,516459,235921,1424516
2023-05-07 14:34,1424546,672160,516464,235922,1424546
2023-05-07 14:35,1424577,672190,516464,235923,1424577
2023-05-07 14:37,1424606,672211,516471,235924,1424606
2023-05-07 14:38,1424637,672242,516471,235924,1424637
2023-05-07 14:39,1424667,672268,516474,235925,1424667
2023-05-07 14:40,1424697,672298,516474,235925,1424697
2023-05-07 14:41,1424728,672327,516476,235925,1424728
2023-05-07 14:42,1424758,672357,516476,235925,1424758
2023-05-07 14:43,1424789,672384,516479,235926,1424789
2023-05-07 14:44,1424819,672415,516479,235925,1424819
2023-05-07 14:45,1424850,672441,516482,235927,1424850
2023-05-07 14:46,1424880,672470,516482,235928,1424880
2023-05-07 14:47,1424912,672495,516487,235930,1424912
2023-05-07 14:48,1424942,672522,516487,235933,1424942
2023-05-07 14:49,1424972,672546,516492,235934,1424972
2023-05-07 14:50,1425004,672576,516492,235936,1425004
2023-05-07 14:51,1425033,672601,516495,235937,1425033
2023-05-07 14:52,1425064,672631,516495,235938,1425064
2023-05-07 14:53,1425093,672655,516500,235938,1425093
2023-05-07 14:54,1425125,672686,516500,235939,1425125
2023-05-07 14:55,1425155,672711,516504,235940,1425155
2023-05-07 14:56,1425185,672741,516504,235940,1425185
2023-05-07 14:57,1425215,672765,516510,235940,1425215
2023-05-07 14:58,1425247,672796,516510,235941,1425247
2023-05-07 14:59,1425277,672821,516514,235942,1425277
2023-05-07 15:00,1425308,672851,516514,235943,1425308
2023-05-07 15:01,1425344,672885,516515,235944,1425344
2023-05-07 15:02,1425378,672916,516515,235947,1425378
2023-05-07 15:03,1425414,672950,516517,235947,1425414
2023-05-07 15:04,1425450,672986,516517,235947,1425450
2023-05-07 15:05,1425485,673020,516517,235948,1425485
2023-05-07 15:06,1425521,673055,516518,235948,1425521
2023-05-07 15:07,1425556,673088,516518,235950,1425556
2023-05-07 15:08,1425590,673116,516523,235951,1425590
2023-05-07 15:09,1425627,673152,516523,235952,1425627
2023-05-07 15:10,1425660,673183,516524,235953,1425660
2023-05-07 15:11,1425698,673221,516524,235953,1425698
2023-05-07 15:12,1425731,673252,516524,235955,1425731
2023-05-07 15:13,1425768,673288,516524,235956,1425768
2023-05-07 15:14,1425802,673321,516524,235957,1425802
2023-05-07 15:15,1425838,673349,516531,235958,1425838
2023-05-07 15:16,1425874,673383,516531,235960,1425874
2023-05-07 15:17,1425910,673414,516536,235960,1425910
2023-05-07 15:18,1425944,673448,516536,235960,1425944
2023-05-07 15:19,1425980,673483,516537,235960,1425980
2023-05-07 15:20,1426017,673520,516537,235960,1426017
2023-05-07 15:21,1426051,673549,516540,235962,1426051
2023-05-07 15:22,1426086,673583,516540,235963,1426086
2023-05-07 15:23,1426119,673610,516545,235964,1426119
2023-05-07 15:25,1426155,673644,516547,235964,1426155
2023-05-07 15:26,1426191,673679,516547,235965,1426191
2023-05-07 15:27,1426227,673709,516553,235965,1426227
2023-05-07 15:28,1426261,673742,516553,235966,1426261
2023-05-07 15:29,1426296,673768,516560,235968,1426296
2023-05-07 15:30,1426331,673803,516560,235968,1426331
2023-05-07 15:31,1426367,673836,516561,235970,1426367
2023-05-07 15:32,1426403,673872,516561,235970,1426403
2023-05-07 15:33,1426439,673902,516566,235971,1426439
2023-05-07 15:34,1426473,673934,516566,235973,1426473
2023-05-07 15:35,1426509,673963,516572,235974,1426509
2023-05-07 15:36,1426544,673998,516572,235974,1426544
2023-05-07 15:37,1426579,674025,516579,235975,1426579
2023-05-07 15:38,1426613,674058,516579,235976,1426613
2023-05-07 15:39,1426650,674088,516585,235977,1426650
2023-05-07 15:40,1426683,674120,516585,235978,1426683
2023-05-07 15:41,1426720,674154,516586,235980,1426720
2023-05-07 15:42,1426754,674188,516586,235980,1426754
2023-05-07 15:43,1426790,674220,516590,235980,1426790
2023-05-07 15:44,1426825,674252,516590,235983,1426825
2023-05-07 15:45,1426861,674284,516593,235984,1426861
2023-05-07 15:46,1426894,674316,516593,235985,1426894
2023-05-07 15:47,1426931,674346,516599,235986,1426931
2023-05-07 15:48,1426965,674377,516599,235989,1426965
2023-05-07 15:49,1427002,674411,516600,235991,1427002
2023-05-07 15:50,1427036,674445,516600,235991,1427036
2023-05-07 15:51,1427073,674474,516608,235991,1427073
2023-05-07 15:52,1427108,674508,516608,235992,1427108
2023-05-07 15:53,1427142,674534,516613,235995,1427142
2023-05-07 15:54,1427178,674565,516616,235997,1427178
2023-05-07 15:55,1427214,674600,516616,235998,1427214
2023-05-07 15:56,1427248,674628,516622,235998,1427248
2023-05-07 15:57,1427285,674662,516624,235999,1427285
2023-05-07 15:58,1427318,674694,516624,236000,1427318
2023-05-07 15:59,1427356,674725,516630,236001,1427356
2023-05-07 16:00,1427379,674747,516630,236002,1427379
2023-05-07 16:01,1427401,674768,516631,236002,1427401
2023-05-07 16:02,1427421,674788,516631,236002,1427421
2023-05-07 16:03,1427441,674804,516636,236001,1427441
2023-05-07 16:04,1427462,674823,516636,236003,1427462
2023-05-07 16:05,1427484,674836,516644,236004,1427484
2023-05-07 16:06,1427504,674854,516644,236006,1427504
2023-05-07 16:07,1427525,674872,516647,236006,1427525
2023-05-07 16:08,1427544,674886,516651,236007,1427544
2023-05-07 16:09,1427565,674905,516651,236009,1427565
2023-05-07 16:10,1427585,674919,516656,236010,1427585
2023-05-07 16:12,1427606,674938,516656,236012,1427606
2023-05-07 16:13,1427626,674953,516660,236013,1427626
2023-05-07 16:14,1427647,674970,516660,236017,1427647
2023-05-07 16:15,1427667,674985,516665,236017,1427667
2023-05-07 16:16,1427687,675004,516665,236018,1427687
2023-05-07 16:17,1427709,675022,516667,236020,1427709
2023-05-07 16:18,1427729,675042,516667,236020,1427729
2023-05-07 16:19,1427750,675056,516672,236022,1427750
2023-05-07 16:20,1427771,675071,516677,236023,1427771
2023-05-07 16:21,1427793,675093,516677,236023,1427793
2023-05-07 16:22,1427813,675102,516685,236026,1427813
2023-05-07 16:23,1427833,675116,516689,236028,1427833
2023-05-07 16:24,1427854,675137,516689,236028,1427854
2023-05-07 16:25,1427876,675156,516692,236028,1427876
2023-05-07 16:26,1427895,675173,516692,236030,1427895
2023-05-07 16:27,1427917,675188,516697,236032,1427917
2023-05-07 16:28,1427938,675208,516697,236033,1427938
2023-05-07 16:29,1427958,675221,516704,236033,1427958
2023-05-07 16:30,1427978,675240,516704,236034,1427978
2023-05-07 16:31,1427998,675251,516711,236036,1427998
2023-05-07 16:32,1428018,675271,516711,236036,1428018
2023-05-07 16:33,1428038,675289,516713,236036,1428038
2023-05-07 16:34,1428059,675309,516713,236037,1428059
2023-05-07 16:35,1428081,675322,516722,236037,1428081
2023-05-07 16:36,1428102,675341,516722,236039,1428102
2023-05-07 16:37,1428123,675358,516725,236040,1428123
2023-05-07 16:38,1428143,675378,516725,236040,1428143
2023-05-07 16:39,1428164,675393,516730,236041,1428164
2023-05-07 16:40,1428184,675412,516730,236042,1428184
2023-05-07 16:41,1428204,675428,516732,236044,1428204
2023-05-07 16:42,1428224,675446,516732,236046,1428224
2023-05-07 16:43,1428245,675458,516739,236048,1428245
2023-05-07 16:44,1428265,675477,516739,236049,1428265
2023-05-07 16:45,1428286,675492,516745,236049,1428286
2023-05-07 16:46,1428306,675510,516745,236051,1428306
2023-05-07 16:47,1428327,675528,516748,236051,1428327
2023-05-07 16:48,1428348,675547,516748,236053,1428348
2023-05-07 16:49,1428368,675558,516756,236054,1428368
2023-05-07 16:50,1428389,675577,516756,236056,1428389
2023-05-07 16:51,1428409,675594,516758,236057,1428409
2023-05-07 16:52,1428430,675615,516758,236057,1428430
2023-05-07 16:53,1428450,675630,516763,236057,1428450
2023-05-07 16:54,1428470,675648,516763,236059,1428470
2023-05-07 16:55,1428491,675667,516765,236059,1428491
2023-05-07 16:56,1428512,675688,516765,236059,1428512
2023-05-07 16:57,1428532,675700,516772,236060,1428532
2023-05-07 16:59,1428552,675717,516774,236061,1428552
2023-05-07 17:00,1428573,675732,516780,236061,1428573
2023-05-07 17:01,1428585,675744,516780,236061,1428585
2023-05-07 17:02,1428595,675748,516787,236060,1428595
2023-05-07 17:03,1428604,675757,516787,236060,1428604
2023-05-07 17:04,1428614,675761,516792,236061,1428614
2023-05-07 17:05,1428625,675772,516792,236061,1428625
2023-05-07 17:06,1428634,675775,516798,236061,1428634
2023-05-07 17:07,1428646,675786,516798,236062,1428646
2023-05-07 17:08,1428655,675792,516799,236064,1428655
2023-05-07 17:09,1428665,675800,516799,236066,1428665
2023-05-07 17:10,1428675,675802,516806,236067,1428675
2023-05-07 17:11,1428686,675812,516807,236067,1428686
2023-05-07 17:12,1428696,675821,516807,236068,1428696
2023-05-07 17:13,1428706,675828,516807,236071,1428706
2023-05-07 17:14,1428716,675837,516807,236072,1428716
2023-05-07 17:15,1428726,675846,516807,236073,1428726
2023-05-07 17:16,1428736,675856,516807,236073,1428736
2023-05-07 17:17,1428746,675865,516807,236074,1428746
2023-05-07 17:18,1428756,675872,516807,236077,1428756
2023-05-07 17:19,1428766,675879,516807,236080,1428766
2023-05-07 17:20,1428777,675864,516833,236080,1428777
2023-05-07 17:21,1428786,675873,516833,236080,1428786
2023-05-07 17:22,1428796,675875,516840,236081,1428796
2023-05-07 17:23,1428807,675884,516840,236083,1428807
2023-05-07 17:24,1428818,675888,516847,236083,1428818
2023-05-07 17:25,1428828,675893,516850,236085,1428828
2023-05-07 17:26,1428838,675903,516850,236085,1428838
2023-05-07 17:27,1428847,675904,516858,236085,1428847
2023-05-07 17:28,1428857,675912,516858,236087,1428857
2023-05-07 17:29,1428866,675909,516869,236088,1428866
2023-05-07 17:30,1428876,675918,516869,236089,1428876
2023-05-07 17:31,1428886,675920,516875,236091,1428886
2023-05-07 17:32,1428895,675929,516875,236091,1428895
2023-05-07 17:33,1428905,675932,516882,236091,1428905
2023-05-07 17:34,1428915,675938,516886,236091,1428915
2023-05-07 17:35,1428926,675947,516886,236093,1428926
2023-05-07 17:36,1428936,675955,516887,236094,1428936
2023-05-07 17:37,1428946,675964,516887,236095,1428946
2023-05-07 17:38,1428956,675967,516894,236095,1428956
2023-05-07 17:39,1428967,675976,516894,236097,1428967
2023-05-07 17:40,1428976,675981,516897,236098,1428976
2023-05-07 17:41,1428986,675987,516897,236102,1428986
2023-05-07 17:42,1428996,675986,516906,236104,1428996
2023-05-07 17:43,1429005,675994,516906,236105,1429005
2023-05-07 17:44,1429015,676000,516908,236107,1429015
2023-05-07 17:46,1429025,676009,516908,236108,1429025
2023-05-07 17:47,1429035,676016,516911,236108,1429035
2023-05-07 17:48,1429044,676023,516913,236108,1429044
2023-05-07 17:49,1429054,676033,516913,236108,1429054
2023-05-07 17:50,1429064,676034,516921,236109,1429064
2023-05-07 17:51,1429074,676044,516921,236109,1429074
2023-05-07 17:52,1429083,676050,516922,236111,1429083
2023-05-07 17:53,1429093,676057,516922,236114,1429093
2023-05-07 17:54,1429104,676062,516928,236114,1429104
2023-05-07 17:55,1429114,676071,516928,236115,1429114
2023-05-07 17:56,1429124,676078,516931,236115,1429124
2023-05-07 17:57,1429134,676087,516931,236116,1429134
2023-05-07 17:58,1429144,676090,516937,236117,1429144
2023-05-07 17:59,1429154,676098,516938,236118,1429154
2023-05-07 18:00,1429166,676109,516938,236119,1429166
2023-05-07 18:01,1429185,676119,516946,236120,1429185
2023-05-07 18:02,1429204,676137,516946,236121,1429204
2023-05-07 18:03,1429223,676151,516946,236126,1429223
2023-05-07 18:04,1429243,676162,516956,236125,1429243
2023-05-07 18:05,1429261,676179,516956,236126,1429261
2023-05-07 18:06,1429280,676192,516960,236128,1429280
2023-05-07 18:07,1429299,676211,516960,236128,1429299
2023-05-07 18:08,1429318,676228,516962,236128,1429318
2023-05-07 18:09,1429336,676243,516965,236128,1429336
2023-05-07 18:10,1429357,676264,516965,236128,1429357
2023-05-07 18:11,1429375,676276,516970,236129,1429375
2023-05-07 18:12,1429393,676294,516970,236129,1429393
2023-05-07 18:13,1429412,676302,516980,236130,1429412
2023-05-07 18:14,1429433,676321,516980,236132,1429433
2023-05-07 18:15,1429453,676337,516983,236133,1429453
2023-05-07 18:16,1429471,676353,516983,236135,1429471
2023-05-07 18:17,1429491,676371,516985,236135,1429491
2023-05-07 18:18,1429511,676385,516985,236141,1429511
2023-05-07 18:19,1429530,676401,516988,236141,1429530
2023-05-07 18:20,1429549,676417,516988,236144,1429549
2023-05-07 18:21,1429567,676430,516992,236145,1429567
2023-05-07 18:22,1429587,676449,516992,236146,1429587
2023-05-07 18:23,1429605,676464,516994,236147,1429605
2023-05-07 18:24,1429624,676480,516997,236147,1429624
2023-05-07 18:25,1429644,676498,516997,236149,1429644
2023-05-07 18:26,1429663,676507,517006,236150,1429663
2023-05-07 18:27,1429682,676526,517006,236150,1429682
2023-05-07 18:28,1429701,676544,517007,236150,1429701
2023-05-07 18:29,1429719,676560,517008,236151,1429719
2023-05-07 18:30,1429739,676580,517008,236151,1429739
2023-05-07 18:31,1429758,676598,517009,236151,1429758
2023-05-07 18:33,1429777,676616,517009,236152,1429777
2023-05-07 18:34,1429798,676634,517012,236152,1429798
2023-05-07 18:35,1429816,676651,517012,236153,1429816
2023-05-07 18:36,1429835,676662,517017,236156,1429835
2023-05-07 18:37,1429855,676681,517017,236157,1429855
2023-05-07 18:38,1429874,676694,517022,236158,1429874
2023-05-07 18:39,1429892,676712,517022,236158,1429892
2023-05-07 18:40,1429910,676728,517024,236158,1429910
2023-05-07 18:41,1429931,676749,517024,236158,1429931
2023-05-07 18:42,1429950,676764,517028,236158,1429950
2023-05-07 18:43,1429968,676780,517030,236158,1429968
2023-05-07 18:44,1429988,676797,517030,236161,1429988
2023-05-07 18:45,1430007,676812,517033,236162,1430007
2023-05-07 18:46,1430025,676829,517033,236163,1430025
2023-05-07 18:47,1430043,676844,517036,236163,1430043
2023-05-07 18:48,1430063,676864,517036,236163,1430063
2023-05-07 18:49,1430083,676877,517041,236165,1430083
2023-05-07 18:50,1430102,676896,517041,236165,1430102
2023-05-07 18:51,1430121,676910,517045,236166,1430121
2023-05-07 18:52,1430139,676926,517045,236168,1430139
2023-05-07 18:53,1430159,676941,517049,236169,1430159
2023-05-07 18:54,1430177,676956,517049,236172,1430177
2023-05-07 18:55,1430197,676972,517051,236174,1430197
2023-05-07 18:56,1430215,676986,517051,236178,1430215
2023-05-07 18:57,1430234,677003,517052,236179,1430234
2023-05-07 18:58,1430254,677022,517052,236180,1430254
2023-05-07 18:59,1430272,677036,517054,236182,1430272
2023-05-07 19:00,1430294,677058,517054,236182,1430294
2023-05-07 19:01,1430312,677068,517061,236183,1430312
2023-05-07 19:02,1430333,677083,517066,236184,1430333
2023-05-07 19:03,1430353,677100,517066,236187,1430353
2023-05-07 19:04,1430372,677117,517068,236187,1430372
2023-05-07 19:05,1430393,677137,517068,236188,1430393
2023-05-07 19:06,1430413,677149,517072,236192,1430413
2023-05-07 19:07,1430435,677168,517074,236193,1430435
2023-05-07 19:08,1430454,677186,517074,236194,1430454
2023-05-07 19:09,1430475,677206,517074,236195,1430475
2023-05-07 19:10,1430495,677225,517074,236196,1430495
2023-05-07 19:11,1430516,677246,517074,236196,1430516
2023-05-07 19:12,1430535,677265,517074,236196,1430535
2023-05-07 19:13,1430556,677285,517074,236197,1430556
2023-05-07 19:14,1430576,677304,517074,236198,1430576
2023-05-07 19:15,1430595,677323,517074,236198,1430595
2023-05-07 19:16,1430615,677342,517074,236199,1430615
2023-05-07 19:17,1430636,677344,517093,236199,1430636
2023-05-07 19:18,1430656,677363,517093,236200,1430656
2023-05-07 19:19,1430675,677382,517093,236200,1430675
2023-05-07 19:21,1430696,677403,517093,236200,1430696
2023-05-07 19:22,1430717,677424,517093,236200,1430717
2023-05-07 19:23,1430738,677444,517093,236201,1430738
2023-05-07 19:24,1430759,677465,517093,236201,1430759
2023-05-07 19:25,1430779,677482,517093,236204,1430779
2023-05-07 19:26,1430800,677502,517093,236205,1430800
2023-05-07 19:27,1430820,677520,517093,236207,1430820
2023-05-07 19:28,1430840,677518,517115,236207,1430840
2023-05-07 19:29,1430860,677537,517115,236208,1430860
2023-05-07 19:30,1430881,677549,517122,236210,1430881
2023-05-07 19:31,1430901,677569,517122,236210,1430901
2023-05-07 19:32,1430921,677586,517124,236211,1430921
2023-05-07 19:33,1430940,677605,517124,236211,1430940
2023-05-07 19:34,1430960,677622,517127,236211,1430960
2023-05-07 19:35,1430980,677642,517127,236211,1430980
2023-05-07 19:36,1431000,677654,517135,236211,1431000
2023-05-07 19:37,1431021,677675,517135,236211,1431021
2023-05-07 19:38,1431041,677694,517136,236211,1431041
2023-05-07 19:39,1431061,677712,517137,236212,1431061
2023-05-07 19:40,1431081,677731,517137,236213,1431081
2023-05-07 19:41,1431102,677750,517139,236213,1431102
2023-05-07 19:42,1431121,677768,517139,236214,1431121
2023-05-07 19:43,1431142,677784,517144,236214,1431142
2023-05-07 19:44,1431162,677803,517144,236215,1431162
2023-05-07 19:45,1431181,677817,517149,236215,1431181
2023-05-07 19:46,1431202,677838,517149,236215,1431202
2023-05-07 19:47,1431222,677853,517154,236215,1431222
2023-05-07 19:48,1431243,677873,517154,236216,1431243
2023-05-07 19:49,1431262,677888,517158,236216,1431262
2023-05-07 19:50,1431284,677909,517158,236217,1431284
2023-05-07 19:51,1431304,677925,517161,236218,1431304
2023-05-07 19:52,1431325,677944,517162,236219,1431325
2023-05-07 19:53,1431344,677957,517167,236220,1431344
2023-05-07 19:54,1431364,677977,517167,236220,1431364
2023-05-07 19:55,1431384,677990,517174,236220,1431384
2023-05-07 19:56,1431405,678010,517175,236220,1431405
2023-05-07 19:57,1431425,678028,517175,236222,1431425
2023-05-07 19:58,1431445,678044,517178,236223,1431445
2023-05-07 19:59,1431465,678064,517178,236223,1431465
2023-05-07 20:00,1431482,678080,517178,236224,1431482
2023-05-07 20:01,1431498,678096,517178,236224,1431498
2023-05-07 20:02,1431513,678108,517181,236224,1431513
2023-05-07 20:03,1431529,678124,517181,236224,1431529
2023-05-07 20:04,1431545,678135,517183,236227,1431545
2023-05-07 20:05,1431561,678151,517183,236227,1431561
2023-05-07 20:06,1431576,678158,517189,236229,1431576
2023-05-07 20:07,1431592,678174,517189,236229,1431592
2023-05-07 20:09,1431608,678188,517190,236230,1431608
2023-05-07 20:10,1431624,678204,517190,236230,1431624
2023-05-07 20:11,1431640,678212,517195,236233,1431640
2023-05-07 20:12,1431655,678226,517195,236234,1431655
2023-05-07 20:13,1431671,678240,517195,236236,1431671
2023-05-07 20:14,1431686,678255,517195,236236,1431686
2023-05-07 20:15,1431702,678266,517199,236237,1431702
2023-05-07 20:16,1431718,678282,517199,236237,1431718
2023-05-07 20:17,1431733,678295,517201,236237,1431733
2023-05-07 20:18,1431749,678310,517201,236238,1431749
2023-05-07 20:19,1431765,678321,517205,236239,1431765
2023-05-07 20:20,1431781,678336,517205,236240,1431781
2023-05-07 20:21,1431796,678349,517207,236240,1431796
2023-05-07 20:22,1431813,678366,517207,236240,1431813
2023-05-07 20:23,1431828,678378,517210,236240,1431828
2023-05-07 20:24,1431844,678394,517210,236240,1431844
2023-05-07 20:25,1431860,678405,517214,236241,1431860
2023-05-07 20:26,1431875,678419,517214,236242,1431875
2023-05-07 20:27,1431890,678431,517216,236243,1431890
2023-05-07 20:28,1431906,678449,517216,236241,1431906
2023-05-07 20:29,1431922,678463,517218,236241,1431922
2023-05-07 20:30,1431937,678477,517218,236242,1431937
2023-05-07 20:31,1431953,678485,517222,236246,1431953
2023-05-07 20:32,1431968,678500,517222,236246,1431968
2023-05-07 20:33,1431984,678514,517224,236246,1431984
2023-05-07 20:34,1431999,678529,517224,236246,1431999
2023-05-07 20:35,1432015,678540,517228,236247,1432015
2023-05-07 20:36,1432031,678554,517228,236249,1432031
2023-05-07 20:37,1432046,678560,517233,236253,1432046
2023-05-07 20:38,1432062,678576,517233,236253,1432062
2023-05-07 20:39,1432078,678587,517237,236254,1432078
2023-05-07 20:40,1432093,678602,517237,236254,1432093
2023-05-07 20:41,1432109,678614,517241,236254,1432109
2023-05-07 20:42,1432124,678628,517241,236255,1432124
2023-05-07 20:43,1432140,678642,517243,236255,1432140
2023-05-07 20:44,1432156,678657,517243,236256,1432156
2023-05-07 20:45,1432171,678671,517243,236257,1432171
2023-05-07 20:46,1432187,678686,517243,236258,1432187
2023-05-07 20:47,1432203,678694,517249,236260,1432203
2023-05-07 20:48,1432218,678708,517249,236261,1432218
2023-05-07 20:49,1432233,678714,517258,236261,1432233
2023-05-07 20:50,1432249,678727,517258,236264,1432249
2023-05-07 20:51,1432264,678741,517259,236264,1432264
2023-05-07 20:52,1432280,678756,517259,236265,1432280
2023-05-07 20:53,1432296,678767,517264,236265,1432296
2023-05-07 20:54,1432313,678784,517264,236265,1432313
2023-05-07 20:55,1432328,678793,517270,236265,1432328
2023-05-07 20:57,1432344,678808,517270,236266,1432344
2023-05-07 20:58,1432359,678821,517272,236266,1432359
2023-05-07 20:59,1432376,678838,517272,236266,1432376
2023-05-07 21:00,1432392,678849,517277,236266,1432392
2023-05-07 21:01,1432430,678887,517277,236266,1432430
2023-05-07 21:02,1432468,678920,517281,236267,1432468
2023-05-07 21:03,1432509,678959,517281,236269,1432509
2023-05-07 21:04,1432547,678992,517286,236269,1432547
2023-05-07 21:05,1432584,679029,517286,236269,1432584
2023-05-07 21:06,1432621,679062,517289,236270,1432621
2023-05-07 21:07,1432660,679101,517289,236270,1432660
2023-05-07 21:08,1432698,679131,517296,236271,1432698
2023-05-07 21:09,1432738,679169,517296,236273,1432738
2023-05-07 21:10,1432777,679203,517301,236273,1432777
2023-05-07 21:11,1432816,679242,517301,236273,1432816
2023-05-07 21:12,1432854,679280,517302,236272,1432854
2023-05-07 21:13,1432894,679319,517302,236273,1432894
2023-05-07 21:14,1432933,679355,517305,236273,1432933
2023-05-07 21:15,1432970,679391,517305,236274,1432970
2023-05-07 21:16,1433008,679423,517310,236275,1433008
2023-05-07 21:17,1433048,679462,517310,236276,1433048
2023-05-07 21:18,1433084,679497,517311,236276,1433084
2023-05-07 21:19,1433126,679536,517311,236279,1433126
2023-05-07 21:20,1433162,679569,517313,236280,1433162
2023-05-07 21:21,1433201,679606,517315,236280,1433201
2023-05-07 21:22,1433241,679645,517315,236281,1433241
2023-05-07 21:23,1433280,679679,517319,236282,1433280
2023-05-07 21:24,1433316,679713,517319,236284,1433316
2023-05-07 21:25,1433355,679751,517320,236284,1433355
2023-05-07 21:26,1433395,679790,517320,236285,1433395
2023-05-07 21:27,1433434,679824,517325,236285,1433434
2023-05-07 21:28,1433470,679860,517325,236285,1433470
2023-05-07 21:29,1433511,679898,517328,236285,1433511
2023-05-07 21:30,1433548,679934,517328,236286,1433548
2023-05-07 21:31,1433588,679967,517334,236287,1433588
2023-05-07 21:32,1433625,680004,517334,236287,1433625
2023-05-07 21:33,1433663,680037,517339,236287,1433663
2023-05-07 21:34,1433703,680076,517339,236288,1433703
2023-05-07 21:35,1433739,680108,517343,236288,1433739
2023-05-07 21:36,1433778,680146,517343,236289,1433778
2023-05-07 21:37,1433818,680184,517345,236289,1433818
2023-05-07 21:38,1433856,680221,517345,236290,1433856
2023-05-07 21:39,1433893,680254,517349,236290,1433893
2023-05-07 21:40,1433931,680290,517349,236292,1433931
2023-05-07 21:41,1433970,680323,517353,236294,1433970
2023-05-07 21:42,1434010,680362,517353,236295,1434010
2023-05-07 21:43,1434049,680396,517357,236296,1434049
2023-05-07 21:45,1434087,680434,517357,236296,1434087
2023-05-07 21:46,1434126,680467,517362,236297,1434126
2023-05-07 21:47,1434164,680505,517362,236297,1434164
2023-05-07 21:48,1434202,680535,517365,236302,1434202
2023-05-07 21:49,1434240,680570,517365,236305,1434240
2023-05-07 21:50,1434278,680598,517373,236307,1434278
2023-05-07 21:51,1434319,680638,517373,236308,1434319
2023-05-07 21:52,1434355,680673,517374,236308,1434355
2023-05-07 21:53,1434396,680714,517374,236308,1434396
2023-05-07 21:54,1434432,680751,517373,236308,1434432
2023-05-07 21:55,1434470,680788,517373,236309,1434470
2023-05-07 21:56,1434509,680819,517378,236312,1434509
2023-05-07 21:57,1434549,680857,517378,236314,1434549
2023-05-07 21:58,1434587,680892,517381,236314,1434587
2023-05-07 21:59,1434626,680927,517384,236315,1434626
2023-05-07 22:00,1434661,680961,517384,236316,1434661
2023-05-07 22:01,1434691,680986,517388,236317,1434691
2023-05-07 22:02,1434718,681013,517388,236317,1434718
2023-05-07 22:03,1434748,681039,517391,236318,1434748
2023-05-07 22:04,1434777,681066,517392,236319,1434777
2023-05-07 22:05,1434805,681092,517392,236321,1434805
2023-05-07 22:06,1434835,681114,517400,236321,1434835
2023-05-07 22:07,1434864,681143,517400,236321,1434864
2023-05-07 22:08,1434894,681169,517403,236322,1434894
2023-05-07 22:09,1434922,681196,517403,236323,1434922
2023-05-07 22:10,1434952,681220,517409,236323,1434952
2023-05-07 22:11,1434981,681249,517409,236323,1434981
2023-05-07 22:12,1435010,681271,517412,236327,1435010
2023-05-07 22:13,1435041,681302,517412,236327,1435041
2023-05-07 22:14,1435069,681321,517421,236327,1435069
2023-05-07 22:15,1435096,681345,517424,236327,1435096
2023-05-07 22:16,1435125,681369,517427,236329,1435125
2023-05-07 22:17,1435154,681395,517427,236332,1435154
2023-05-07 22:18,1435183,681418,517430,236335,1435183
2023-05-07 22:19,1435211,681440,517433,236338,1435211
2023-05-07 22:20,1435240,681468,517433,236339,1435240
2023-05-07 22:21,1435269,681496,517433,236340,1435269
2023-05-07 22:22,1435300,681526,517433,236341,1435300
2023-05-07 22:23,1435329,681555,517433,236341,1435329
2023-05-07 22:24,1435358,681583,517433,236342,1435358
2023-05-07 22:25,1435388,681613,517433,236342,1435388
2023-05-07 22:26,1435417,681642,517433,236342,1435417
2023-05-07 22:27,1435446,681669,517433,236344,1435446
2023-05-07 22:28,1435473,681671,517458,236344,1435473
2023-05-07 22:29,1435503,681701,517458,236344,1435503
2023-05-07 22:30,1435532,681726,517462,236344,1435532
2023-05-07 22:32,1435559,681751,517462,236346,1435559
2023-05-07 22:33,1435588,681770,517472,236346,1435588
2023-05-07 22:34,1435618,681796,517472,236350,1435618
2023-05-07 22:35,1435649,681824,517475,236350,1435649
2023-05-07 22:36,1435675,681846,517475,236354,1435675
2023-05-07 22:37,1435705,681868,517483,236354,1435705
2023-05-07 22:38,1435733,681894,517483,236356,1435733
2023-05-07 22:39,1435763,681922,517486,236355,1435763
2023-05-07 22:40,1435791,681950,517486,236355,1435791
2023-05-07 22:41,1435819,681972,517491,236356,1435819
2023-05-07 22:42,1435849,682001,517491,236357,1435849
2023-05-07 22:43,1435878,682022,517499,236357,1435878
2023-05-07 22:44,1435908,682052,517499,236357,1435908
2023-05-07 22:45,1435937,682074,517503,236360,1435937
2023-05-07 22:46,1435965,682101,517503,236361,1435965
2023-05-07 22:47,1435993,682123,517508,236362,1435993
2023-05-07 22:48,1436023,682153,517508,236362,1436023
2023-05-07 22:49,1436051,682177,517510,236364,1436051
2023-05-07 22:50,1436081,682206,517510,236365,1436081
2023-05-07 22:51,1436111,682230,517514,236367,1436111
2023-05-07 22:52,1436137,682253,517515,236369,1436137
2023-05-07 22:53,1436168,682283,517515,236370,1436168
2023-05-07 22:54,1436197,682304,517522,236371,1436197
2023-05-07 22:55,1436226,682332,517522,236372,1436226
2023-05-07 22:56,1436257,682353,517531,236373,1436257
2023-05-07 22:57,1436285,682381,517531,236373,1436285
2023-05-07 22:58,1436313,682403,517536,236374,1436313
2023-05-07 22:59,1436344,682434,517536,236374,1436344
2023-05-07 23:00,1436371,682456,517541,236374,1436371
2023-05-07 23:01,1436395,682478,517541,236376,1436395
2023-05-07 23:02,1436419,682492,517550,236377,1436419
2023-05-07 23:03,1436444,682517,517550,236377,1436444
2023-05-07 23:04,1436468,682534,517557,236377,1436468
2023-05-07 23:05,1436492,682558,517557,236377,1436492
2023-05-07 23:06,1436516,682579,517559,236378,1436516
2023-05-07 23:07,1436540,682600,517561,236379,1436540
2023-05-07 23:08,1436565,682624,517561,236380,1436565
2023-05-07 23:09,1436590,682640,517568,236382,1436590
2023-05-07 23:10,1436613,682660,517568,236385,1436613
2023-05-07 23:11,1436637,682678,517573,236386,1436637
2023-05-07 23:12,1436662,682701,517573,236388,1436662
2023-05-07 23:13,1436687,682719,517579,236389,1436687
2023-05-07 23:14,1436710,682741,517579,236390,1436710
2023-05-07 23:15,1436734,682762,517581,236391,1436734
2023-05-07 23:16,1436758,682786,517581,236391,1436758
2023-05-07 23:17,1436784,682800,517591,236393,1436784
2023-05-07 23:19,1436807,682822,517591,236394,1436807
2023-05-07 23:20,1436832,682845,517592,236395,1436832
2023-05-07 23:21,1436859,682871,517592,236396,1436859
2023-05-07 23:22,1436882,682887,517596,236399,1436882
2023-05-07 23:23,1436907,682911,517596,236400,1436907
2023-05-07 23:24,1436930,682932,517598,236400,1436930
2023-05-07 23:25,1436955,682956,517598,236401,1436955
2023-05-07 23:26,1436980,682976,517603,236401,1436980
2023-05-07 23:27,1437005,683000,517603,236402,1437005
2023-05-07 23:28,1437029,683013,517612,236404,1437029
2023-05-07 23:29,1437055,683037,517612,236406,1437055
2023-05-07 23:30,1437079,683052,517619,236408,1437079
2023-05-07 23:31,1437105,683076,517619,236410,1437105
2023-05-07 23:32,1437128,683090,517626,236412,1437128
2023-05-07 23:33,1437153,683114,517626,236413,1437153
2023-05-07 23:34,1437178,683130,517635,236413,1437178
2023-05-07 23:35,1437202,683149,517635,236418,1437202
2023-05-07 23:36,1437228,683169,517641,236418,1437228
2023-05-07 23:37,1437252,683192,517641,236419,1437252
2023-05-07 23:38,1437277,683208,517648,236421,1437277
2023-05-07 23:39,1437301,683231,517648,236422,1437301
2023-05-07 23:40,1437327,683251,517653,236423,1437327
2023-05-07 23:41,1437351,683275,517653,236423,1437351
2023-05-07 23:42,1437376,683297,517655,236424,1437376
2023-05-07 23:43,1437400,683316,517658,236426,1437400
2023-05-07 23:44,1437424,683334,517663,236427,1437424
2023-05-07 23:45,1437449,683359,517663,236427,1437449
2023-05-07 23:46,1437473,683377,517669,236427,1437473
2023-05-07 23:47,1437497,683400,517669,236428,1437497
2023-05-07 23:48,1437521,683418,517674,236429,1437521
2023-05-07 23:49,1437545,683441,517674,236430,1437545
2023-05-07 23:50,1437569,683461,517678,236430,1437569
2023-05-07 23:51,1437593,683483,517678,236432,1437593
2023-05-07 23:52,1437618,683507,517679,236432,1437618
2023-05-07 23:53,1437642,683529,517681,236432,1437642
2023-05-07 23:54,1437667,683551,517681,236435,1437667
2023-05-07 23:55,1437691,683572,517684,236435,1437691
2023-05-07 23:56,1437715,683596,517684,236435,1437715
2023-05-07 23:57,1437739,683614,517690,236435,1437739
2023-05-07 23:58,1437763,683638,517690,236435,1437763
2023-05-07 23:59,1437787,683656,517695,236436,1437787
2023-05-08 00:00,1437806,683670,517699,236437,1437806
2023-05-08 00:01,1437824,683688,517699,236437,1437824
2023-05-08 00:02,1437842,683700,517703,236439,1437842
2023-05-08 00:03,1437859,683717,517703,236439,1437859
2023-05-08 00:04,1437877,683729,517708,236440,1437877
2023-05-08 00:06,1437895,683746,517708,236441,1437895
2023-05-08 00:07,1437913,683753,517718,236442,1437913
2023-05-08 00:08,1437930,683770,517718,236442,1437930
2023-05-08 00:09,1437949,683783,517723,236443,1437949
2023-05-08 00:10,1437966,683798,517723,236445,1437966
2023-05-08 00:11,1437985,683808,517732,236445,1437985
2023-05-08 00:12,1438002,683824,517732,236446,1438002
2023-05-08 00:13,1438021,683839,517734,236448,1438021
2023-05-08 00:14,1438038,683853,517734,236451,1438038
2023-05-08 00:15,1438056,683867,517737,236452,1438056
2023-05-08 00:16,1438075,683884,517737,236454,1438075
2023-05-08 00:17,1438092,683897,517740,236455,1438092
2023-05-08 00:18,1438109,683913,517740,236456,1438109
2023-05-08 00:19,1438128,683929,517743,236456,1438128
2023-05-08 00:20,1438145,683946,517743,236456,1438145
2023-05-08 00:21,1438162,683962,517744,236456,1438162
2023-05-08 00:22,1438180,683978,517744,236458,1438180
2023-05-08 00:23,1438199,683992,517748,236459,1438199
2023-05-08 00:24,1438218,684011,517748,236459,1438218
2023-05-08 00:25,1438235,684020,517753,236462,1438235
2023-05-08 00:26,1438253,684038,517753,236462,1438253
2023-05-08 00:27,1438271,684050,517758,236463,1438271
2023-05-08 00:28,1438290,684069,517758,236463,1438290
2023-05-08 00:29,1438307,684078,517761,236468,1438307
2023-05-08 00:30,1438326,684097,517761,236468,1438326
2023-05-08 00:31,1438343,684111,517764,236468,1438343
2023-05-08 00:32,1438361,684127,517764,236470,1438361
2023-05-08 00:33,1438378,684140,517767,236471,1438378
2023-05-08 00:34,1438397,684158,517767,236472,1438397
2023-05-08 00:35,1438413,684167,517774,236472,1438413
2023-05-08 00:36,1438432,684186,517774,236472,1438432
2023-05-08 00:37,1438450,684201,517777,236472,1438450
2023-05-08 00:38,1438467,684218,517777,236472,1438467
2023-05-08 00:39,1438485,684235,517777,236473,1438485
2023-05-08 00:40,1438502,684251,517777,236474,1438502
2023-05-08 00:41,1438521,684269,517777,236475,1438521
2023-05-08 00:42,1438539,684286,517777,236476,1438539
2023-05-08 00:43,1438558,684305,517777,236476,1438558
2023-05-08 00:44,1438578,684325,517777,236476,1438578
2023-05-08 00:45,1438595,684341,517777,236477,1438595
2023-05-08 00:46,1438612,684358,517777,236477,1438612
2023-05-08 00:47,1438631,684359,517795,236477,1438631
2023-05-08 00:48,1438648,684376,517795,236477,1438648
2023-05-08 00:49,1438665,684386,517802,236477,1438665
2023-05-08 00:50,1438684,684403,517802,236479,1438684
2023-05-08 00:51,1438702,684413,517809,236480,1438702
2023-05-08 00:52,1438720,684427,517809,236484,1438720
2023-05-08 00:54,1438737,684440,517813,236484,1438737
2023-05-08 00:55,1438756,684458,517813,236485,1438756
2023-05-08 00:56,1438774,684468,517820,236486,1438774
2023-05-08 00:57,1438792,684485,517820,236487,1438792
2023-05-08 00:58,1438810,684500,517822,236488,1438810
2023-05-08 00:59,1438829,684518,517822,236489,1438829
2023-05-08 01:00,1438845,684531,517825,236489,1438845
2023-05-08 01:01,1438857,684542,517825,236490,1438857
2023-05-08 01:02,1438869,684555,517825,236489,1438869
2023-05-08 01:03,1438881,684563,517829,236489,1438881
2023-05-08 01:04,1438893,684575,517829,236489,1438893
2023-05-08 01:05,1438905,684584,517832,236489,1438905
2023-05-08 01:06,1438917,684596,517832,236489,1438917
2023-05-08 01:07,1438929,684606,517834,236489,1438929
2023-05-08 01:08,1438941,684617,517834,236490,1438941
2023-05-08 01:09,1438953,684623,517839,236491,1438953
2023-05-08 01:10,1438965,684635,517839,236491,1438965
2023-05-08 01:11,1438978,684645,517842,236491,1438978
2023-05-08 01:12,1438989,684655,517843,236491,1438989
2023-05-08 01:13,1439002,684668,517843,236491,1439002
2023-05-08 01:14,1439013,684671,517850,236492,1439013
2023-05-08 01:15,1439025,684683,517850,236492,1439025
2023-05-08 01:16,1439037,684692,517853,236492,1439037
2023-05-08 01:17,1439049,684704,517853,236492,1439049
2023-05-08 01:18,1439061,684713,517856,236492,1439061
2023-05-08 01:19,1439073,684725,517856,236492,1439073
2023-05-08 01:20,1439084,684734,517857,236493,1439084
2023-05-08 01:21,1439096,684746,517857,236493,1439096
2023-05-08 01:22,1439108,684753,517862,236493,1439108
2023-05-08 01:23,1439119,684764,517862,236493,1439119
2023-05-08 01:24,1439132,684775,517864,236493,1439132
2023-05-08 01:25,1439144,684787,517864,236493,1439144
2023-05-08 01:26,1439157,684799,517865,236493,1439157
2023-05-08 01:27,1439168,684810,517865,236493,1439168
2023-05-08 01:28,1439180,684821,517866,236493,1439180
2023-05-08 01:29,1439192,684833,517866,236493,1439192
2023-05-08 01:30,1439204,684842,517869,236493,1439204
2023-05-08 01:31,1439216,684854,517869,236493,1439216
2023-05-08 01:32,1439228,684864,517871,236493,1439228
2023-05-08 01:33,1439239,684874,517871,236494,1439239
2023-05-08 01:34,1439251,684881,517876,236494,1439251
2023-05-08 01:35,1439263,684893,517876,236494,1439263
2023-05-08 01:36,1439275,684904,517877,236494,1439275
2023-05-08 01:37,1439287,684916,517877,236494,1439287
2023-05-08 01:38,1439299,684926,517878,236495,1439299
2023-05-08 01:39,1439311,684938,517878,236495,1439311
2023-05-08 01:40,1439323,684948,517880,236495,1439323
2023-05-08 01:41,1439335,684958,517880,236497,1439335
2023-05-08 01:42,1439346,684967,517881,236498,1439346
2023-05-08 01:44,1439358,684979,517881,236498,1439358
2023-05-08 01:45,1439370,684987,517883,236500,1439370
2023-05-08 01:46,1439382,684998,517883,236501,1439382
2023-05-08 01:47,1439394,685004,517888,236502,1439394
2023-05-08 01:48,1439406,685016,517888,236502,1439406
2023-05-08 01:49,1439418,685024,517891,236503,1439418
2023-05-08 01:50,1439429,685035,517891,236503,1439429
2023-05-08 01:51,1439441,685044,517893,236504,1439441
2023-05-08 01:52,1439453,685056,517893,236504,1439453
2023-05-08 01:53,1439465,685064,517895,236506,1439465
2023-05-08 01:54,1439477,685075,517895,236507,1439477
2023-05-08 01:55,1439489,685086,517896,236507,1439489
2023-05-08 01:56,1439500,685096,517896,236508,1439500
2023-05-08 01:57,1439512,685104,517900,236508,1439512
2023-05-08 01:58,1439524,685116,517900,236508,1439524
2023-05-08 01:59,1439536,685126,517902,236508,1439536
2023-05-08 02:00,1439550,685139,517902,236509,1439550
2023-05-08 02:01,1439571,685158,517904,236509,1439571
2023-05-08 02:02,1439588,685174,517904,236510,1439588
2023-05-08 02:03,1439608,685193,517904,236511,1439608
2023-05-08 02:04,1439627,685210,517904,236513,1439627
2023-05-08 02:05,1439645,685227,517904,236514,1439645
2023-05-08 02:06,1439664,685246,517904,236514,1439664
2023-05-08 02:07,1439683,685265,517904,236514,1439683
2023-05-08 02:08,1439702,685283,517904,236515,1439702
2023-05-08 02:09,1439721,685299,517907,236515,1439721
2023-05-08 02:10,1439740,685318,517907,236515,1439740
2023-05-08 02:11,1439758,685334,517908,236516,1439758
2023-05-08 02:12,1439777,685353,517908,236516,1439777
2023-05-08 02:13,1439797,685372,517909,236516,1439797
2023-05-08 02:14,1439817,685391,517909,236517,1439817
2023-05-08 02:15,1439835,685408,517910,236517,1439835
2023-05-08 02:16,1439854,685427,517910,236517,1439854
2023-05-08 02:17,1439873,685445,517911,236517,1439873
2023-05-08 02:18,1439891,685463,517911,236517,1439891
2023-05-08 02:19,1439910,685482,517911,236517,1439910
2023-05-08 02:20,1439929,685501,517911,236517,1439929
2023-05-08 02:21,1439948,685516,517915,236517,1439948
2023-05-08 02:22,1439968,685536,517915,236517,1439968
2023-05-08 02:23,1439987,685553,517916,236518,1439987
2023-05-08 02:24,1440006,685572,517916,236518,1440006
2023-05-08 02:25,1440024,685585,517920,236519,1440024
2023-05-08 02:26,1440043,685604,517920,236519,1440043
2023-05-08 02:27,1440061,685621,517921,236519,1440061
2023-05-08 02:28,1440080,685639,517921,236520,1440080
2023-05-08 02:29,1440100,685658,517922,236520,1440100
2023-05-08 02:31,1440118,685676,517922,236520,1440118
2023-05-08 02:32,1440136,685693,517923,236520,1440136
2023-05-08 02:33,1440155,685712,517923,236520,1440155
2023-05-08 02:34,1440175,685731,517924,236520,1440175
2023-05-08 02:35,1440194,685750,517924,236520,1440194
2023-05-08 02:36,1440212,685766,517926,236520,1440212
2023-05-08 02:37,1440232,685786,517926,236520,1440232
2023-05-08 02:38,1440249,685803,517926,236520,1440249
2023-05-08 02:39,1440269,685823,517926,236520,1440269
2023-05-08 02:40,1440287,685840,517927,236520,1440287
2023-05-08 02:41,1440306,685859,517927,236520,1440306
2023-05-08 02:42,1440325,685874,517930,236521,1440325
2023-05-08 02:43,1440343,685892,517930,236521,1440343
2023-05-08 02:44,1440362,685909,517932,236521,1440362
2023-05-08 02:45,1440382,685929,517932,236521,1440382
2023-05-08 02:46,1440401,685947,517932,236522,1440401
2023-05-08 02:47,1440418,685964,517932,236522,1440418
2023-05-08 02:48,1440438,685981,517935,236522,1440438
2023-05-08 02:49,1440457,686000,517935,236522,1440457
2023-05-08 02:50,1440476,686018,517936,236522,1440476
2023-05-08 02:51,1440494,686036,517936,236522,1440494
2023-05-08 02:52,1440513,686053,517938,236522,1440513
2023-05-08 02:53,1440532,686072,517938,236522,1440532
2023-05-08 02:54,1440551,686091,517938,236522,1440551
2023-05-08 02:55,1440569,686108,517938,236523,1440569
2023-05-08 02:56,1440588,686127,517938,236523,1440588
2023-05-08 02:57,1440607,686146,517938,236523,1440607
2023-05-08 02:58,1440626,686164,517939,236523,1440626
2023-05-08 02:59,1440644,686182,517939,236523,1440644
2023-05-08 03:00,1440667,686202,517942,236523,1440667
2023-05-08 03:01,1440691,686226,517942,236523,1440691
2023-05-08 03:02,1440714,686245,517946,236523,1440714
2023-05-08 03:03,1440738,686269,517946,236523,1440738
2023-05-08 03:04,1440762,686290,517949,236523,1440762
2023-05-08 03:05,1440785,686313,517949,236523,1440785
2023-05-08 03:06,1440809,686336,517950,236523,1440809
2023-05-08 03:07,1440833,686360,517950,236523,1440833
2023-05-08 03:08,1440857,686382,517952,236523,1440857
2023-05-08 03:09,1440881,686406,517952,236523,1440881
2023-05-08 03:10,1440904,686428,517953,236523,1440904
2023-05-08 03:11,1440928,686452,517953,236523,1440928
2023-05-08 03:12,1440952,686474,517955,236523,1440952
2023-05-08 03:13,1440976,686498,517955,236523,1440976
2023-05-08 03:14,1440999,686520,517956,236523,1440999
2023-05-08 03:15,1441024,686545,517956,236523,1441024
2023-05-08 03:16,1441049,686570,517956,236523,1441049
2023-05-08 03:18,1441073,686594,517956,236523,1441073
2023-05-08 03:19,1441097,686618,517956,236523,1441097
2023-05-08 03:20,1441120,686641,517956,236523,1441120
2023-05-08 03:21,1441145,686666,517956,236523,1441145
2023-05-08 03:22,1441167,686688,517956,236523,1441167
2023-05-08 03:23,1441192,686712,517957,236523,1441192
2023-05-08 03:24,1441215,686735,517957,236523,1441215
2023-05-08 03:25,1441239,686758,517958,236523,1441239
2023-05-08 03:26,1441262,686781,517958,236523,1441262
2023-05-08 03:27,1441286,686802,517961,236523,1441286
2023-05-08 03:28,1441311,686827,517961,236523,1441311
2023-05-08 03:29,1441335,686851,517961,236523,1441335
2023-05-08 03:30,1441357,686873,517961,236523,1441357
2023-05-08 03:31,1441382,686894,517965,236523,1441382
2023-05-08 03:32,1441405,686917,517965,236523,1441405
2023-05-08 03:33,1441430,686942,517965,236523,1441430
2023-05-08 03:34,1441453,686964,517965,236524,1441453
2023-05-08 03:35,1441478,686987,517967,236524,1441478
2023-05-08 03:36,1441500,687009,517967,236524,1441500
2023-05-08 03:37,1441526,687034,517968,236524,1441526
2023-05-08 03:38,1441549,687057,517968,236524,1441549
2023-05-08 03:39,1441573,687078,517970,236525,1441573
2023-05-08 03:40,1441597,687102,517970,236525,1441597
2023-05-08 03:41,1441619,687123,517970,236526,1441619
2023-05-08 03:42,1441645,687149,517970,236526,1441645
2023-05-08 03:43,1441668,687172,517970,236526,1441668
2023-05-08 03:44,1441692,687195,517970,236527,1441692
2023-05-08 03:45,1441716,687218,517971,236527,1441716
2023-05-08 03:46,1441740,687242,517971,236527,1441740
2023-05-08 03:47,1441763,687264,517971,236528,1441763
2023-05-08 03:48,1441788,687289,517971,236528,1441788
2023-05-08 03:49,1441810,687310,517972,236528,1441810
2023-05-08 03:50,1441834,687334,517972,236528,1441834
2023-05-08 03:51,1441859,687358,517972,236529,1441859
2023-05-08 03:52,1441883,687382,517972,236529,1441883
2023-05-08 03:53,1441905,687404,517972,236529,1441905
2023-05-08 03:54,1441931,687430,517972,236529,1441931
2023-05-08 03:55,1441954,687453,517972,236529,1441954
2023-05-08 03:56,1441978,687477,517972,236529,1441978
2023-05-08 03:57,1442001,687500,517972,236529,1442001
2023-05-08 03:58,1442025,687524,517972,236529,1442025
2023-05-08 03:59,1442050,687549,517972,236529,1442050
2023-05-08 04:00,1442059,687558,517972,236529,1442059
2023-05-08 04:01,1442067,687566,517972,236529,1442067
2023-05-08 04:02,1442074,687573,517972,236529,1442074
2023-05-08 04:03,1442082,687579,517974,236529,1442082
2023-05-08 04:05,1442089,687586,517974,236529,1442089
2023-05-08 04:06,1442096,687593,517974,236529,1442096
2023-05-08 04:07,1442104,687600,517974,236530,1442104
2023-05-08 04:08,1442111,687607,517974,236530,1442111
2023-05-08 04:09,1442119,687615,517974,236530,1442119
2023-05-08 04:10,1442126,687622,517974,236530,1442126
2023-05-08 04:11,1442134,687630,517974,236530,1442134
2023-05-08 04:12,1442141,687637,517974,236530,1442141
2023-05-08 04:13,1442150,687646,517974,236530,1442150
2023-05-08 04:14,1442158,687654,517974,236530,1442158
2023-05-08 04:15,1442165,687661,517974,236530,1442165
2023-05-08 04:16,1442172,687667,517975,236530,1442172
2023-05-08 04:17,1442180,687675,517975,236530,1442180
2023-05-08 04:18,1442188,687683,517975,236530,1442188
2023-05-08 04:19,1442195,687690,517975,236530,1442195
2023-05-08 04:20,1442203,687698,517975,236530,1442203
2023-05-08 04:21,1442210,687704,517975,236531,1442210
2023-05-08 04:22,1442218,687711,517976,236531,1442218
2023-05-08 04:23,1442225,687718,517976,236531,1442225
2023-05-08 04:24,1442233,687726,517976,236531,1442233
2023-05-08 04:25,1442240,687733,517976,236531,1442240
2023-05-08 04:26,1442248,687740,517977,236531,1442248
2023-05-08 04:27,1442255,687747,517977,236531,1442255
2023-05-08 04:28,1442263,687754,517978,236531,1442263
2023-05-08 04:29,1442270,687761,517978,236531,1442270
2023-05-08 04:30,1442278,687768,517978,236532,1442278
2023-05-08 04:31,1442285,687775,517978,236532,1442285
2023-05-08 04:32,1442293,687783,517978,236532,1442293
2023-05-08 04:33,1442300,687790,517978,236532,1442300
2023-05-08 04:34,1442308,687798,517978,236532,1442308
2023-05-08 04:35,1442315,687805,517978,236532,1442315
2023-05-08 04:36,1442323,687813,517978,236532,1442323
2023-05-08 04:37,1442331,687821,517978,236532,1442331
2023-05-08 04:38,1442339,687828,517979,236532,1442339
2023-05-08 04:39,1442347,687836,517979,236532,1442347
2023-05-08 04:40,1442354,687842,517980,236532,1442354
2023-05-08 04:41,1442362,687850,517980,236532,1442362
2023-05-08 04:42,1442369,687856,517981,236532,1442369
2023-05-08 04:43,1442376,687863,517981,236532,1442376
2023-05-08 04:44,1442384,687871,517981,236532,1442384
2023-05-08 04:45,1442392,687879,517981,236532,1442392
2023-05-08 04:46,1442399,687886,517981,236532,1442399
2023-05-08 04:47,1442406,687893,517981,236532,1442406
2023-05-08 04:48,1442414,687901,517981,236532,1442414
2023-05-08 04:49,1442422,687909,517981,236532,1442422
2023-05-08 04:50,1442430,687916,517982,236532,1442430
2023-05-08 04:52,1442438,687924,517982,236532,1442438
2023-05-08 04:53,1442445,687931,517982,236532,1442445
2023-05-08 04:54,1442452,687938,517982,236532,1442452
2023-05-08 04:55,1442460,687945,517983,236532,1442460
2023-05-08 04:56,1442467,687952,517983,236532,1442467
2023-05-08 04:57,1442475,687960,517983,236532,1442475
2023-05-08 04:58,1442483,687967,517983,236533,1442483
2023-05-08 04:59,1442490,687972,517984,236534,1442490
2023-05-08 05:00,1442500,687982,517984,236534,1442500
2023-05-08 05:01,1442526,688007,517985,236534,1442526
2023-05-08 05:02,1442552,688033,517985,236534,1442552
2023-05-08 05:03,1442579,688059,517986,236534,1442579
2023-05-08 05:04,1442604,688084,517986,236534,1442604
2023-05-08 05:05,1442629,688109,517986,236534,1442629
2023-05-08 05:06,1442655,688135,517986,236534,1442655
2023-05-08 05:07,1442683,688161,517988,236534,1442683
2023-05-08 05:08,1442709,688187,517988,236534,1442709
2023-05-08 05:09,1442735,688211,517990,236534,1442735
2023-05-08 05:10,1442761,688237,517990,236534,1442761
2023-05-08 05:11,1442787,688262,517991,236534,1442787
2023-05-08 05:12,1442812,688287,517991,236534,1442812
2023-05-08 05:13,1442838,688313,517991,236534,1442838
2023-05-08 05:14,1442864,688339,517991,236534,1442864
2023-05-08 05:15,1442890,688363,517993,236534,1442890
2023-05-08 05:16,1442916,688389,517993,236534,1442916
2023-05-08 05:17,1442942,688415,517993,236534,1442942
2023-05-08 05:18,1442968,688441,517993,236534,1442968
2023-05-08 05:19,1442995,688467,517994,236534,1442995
2023-05-08 05:20,1443020,688492,517994,236534,1443020
2023-05-08 05:21,1443047,688519,517994,236534,1443047
2023-05-08 05:22,1443074,688546,517994,236534,1443074
2023-05-08 05:23,1443099,688570,517995,236534,1443099
2023-05-08 05:24,1443126,688597,517995,236534,1443126
2023-05-08 05:25,1443151,688622,517995,236534,1443151
2023-05-08 05:26,1443177,688648,517995,236534,1443177
2023-05-08 05:27,1443202,688671,517996,236535,1443202
2023-05-08 05:28,1443228,688697,517996,236535,1443228
2023-05-08 05:29,1443254,688723,517996,236535,1443254
2023-05-08 05:30,1443282,688751,517996,236535,1443282
2023-05-08 05:31,1443307,688775,517997,236535,1443307
2023-05-08 05:32,1443333,688799,517998,236536,1443333
2023-05-08 05:33,1443359,688825,517998,236536,1443359
2023-05-08 05:34,1443385,688851,517998,236536,1443385
2023-05-08 05:35,1443411,688877,517998,236536,1443411
2023-05-08 05:36,1443437,688903,517998,236536,1443437
2023-05-08 05:37,1443464,688930,517998,236536,1443464
2023-05-08 05:39,1443489,688955,517998,236536,1443489
2023-05-08 05:40,1443515,688981,517998,236536,1443515
2023-05-08 05:41,1443542,689007,517999,236536,1443542
2023-05-08 05:42,1443566,689031,517999,236536,1443566
2023-05-08 05:43,1443594,689059,517999,236536,1443594
2023-05-08 05:44,1443620,689085,517999,236536,1443620
2023-05-08 05:45,1443645,689110,517999,236536,1443645
2023-05-08 05:46,1443672,689137,517999,236536,1443672
2023-05-08 05:47,1443698,689163,517999,236536,1443698
2023-05-08 05:48,1443724,689189,517999,236536,1443724
2023-05-08 05:49,1443750,689214,518000,236536,1443750
2023-05-08 05:50,1443775,689239,518000,236536,1443775
2023-05-08 05:51,1443801,689264,518001,236536,1443801
2023-05-08 05:52,1443829,689292,518001,236536,1443829
2023-05-08 05:53,1443856,689319,518001,236536,1443856
2023-05-08 05:54,1443882,689344,518001,236537,1443882
2023-05-08 05:55,1443907,689369,518001,236537,1443907
2023-05-08 05:56,1443933,689394,518001,236538,1443933
2023-05-08 05:57,1443958,689420,518000,236538,1443958
2023-05-08 05:58,1443985,689447,518000,236538,1443985
2023-05-08 05:59,1444010,689472,518000,236538,1444010
2023-05-08 06:00,1444038,689500,518000,236538,1444038
2023-05-08 06:01,1444067,689528,518001,236538,1444067
2023-05-08 06:02,1444094,689555,518001,236538,1444094
2023-05-08 06:03,1444122,689583,518001,236538,1444122
2023-05-08 06:04,1444149,689610,518001,236538,1444149
2023-05-08 06:05,1444178,689638,518002,236538,1444178
2023-05-08 06:06,1444206,689665,518002,236539,1444206
2023-05-08 06:07,1444234,689693,518002,236539,1444234
2023-05-08 06:08,1444262,689721,518002,236539,1444262
2023-05-08 06:09,1444289,689748,518002,236539,1444289
2023-05-08 06:10,1444318,689777,518002,236539,1444318
2023-05-08 06:11,1444345,689803,518003,236539,1444345
2023-05-08 06:12,1444374,689832,518003,236539,1444374
2023-05-08 06:13,1444401,689859,518003,236539,1444401
2023-05-08 06:14,1444431,689889,518003,236539,1444431
2023-05-08 06:15,1444457,689913,518005,236539,1444457
2023-05-08 06:16,1444487,689943,518005,236539,1444487
2023-05-08 06:17,1444513,689969,518005,236539,1444513
2023-05-08 06:18,1444541,689997,518005,236539,1444541
2023-05-08 06:19,1444570,690026,518005,236539,1444570
2023-05-08 06:20,1444597,690053,518005,236539,1444597
2023-05-08 06:21,1444626,690082,518005,236539,1444626
2023-05-08 06:22,1444655,690111,518005,236539,1444655
2023-05-08 06:23,1444681,690137,518005,236539,1444681
2023-05-08 06:24,1444709,690165,518005,236539,1444709
2023-05-08 06:26,1444739,690193,518007,236539,1444739
2023-05-08 06:27,1444766,690220,518007,236539,1444766
2023-05-08 06:28,1444793,690245,518009,236539,1444793
2023-05-08 06:29,1444821,690273,518009,236539,1444821
2023-05-08 06:30,1444850,690302,518009,236539,1444850
2023-05-08 06:31,1444878,690329,518009,236540,1444878
2023-05-08 06:32,1444905,690356,518009,236540,1444905
2023-05-08 06:33,1444934,690385,518009,236540,1444934
2023-05-08 06:34,1444962,690413,518009,236540,1444962
2023-05-08 06:35,1444990,690441,518009,236540,1444990
2023-05-08 06:36,1445017,690468,518009,236540,1445017
2023-05-08 06:37,1445047,690492,518014,236541,1445047
2023-05-08 06:38,1445073,690518,518014,236541,1445073
2023-05-08 06:39,1445101,690545,518015,236541,1445101
2023-05-08 06:40,1445130,690574,518015,236541,1445130
2023-05-08 06:41,1445158,690600,518017,236541,1445158
2023-05-08 06:42,1445185,690626,518017,236542,1445185
2023-05-08 06:43,1445213,690653,518018,236542,1445213
2023-05-08 06:44,1445243,690683,518018,236542,1445243
2023-05-08 06:45,1445270,690707,518021,236542,1445270
2023-05-08 06:46,1445298,690735,518021,236542,1445298
2023-05-08 06:47,1445326,690763,518021,236542,1445326
2023-05-08 06:48,1445353,690790,518021,236542,1445353
2023-05-08 06:49,1445382,690817,518023,236542,1445382
2023-05-08 06:50,1445410,690845,518023,236542,1445410
2023-05-08 06:51,1445439,690872,518024,236543,1445439
2023-05-08 06:52,1445465,690898,518024,236543,1445465
2023-05-08 06:53,1445494,690925,518026,236543,1445494
2023-05-08 06:54,1445521,690952,518026,236543,1445521
2023-05-08 06:55,1445550,690979,518028,236543,1445550
2023-05-08 06:56,1445577,691006,518028,236543,1445577
2023-05-08 06:57,1445606,691035,518028,236543,1445606
2023-05-08 06:58,1445634,691063,518028,236543,1445634
2023-05-08 06:59,1445662,691090,518029,236543,1445662
2023-05-08 07:00,1445677,691105,518029,236543,1445677
2023-05-08 07:01,1445686,691114,518029,236543,1445686
2023-05-08 07:02,1445696,691123,518029,236544,1445696
2023-05-08 07:03,1445705,691130,518031,236544,1445705
2023-05-08 07:04,1445714,691138,518031,236545,1445714
2023-05-08 07:05,1445723,691148,518031,236544,1445723
2023-05-08 07:06,1445733,691158,518031,236544,1445733
2023-05-08 07:07,1445741,691165,518031,236545,1445741
2023-05-08 07:08,1445751,691175,518031,236545,1445751
2023-05-08 07:09,1445760,691183,518032,236545,1445760
2023-05-08 07:10,1445769,691192,518032,236545,1445769
2023-05-08 07:11,1445778,691201,518032,236545,1445778
2023-05-08 07:12,1445788,691211,518032,236545,1445788
2023-05-08 07:14,1445797,691220,518032,236545,1445797
2023-05-08 07:15,1445806,691229,518032,236545,1445806
2023-05-08 07:16,1445815,691234,518036,236545,1445815
2023-05-08 07:17,1445825,691244,518036,236545,1445825
2023-05-08 07:18,1445834,691250,518039,236545,1445834
2023-05-08 07:19,1445843,691259,518039,236545,1445843
2023-05-08 07:20,1445852,691265,518041,236546,1445852
2023-05-08 07:21,1445861,691274,518041,236546,1445861
2023-05-08 07:22,1445871,691283,518042,236546,1445871
2023-05-08 07:23,1445880,691291,518042,236547,1445880
2023-05-08 07:24,1445890,691301,518042,236547,1445890
2023-05-08 07:25,1445898,691309,518042,236547,1445898
2023-05-08 07:26,1445908,691318,518043,236547,1445908
2023-05-08 07:27,1445917,691327,518043,236547,1445917
2023-05-08 07:28,1445926,691335,518043,236548,1445926
2023-05-08 07:29,1445935,691344,518043,236548,1445935
2023-05-08 07:30,1445944,691353,518043,236548,1445944
2023-05-08 07:31,1445953,691362,518043,236548,1445953
2023-05-08 07:32,1445963,691370,518044,236549,1445963
2023-05-08 07:33,1445972,691378,518044,236550,1445972
2023-05-08 07:34,1445981,691387,518044,236550,1445981
2023-05-08 07:35,1445990,691396,518044,236550,1445990
2023-05-08 07:36,1445999,691404,518045,236550,1445999
2023-05-08 07:37,1446008,691413,518045,236550,1446008
2023-05-08 07:38,1446018,691421,518046,236551,1446018
2023-05-08 07:39,1446028,691431,518046,236551,1446028
2023-05-08 07:40,1446037,691439,518047,236551,1446037
2023-05-08 07:41,1446046,691448,518047,236551,1446046
2023-05-08 07:42,1446055,691455,518048,236552,1446055
2023-05-08 07:43,1446064,691463,518048,236553,1446064
2023-05-08 07:44,1446073,691470,518050,236553,1446073
2023-05-08 07:45,1446082,691479,518050,236553,1446082
2023-05-08 07:46,1446091,691487,518051,236553,1446091
2023-05-08 07:47,1446100,691496,518051,236553,1446100
2023-05-08 07:48,1446109,691503,518053,236553,1446109
2023-05-08 07:49,1446118,691513,518053,236552,1446118
2023-05-08 07:50,1446127,691521,518054,236552,1446127
2023-05-08 07:51,1446137,691531,518054,236552,1446137
2023-05-08 07:52,1446146,691540,518053,236553,1446146
2023-05-08 07:53,1446155,691547,518054,236554,1446155
2023-05-08 07:54,1446165,691556,518054,236555,1446165
2023-05-08 07:55,1446174,691561,518057,236556,1446174
2023-05-08 07:56,1446183,691571,518057,236555,1446183
2023-05-08 07:57,1446193,691578,518060,236555,1446193
2023-05-08 07:58,1446202,691587,518060,236555,1446202
2023-05-08 07:59,1446210,691595,518060,236555,1446210
2023-05-08 08:00,1446221,691606,518060,236555,1446221
2023-05-08 08:02,1446230,691614,518061,236555,1446230
2023-05-08 08:03,1446241,691625,518061,236555,1446241
2023-05-08 08:04,1446250,691633,518062,236555,1446250
2023-05-08 08:05,1446261,691644,518062,236555,1446261
2023-05-08 08:06,1446270,691653,518062,236555,1446270
2023-05-08 08:07,1446280,691663,518062,236555,1446280
2023-05-08 08:08,1446290,691672,518063,236555,1446290
2023-05-08 08:09,1446300,691681,518063,236556,1446300
2023-05-08 08:10,1446310,691691,518063,236556,1446310
2023-05-08 08:11,1446320,691700,518063,236557,1446320
2023-05-08 08:12,1446330,691710,518063,236557,1446330
2023-05-08 08:13,1446340,691720,518063,236557,1446340
2023-05-08 08:14,1446350,691728,518065,236557,1446350
2023-05-08 08:15,1446360,691738,518065,236557,1446360
2023-05-08 08:16,1446370,691746,518067,236557,1446370
2023-05-08 08:17,1446380,691756,518067,236557,1446380
2023-05-08 08:18,1446390,691765,518068,236557,1446390
2023-05-08 08:19,1446400,691775,518068,236557,1446400
2023-05-08 08:20,1446410,691783,518069,236558,1446410
2023-05-08 08:21,1446420,691793,518069,236558,1446420
2023-05-08 08:22,1446430,691801,518071,236558,1446430
2023-05-08 08:23,1446439,691809,518071,236559,1446439
2023-05-08 08:24,1446450,691817,518074,236559,1446450
2023-05-08 08:25,1446460,691827,518074,236559,1446460
2023-05-08 08:26,1446470,691836,518075,236559,1446470
2023-05-08 08:27,1446479,691845,518075,236559,1446479
2023-05-08 08:28,1446489,691855,518075,236559,1446489
2023-05-08 08:29,1446499,691865,518075,236559,1446499
2023-05-08 08:30,1446509,691874,518076,236559,1446509
2023-05-08 08:31,1446519,691883,518076,236560,1446519
2023-05-08 08:32,1446529,691890,518079,236560,1446529
2023-05-08 08:33,1446539,691900,518079,236560,1446539
2023-05-08 08:34,1446549,691909,518080,236560,1446549
2023-05-08 08:35,1446559,691919,518080,236560,1446559
2023-05-08 08:36,1446569,691926,518082,236561,1446569
2023-05-08 08:37,1446580,691936,518083,236561,1446580
2023-05-08 08:38,1446590,691945,518083,236562,1446590
2023-05-08 08:39,1446600,691955,518083,236562,1446600
2023-05-08 08:40,1446610,691965,518083,236562,1446610
2023-05-08 08:41,1446620,691974,518083,236563,1446620
2023-05-08 08:42,1446630,691983,518083,236564,1446630
2023-05-08 08:43,1446641,691994,518083,236564,1446641
2023-05-08 08:44,1446650,692003,518083,236564,1446650
2023-05-08 08:45,1446661,692014,518083,236564,1446661
2023-05-08 08:46,1446670,692023,518083,236564,1446670
2023-05-08 08:47,1446680,692022,518093,236565,1446680
2023-05-08 08:48,1446690,692032,518093,236565,1446690
2023-05-08 08:50,1446701,692043,518093,236565,1446701
2023-05-08 08:51,1446711,692053,518093,236565,1446711
2023-05-08 08:52,1446721,692063,518093,236565,1446721
2023-05-08 08:53,1446731,692073,518093,236565,1446731
2023-05-08 08:54,1446742,692084,518093,236565,1446742
2023-05-08 08:55,1446751,692093,518093,236565,1446751
2023-05-08 08:56,1446761,692102,518093,236566,1446761
2023-05-08 08:57,1446771,692112,518093,236566,1446771
2023-05-08 08:58,1446781,692109,518105,236567,1446781
2023-05-08 08:59,1446791,692118,518105,236568,1446791
2023-05-08 09:00,1446806,692131,518106,236569,1446806
2023-05-08 09:01,1446837,692162,518106,236569,1446837
2023-05-08 09:02,1446870,692194,518106,236570,1446870
2023-05-08 09:03,1446901,692225,518106,236570,1446901
2023-05-08 09:04,1446935,692257,518106,236572,1446935
2023-05-08 09:05,1446965,692285,518106,236574,1446965
2023-05-08 09:06,1446999,692319,518106,236574,1446999
2023-05-08 09:07,1447032,692352,518106,236574,1447032
2023-05-08 09:08,1447065,692385,518106,236574,1447065
2023-05-08 09:09,1447097,692417,518106,236574,1447097
2023-05-08 09:10,1447129,692436,518119,236574,1447129
2023-05-08 09:11,1447161,692468,518119,236574,1447161
2023-05-08 09:12,1447193,692500,518119,236574,1447193
2023-05-08 09:13,1447225,692532,518119,236574,1447225
2023-05-08 09:14,1447259,692566,518119,236574,1447259
2023-05-08 09:15,1447290,692597,518119,236574,1447290
2023-05-08 09:16,1447322,692628,518119,236575,1447322
2023-05-08 09:17,1447354,692659,518119,236576,1447354
2023-05-08 09:18,1447387,692692,518119,236576,1447387
2023-05-08 09:19,1447419,692724,518119,236576,1447419
2023-05-08 09:20,1447453,692752,518125,236576,1447453
2023-05-08 09:21,1447485,692781,518128,236576,1447485
2023-05-08 09:22,1447519,692814,518128,236577,1447519
2023-05-08 09:23,1447551,692845,518129,236577,1447551
2023-05-08 09:24,1447582,692875,518129,236578,1447582
2023-05-08 09:25,1447615,692907,518130,236578,1447615
2023-05-08 09:26,1447646,692937,518130,236579,1447646
2023-05-08 09:27,1447679,692966,518134,236579,1447679
2023-05-08 09:28,1447713,693000,518134,236579,1447713
2023-05-08 09:29,1447745,693024,518141,236580,1447745
2023-05-08 09:30,1447778,693057,518141,236580,1447778
2023-05-08 09:31,1447808,693085,518143,236580,1447808
2023-05-08 09:32,1447841,693117,518143,236581,1447841
2023-05-08 09:33,1447874,693146,518146,236582,1447874
2023-05-08 09:34,1447906,693177,518146,236583,1447906
2023-05-08 09:35,1447939,693209,518147,236583,1447939
2023-05-08 09:37,1447971,693241,518147,236583,1447971
2023-05-08 09:38,1448003,693270,518150,236583,1448003
2023-05-08 09:39,1448036,693303,518150,236583,1448036
2023-05-08 09:40,1448069,693334,518152,236583,1448069
2023-05-08 09:41,1448102,693367,518152,236583,1448102
2023-05-08 09:42,1448134,693396,518155,236583,1448134
2023-05-08 09:43,1448167,693428,518155,236584,1448167
2023-05-08 09:44,1448199,693457,518156,236586,1448199
2023-05-08 09:45,1448232,693488,518156,236588,1448232
2023-05-08 09:46,1448264,693518,518158,236588,1448264
2023-05-08 09:47,1448294,693549,518158,236587,1448294
2023-05-08 09:48,1448328,693577,518163,236588,1448328
2023-05-08 09:49,1448362,693611,518163,236588,1448362
2023-05-08 09:50,1448394,693641,518165,236588,1448394
2023-05-08 09:51,1448426,693673,518165,236588,1448426
2023-05-08 09:52,1448458,693703,518167,236588,1448458
2023-05-08 09:53,1448491,693736,518167,236588,1448491
2023-05-08 09:54,1448522,693766,518168,236588,1448522
2023-05-08 09:55,1448556,693799,518168,236589,1448556
2023-05-08 09:56,1448587,693827,518171,236589,1448587
2023-05-08 09:57,1448619,693859,518171,236589,1448619
2023-05-08 09:58,1448651,693888,518173,236590,1448651
2023-05-08 09:59,1448684,693922,518173,236589,1448684
2023-05-08 10:00,1448710,693945,518175,236590,1448710
2023-05-08 10:01,1448725,693958,518175,236592,1448725
2023-05-08 10:02,1448742,693975,518175,236592,1448742
2023-05-08 10:03,1448758,693990,518175,236593,1448758
2023-05-08 10:04,1448774,694004,518176,236594,1448774
2023-05-08 10:05,1448790,694019,518176,236595,1448790
2023-05-08 10:06,1448806,694032,518179,236595,1448806
2023-05-08 10:07,1448823,694048,518179,236596,1448823
2023-05-08 10:08,1448839,694062,518181,236596,1448839
2023-05-08 10:09,1448855,694078,518181,236596,1448855
2023-05-08 10:10,1448870,694086,518188,236596,1448870
2023-05-08 10:11,1448887,694101,518188,236598,1448887
2023-05-08 10:12,1448902,694114,518190,236598,1448902
2023-05-08 10:13,1448918,694131,518190,236597,1448918
2023-05-08 10:14,1448933,694143,518193,236597,1448933
2023-05-08 10:15,1448950,694160,518193,236597,1448950
2023-05-08 10:16,1448966,694173,518196,236597,1448966
2023-05-08 10:17,1448983,694189,518196,236598,1448983
2023-05-08 10:18,1448998,694202,518197,236599,1448998
2023-05-08 10:19,1449014,694218,518197,236599,1449014
2023-05-08 10:20,1449029,694230,518200,236599,1449029
2023-05-08 10:21,1449046,694246,518200,236600,1449046
2023-05-08 10:22,1449062,694257,518205,236600,1449062
2023-05-08 10:24,1449079,694274,518205,236600,1449079
2023-05-08 10:25,1449095,694287,518208,236600,1449095
2023-05-08 10:26,1449110,694302,518208,236600,1449110
2023-05-08 10:27,1449126,694315,518210,236601,1449126
2023-05-08 10:28,1449142,694331,518210,236601,1449142
2023-05-08 10:29,1449158,694344,518213,236601,1449158
2023-05-08 10:30,1449174,694360,518213,236601,1449174
2023-05-08 10:31,1449189,694373,518215,236601,1449189
2023-05-08 10:32,1449205,694389,518215,236601,1449205
2023-05-08 10:33,1449221,694401,518218,236602,1449221
2023-05-08 10:34,1449237,694415,518218,236604,1449237
2023-05-08 10:35,1449253,694429,518219,236605,1449253
2023-05-08 10:36,1449269,694445,518219,236605,1449269
2023-05-08 10:37,1449284,694458,518221,236605,1449284
2023-05-08 10:38,1449300,694474,518221,236605,1449300
2023-05-08 10:39,1449317,694488,518223,236606,1449317
2023-05-08 10:40,1449336,694507,518223,236606,1449336
2023-05-08 10:41,1449352,694519,518224,236609,1449352
2023-05-08 10:42,1449367,694534,518224,236609,1449367
2023-05-08 10:43,1449383,694546,518228,236609,1449383
2023-05-08 10:44,1449399,694561,518228,236610,1449399
2023-05-08 10:45,1449415,694576,518229,236610,1449415
2023-05-08 10:46,1449431,694592,518229,236610,1449431
2023-05-08 10:47,1449447,694606,518231,236610,1449447
2023-05-08 10:48,1449464,694621,518231,236612,1449464
2023-05-08 10:49,1449480,694634,518232,236614,1449480
2023-05-08 10:50,1449496,694649,518232,236615,1449496
2023-05-08 10:51,1449511,694664,518232,236615,1449511
2023-05-08 10:52,1449528,694682,518232,236614,1449528
2023-05-08 10:53,1449543,694695,518232,236616,1449543
2023-05-08 10:54,1449560,694713,518232,236615,1449560
2023-05-08 10:55,1449576,694729,518232,236615,1449576
2023-05-08 10:56,1449593,694745,518232,236616,1449593
2023-05-08 10:57,1449609,694761,518232,236616,1449609
2023-05-08 10:58,1449624,694776,518232,236616,1449624
2023-05-08 10:59,1449641,694777,518248,236616,1449641
2023-05-08 11:00,1449655,694791,518248,236616,1449655
2023-05-08 11:01,1449668,694802,518250,236616,1449668
2023-05-08 11:02,1449682,694816,518250,236616,1449682
2023-05-08 11:03,1449695,694824,518254,236617,1449695
2023-05-08 11:04,1449709,694838,518254,236617,1449709
2023-05-08 11:05,1449723,694852,518254,236617,1449723
2023-05-08 11:06,1449735,694863,518254,236618,1449735
2023-05-08 11:07,1449750,694878,518254,236618,1449750
2023-05-08 11:08,1449763,694890,518254,236619,1449763
2023-05-08 11:09,1449777,694900,518257,236620,1449777
2023-05-08 11:11,1449790,694914,518257,236619,1449790
2023-05-08 11:12,1449804,694920,518264,236620,1449804
2023-05-08 11:13,1449817,694933,518264,236620,1449817
2023-05-08 11:14,1449830,694944,518265,236621,1449830
2023-05-08 11:15,1449843,694956,518265,236622,1449843
2023-05-08 11:16,1449857,694968,518267,236622,1449857
2023-05-08 11:17,1449871,694982,518267,236622,1449871
2023-05-08 11:18,1449885,694994,518268,236623,1449885
2023-05-08 11:19,1449898,695005,518268,236625,1449898
2023-05-08 11:20,1449911,695017,518268,236626,1449911
2023-05-08 11:21,1449925,695030,518268,236627,1449925
2023-05-08 11:22,1449937,695042,518268,236627,1449937
2023-05-08 11:23,1449951,695054,518268,236629,1449951
2023-05-08 11:24,1449964,695066,518269,236629,1449964
2023-05-08 11:25,1449978,695080,518269,236629,1449978
2023-05-08 11:26,1449991,695093,518269,236629,1449991
2023-05-08 11:27,1450004,695106,518269,236629,1450004
2023-05-08 11:28,1450018,695119,518270,236629,1450018
2023-05-08 11:29,1450032,695133,518270,236629,1450032
2023-05-08 11:30,1450047,695146,518272,236629,1450047
2023-05-08 11:31,1450060,695158,518272,236630,1450060
2023-05-08 11:32,1450073,695169,518272,236632,1450073
2023-05-08 11:33,1450086,695180,518272,236634,1450086
2023-05-08 11:34,1450100,695192,518273,236635,1450100
2023-05-08 11:35,1450113,695205,518273,236635,1450113
2023-05-08 11:36,1450127,695217,518275,236635,1450127
2023-05-08 11:37,1450140,695230,518275,236635,1450140
2023-05-08 11:38,1450154,695243,518275,236636,1450154
2023-05-08 11:39,1450167,695256,518275,236636,1450167
2023-05-08 11:40,1450180,695265,518279,236636,1450180
2023-05-08 11:41,1450193,695278,518279,236636,1450193
2023-05-08 11:42,1450207,695289,518281,236637,1450207
2023-05-08 11:43,1450220,695301,518281,236638,1450220
2023-05-08 11:44,1450234,695310,518284,236640,1450234
2023-05-08 11:45,1450247,695323,518284,236640,1450247
2023-05-08 11:46,1450261,695334,518286,236641,1450261
2023-05-08 11:47,1450274,695347,518286,236641,1450274
2023-05-08 11:48,1450288,695357,518289,236642,1450288
2023-05-08 11:49,1450301,695369,518289,236643,1450301
2023-05-08 11:50,1450315,695379,518291,236645,1450315
2023-05-08 11:51,1450328,695392,518291,236645,1450328
2023-05-08 11:52,1450341,695403,518293,236645,1450341
2023-05-08 11:53,1450354,695416,518293,236645,1450354
2023-05-08 11:54,1450367,695426,518296,236645,1450367
2023-05-08 11:55,1450381,695440,518296,236645,1450381
2023-05-08 11:56,1450395,695448,518301,236646,1450395
2023-05-08 11:58,1450408,695461,518301,236646,1450408
2023-05-08 11:59,1450421,695470,518304,236647,1450421
2023-05-08 12:00,1450434,695483,518304,236647,1450434
2023-05-08 12:01,1450444,695488,518308,236648,1450444
2023-05-08 12:02,1450453,695497,518308,236648,1450453
2023-05-08 12:03,1450463,695504,518311,236648,1450463
2023-05-08 12:04,1450472,695513,518311,236648,1450472
2023-05-08 12:05,1450482,695522,518312,236648,1450482
2023-05-08 12:06,1450492,695531,518312,236649,1450492
2023-05-08 12:07,1450501,695536,518316,236649,1450501
2023-05-08 12:08,1450510,695545,518316,236649,1450510
2023-05-08 12:09,1450519,695547,518321,236651,1450519
2023-05-08 12:10,1450529,695558,518321,236650,1450529
2023-05-08 12:11,1450539,695567,518321,236651,1450539
2023-05-08 12:12,1450548,695575,518321,236652,1450548
2023-05-08 12:13,1450557,695580,518325,236652,1450557
2023-05-08 12:14,1450566,695588,518325,236653,1450566
2023-05-08 12:15,1450576,695592,518329,236655,1450576
2023-05-08 12:16,1450585,695601,518329,236655,1450585
2023-05-08 12:17,1450595,695610,518330,236655,1450595
2023-05-08 12:18,1450604,695619,518330,236655,1450604
2023-05-08 12:19,1450616,695629,518332,236655,1450616
2023-05-08 12:20,1450625,695638,518332,236655,1450625
2023-05-08 12:21,1450634,695640,518339,236655,1450634
2023-05-08 12:22,1450644,695650,518339,236655,1450644
2023-05-08 12:23,1450653,695654,518344,236655,1450653
2023-05-08 12:24,1450663,695664,518344,236655,1450663
2023-05-08 12:25,1450672,695671,518346,236655,1450672
2023-05-08 12:26,1450681,695679,518346,236656,1450681
2023-05-08 12:27,1450691,695687,518348,236656,1450691
2023-05-08 12:28,1450700,695695,518348,236657,1450700
2023-05-08 12:29,1450709,695701,518350,236658,1450709
2023-05-08 12:30,1450719,695711,518350,236658,1450719
2023-05-08 12:31,1450728,695713,518356,236659,1450728
2023-05-08 12:32,1450737,695722,518356,236659,1450737
2023-05-08 12:33,1450748,695731,518358,236659,1450748
2023-05-08 12:34,1450758,695741,518358,236659,1450758
2023-05-08 12:35,1450767,695746,518361,236660,1450767
2023-05-08 12:36,1450777,695756,518361,236660,1450777
2023-05-08 12:37,1450787,695760,518366,236661,1450787
2023-05-08 12:38,1450796,695769,518366,236661,1450796
2023-05-08 12:39,1450805,695774,518369,236662,1450805
2023-05-08 12:40,1450816,695785,518369,236662,1450816
2023-05-08 12:41,1450826,695789,518374,236663,1450826
2023-05-08 12:42,1450837,695798,518374,236665,1450837
2023-05-08 12:43,1450846,695805,518376,236665,1450846
2023-05-08 12:44,1450856,695815,518376,236665,1450856
2023-05-08 12:46,1450866,695823,518378,236665,1450866
2023-05-08 12:47,1450875,695831,518378,236666,1450875
2023-05-08 12:48,1450884,695836,518382,236666,1450884
2023-05-08 12:49,1450894,695845,518382,236667,1450894
2023-05-08 12:50,1450903,695852,518384,236667,1450903
2023-05-08 12:51,1450913,695861,518384,236668,1450913
2023-05-08 12:52,1450923,695869,518386,236668,1450923
2023-05-08 12:53,1450932,695876,518386,236670,1450932
2023-05-08 12:54,1450941,695884,518387,236670,1450941
2023-05-08 12:55,1450951,695893,518387,236671,1450951
2023-05-08 12:56,1450960,695898,518390,236672,1450960
2023-05-08 12:57,1450970,695908,518390,236672,1450970
2023-05-08 12:58,1450980,695915,518392,236673,1450980
2023-05-08 12:59,1450990,695925,518392,236673,1450990
